Agency_for_International_Development	anwarrARtrIya_vikAsa_ejeMsI#anwarrARtrIya_vikAsa_ejeMsI#noun#4#RM
Agricultural_credit_Department	kqRi_qNa_viBAga#kqRi_qNa_viBAga#noun#3#RM
Asian_and_Pacific_Regional_Agricultural_Credit_Association	eSiyAI_Ora_praSAnwa_kRewrIya_kqRi_qNa_saMGa#eSiyAI_Ora_praSAnwa_kRewrIya_kqRi_qNa_saMGa#noun#7#RM
Association_of_South_East_Asian_Nations	xakRiNa_pUrva_eSiyAI_rARtroM_kA_saMGa#xakRiNa_pUrva_eSiyAI_rARtroM_kA_saMGa#noun#1#RM
Association_of_Voluntary_Agencies_for_Rural_Development	grAmINa_vikAsa_svEcCika_ejeMsI_saMGa#grAmINa_vikAsa_svEcCika_ejeMsI_saMGa#noun#1#RM
Board_for_Industrial_and_Financial_Reconstruction	Oxyogika_Ora_viwwIya_punarnirmANa_borda#Oxyogika_Ora_viwwIya_punarnirmANa_borda#noun#6#RM
Bureau_of_Public_Enterprises	loka_uxyama_kAryAlaya#loka_uxyama_kAryAlaya#noun#1#RM
College_of_Agricultural_Banking	kqRi_bEMkiMga_mahAvixyAlaya#kqRi_bEMkiMga_mahAvixyAlaya#noun#1#RM
Commission_for_Agricultural_Costs_and_Prices	kqRi_lAgawa_Ora_mUlya_Ayoga#kqRi_lAgawa_Ora_mUlya_Ayoga#noun#6#RM
Communication_control_unit	saMcAra_niyaMwraNa_ekaka#saMcAra_niyaMwraNa_ekaka#noun#3#RM
Controller_of_Capital_Issues	pUMjI_nirgama_niyaMwraka#pUMjI_nirgama_niyaMwraka#noun#1#RM
Council_for_Mutual_Economic_Assistance	pArasparika_ArWika_sahAyawA_pariRaxa#pArasparika_ArWika_sahAyawA_pariRaxa#noun#5#RM
Department_of_Banking_Operations_Development	bEMkiMga_paricAlana_Ora_vikAsa_viBAga#bEMkiMga_paricAlana_Ora_vikAsa_viBAga#noun#1#RM
Directorate_of_Advertising_and_Visual_Publicity	vijFApana_evaM_xqSya_pracAra_nixeSAlaya#vijFApana_evaM_xqSya_pracAra_nixeSAlaya#noun#1#RM
Economic_and_Social_Commission_for_Asia_and_Pacific	eSiyA_Ora_praSAMwa_kRewra_kA_ArWika_Ora_sAmAjika_Ayoga#eSiyA_Ora_praSAMwa_kRewra_kA_ArWika_Ora_sAmAjika_Ayoga#noun#8#RM
FEAEd_Foreign_Exchange_Act_Enforcement_Directorate	vixeSI_muxrA_aXiniyama_pravarwana_nixeSAlaya#vixeSI_muxrA_aXiniyama_pravarwana_nixeSAlaya#noun#6#RM
FRNs_Floating_Rate_Notes	asWira_xara_vAle_nota#asWira_xara_vAle_nota#noun#4#RM
Federation_of_Indian_Export_Organisation	BArawIya_niryAwa_saMgaTana_mahAsaMGa#BArawIya_niryAwa_saMgaTana_mahAsaMGa#noun#1#RM
Food_for_Work_Programme	kAma_ke_baxale_AnAja_kAryakrama#kAma_ke_baxale_AnAja_kAryakrama#noun#4#RM
Institute_of_Banking_Personnel_Selection	bEMkiMga_kArmika_cayana_saMsWAna#bEMkiMga_kArmika_cayana_saMsWAna#noun#1#RM
Khadi_and_Village_Industries_Commission	KAxI_waWA_grAmoxyoga_Ayoga#KAxI_waWA_grAmoxyoga_Ayoga#noun#5#RM
Monopolies_and_Restrictive_Trade_Practices_Commission	ekAXikAra_waWA_avaroXaka_vyApArika_vyavahAra_Ayoga#ekAXikAra_waWA_avaroXaka_vyApArika_vyavahAra_Ayoga#noun#6#RM
Organisation_of_Petroleum_Exporting_Countries	petroliyana_(wela)_niryAwaka_xeSoM_kA_saMgaTana#petroliyana_(wela)_niryAwaka_xeSoM_kA_saMgaTana#noun#1#RM
Additional_Resource_Mobilisation	awirikwa_saMsAXana_jutAnA#awirikwa_saMsAXana_jutAnA#noun#3#RM
Agricultural_Credit_Board	kqrRi_qNa_borda#kqrRi_qNa_borda#noun#3#RM
Agricultural_Economic_Research_Centre	kqRi_ArWika_anusaMXAna_kenxra#kqRi_ArWika_anusaMXAna_kenxra#noun#4#RM
Agricultural_Finance_Corporation	kqRi_viwwa_nigama#kqRi_viwwa_nigama#noun#3#RM
Agricultural_Labourers_Development_Agency	kqRi_Sramika_vikAsa_ejeMsI#kqRi_Sramika_vikAsa_ejeMsI#noun#4#RM
Agricultural_Prices_Commission	kqRi_mUlya_Ayoga#kqRi_mUlya_Ayoga#noun#3#RM
Agricultural_Refinance_and_Development_Corporation	kqRi_punarviwwa_Ora_vikAsa_nigama#kqRi_punarviwwa_Ora_vikAsa_nigama#noun#5#RM
Agricultural_Service_Centre	kqRi_sevA_kenxra#kqRi_sevA_kenxra#noun#3#RM
Agricultural_Stabilization_Fund	kqRi_sWirIkaraNa_niXi#kqRi_sWirIkaraNa_niXi#noun#3#RM
Agro_Industries_Corporation	kqRi_uxyoga_nigama#kqRi_uxyoga_nigama#noun#3#RM
Air_Chief_Marshal	eara_cIPZa_mArSala{vAyu_senA_kA_bahuwa_ucca_aXikArI}#eara_cIPZa_mArSala{vAyu_senA_kA_bahuwa_ucca_aXikArI}#noun#3#RM
Air_Commodore	eara_kOmodora{vAyu_senA_kA_ucca_aXikArI}#eara_kOmodora{vAyu_senA_kA_ucca_aXikArI}#noun#2#RM
Air_Vice_Marshal	eara_vAisa_mArSala{vAyu_senA_kA_ucca_aXikArI}#eara_vAisa_mArSala{vAyu_senA_kA_ucca_aXikArI}#noun#3#RM
All_India_Debt_and_Investment_Survey	aKila_BArawIya_qNa_Ora_niveSa_sarvekRaNa#aKila_BArawIya_qNa_Ora_niveSa_sarvekRaNa#noun#6#RM
All_India_Export_Advisory_Committee	aKila_BArawIya_niryAwa_parAmarSaxAwrI_samiwi#aKila_BArawIya_niryAwa_parAmarSaxAwrI_samiwi#noun#5#RM
All_India_Handicrafts_Board	aKila_BArawIya_haswaSilpa_borda#aKila_BArawIya_haswaSilpa_borda#noun#4#RM
Anual_Action_Plan	vArRika_kArya_yojanA#vArRika_kArya_yojanA#noun#3#RM
Asian_African_Legal_Consultative_Committee	eSiyAI_aPrIkI_viviXa_parAmarSaxAwrI_samiwi#eSiyAI_aPrIkI_viviXa_parAmarSaxAwrI_samiwi#noun#5#RM
Asian_Clearing_Union	eSiyAI_samASoXana_yUniyana#eSiyAI_samASoXana_yUniyana#noun#3#RM
Asian_Development_Bank	eSiyAI_vikAsa_bEMka#eSiyAI_vikAsa_bEMka#noun#3#RM
Asian_Monetary_Union	eSiyAI_mOxrika_saMGa#eSiyAI_mOxrika_saMGa#noun#3#RM
Asian_Monetary_Unit	eSiyAI_mOxrika_ikAI#eSiyAI_mOxrika_ikAI#noun#3#RM
Asian_Pacific_Regional_Credit_Association	eSiyAI_Ora_praSAMwa_kRewrIya_qNa_saMGa#eSiyAI_Ora_praSAMwa_kRewrIya_qNa_saMGa#noun#5#RM
Asian_Payments_Union	eSiyAI_BugawAna_saMGa#eSiyAI_BugawAna_saMGa#noun#3#RM
Backward_Classes_Commission	piCadI_jAwi_Ayoga#piCadI_jAwi_Ayoga#noun#3#RM
Bankers_Training_College	bEMkara_praSikRaNa_mahAvixyAlaya#bEMkara_praSikRaNa_mahAvixyAlaya#noun#3#RM
Banking_Regulation_Act	bEMkakArI_vinimaya_aXiniyama#bEMkakArI_vinimaya_aXiniyama#noun#3#RM
Banking_Services_Recruitment_Board	bEMkiMga_sevA_BarwI_borda#bEMkiMga_sevA_BarwI_borda#noun#4#RM
Belgian_Congo	bEljiyama_kAMgo#bEljiyama_kAMgo#noun#2#RM
Bills_Rediscounting_Scheme	bila_punarBunAI_yojanA#bila_punarBunAI_yojanA#noun#3#RM
Block_Development_Officer	KaMda_vikAsa_aXikArI#KaMda_vikAsa_aXikArI#noun#3#RM
British_Cabinet	britiSa_maMwrimaMdala#britiSa_maMwrimaMdala#noun#2#RM
Canadian_International_Development_Association	kanAdA_anwarrARtrIya_vikAsa_saMGa#kanAdA_anwarrARtrIya_vikAsa_saMGa#noun#4#RM
Cash_Compensatory_Scheme	nakaxI_prawipUrwi_yojanA#nakaxI_prawipUrwi_yojanA#noun#3#RM
Cash_Compensatory_Support	nakaxI_prawipUrwi_sahAyawA#nakaxI_prawipUrwi_sahAyawA#noun#3#RM
Cash_Reserve_Ratio	prArakRiwa_nakaxI_niXi_anupAwa#prArakRiwa_nakaxI_niXi_anupAwa#noun#3#RM
Cashew_Corporation_of_India	BArawIya_kAjU_nigama#BArawIya_kAjU_nigama#noun#2#RM
Census_Bureau	niMxA_kakRa#niMxA_kakRa#noun#2#RM
Central_Board_of_Direct_Taxes	kenxrIya_prawyakRa_kara_borda#kenxrIya_prawyakRa_kara_borda#noun#2#RM
Central_Board_of_Excise_and_Customs	kenxrIya_uwpAxana_Ora_sImA_Sulka_borda#kenxrIya_uwpAxana_Ora_sImA_Sulka_borda#noun#2#RM
Central_Board_of_Revenue	kenxrIya_rAjasva_borda#kenxrIya_rAjasva_borda#noun#2#RM
Central_Ground_Water_Board	kenxrIya_BU-jala_borda#kenxrIya_BU-jala_borda#noun#4#RM
Central_Industrial_Extension_Training_Institute	kenxrIya_Oxyogika_viswAra_praSikRaNa_saMsWAna#kenxrIya_Oxyogika_viswAra_praSikRaNa_saMsWAna#noun#5#RM
Central_Land_Development_Bank	kenxrIya_BUmi_vikAsa_bEMka#kenxrIya_BUmi_vikAsa_bEMka#noun#4#RM
Central_Land_Reforms_Committee	kenxrIya_BUmi_suXAra_samiwi#kenxrIya_BUmi_suXAra_samiwi#noun#4#RM
Central_Sector_Plan_Scheme	kenxrIya_kRewra_Ayojana_kI_yojanA#kenxrIya_kRewra_Ayojana_kI_yojanA#noun#4#RM
Central_Statistical_Organisation	kenxrIya_sAMKyikIya_saMgaTana#kenxrIya_sAMKyikIya_saMgaTana#noun#3#RM
Central_Veterinary_Research_Institute	kenxrIya_paSucikiwsA_anusaMXAna_saMsWA#kenxrIya_paSucikiwsA_anusaMXAna_saMsWA#noun#4#RM
Central_Warehousing_Corporation	kenxrIya_BANdAgAraNa_nigama#kenxrIya_BANdAgAraNa_nigama#noun#3#RM
Certificated_Associate_of_the_Indian_Institute_of_Bankers	BArawIya_bEMkara_saMsWAna_kA_pramANapawriwa_esosieta#BArawIya_bEMkara_saMsWAna_kA_pramANapawriwa_esosieta#noun#2#RM
Command_Area_Development_Agency	kamAna_kRewra_vikAsa_ejeMsI#kamAna_kRewra_vikAsa_ejeMsI#noun#4#RM
Command_Area_Development_Programme	kamAna_kRewra_vikAsa_kAryakrama#kamAna_kRewra_vikAsa_kAryakrama#noun#4#RM
Compensatory_Financing_Facility	kRawipUraka_viwwapoRaNa_suviXA#kRawipUraka_viwwapoRaNa_suviXA#noun#3#RM
Compulsory_Deposit_Scheme	anivArya_jamA_yojanA#anivArya_jamA_yojanA#noun#3#RM
Concessional_Rate_of_Interest	riyAyawI_byAja_xara#riyAyawI_byAja_xara#noun#2#RM
Cotton_Advisory_Board	kapAsa_parAmarSaxAwA_borda#kapAsa_parAmarSaxAwA_borda#noun#3#RM
Cotton_Corporation_of_India	BArawIya_kapAsa_nigama#BArawIya_kapAsa_nigama#noun#2#RM
Credit_Authorisation_Scheme	qNa_prAXikaraNa_yojanA#qNa_prAXikaraNa_yojanA#noun#3#RM
Credit_Guarantee_Organisation	qNa_gAraMtI_saMgaTana#qNa_gAraMtI_saMgaTana#noun#3#RM
Credit_Guarantee_Scheme	qNa_gAraMtI_yojanA#qNa_gAraMtI_yojanA#noun#3#RM
Cumulative_Term_Deposit	saMcayI_sAvaXi_jamA#saMcayI_sAvaXi_jamA#noun#3#RM
Currency_Declaration_Form	muxrA_GoRaNA_PArma#muxrA_GoRaNA_PArma#noun#3#RM
Debt_Equity_Ratio	qNa_IkvitI_anupAwa#qNa_IkvitI_anupAwa#noun#3#RM
Demand_Promissory_Note	mAMga_vacana_pawra#mAMga_vacana_pawra#noun#3#RM
Deposit_Insurance_Credit_Guarantee_Corporation	nikRepa_bImA_Ora_prawyaya_gAraMtI_nigama#nikRepa_bImA_Ora_prawyaya_gAraMtI_nigama#noun#5#RM
Development_Assistance_Committee	vikAsa_sahAyawA_samiwi#vikAsa_sahAyawA_samiwi#noun#3#RM
Development_Loan_Fund	vikAsa_qNa_niXi#vikAsa_qNa_niXi#noun#3#RM
Differential_Rate_of_Interest_Scheme	viBexaka_bjAya_xara_yojanA#viBexaka_bjAya_xara_yojanA#noun#2#RM
Directorate_General_of_Shipping	jahAjZarAnI_mahAnixeSAlaya#jahAjZarAnI_mahAnixeSAlaya#noun#2#RM
Directorate_General_of_Technical_Development	wakanIkI_vikAsa_mahAnixeSAlaya#wakanIkI_vikAsa_mahAnixeSAlaya#noun#2#RM
District_Consultative_Committee	jilA_parAmarSaxAwrI_samiwi#jilA_parAmarSaxAwrI_samiwi#noun#3#RM
District_Credit_Plan	jilA_qNa_yojanA#jilA_qNa_yojanA#noun#3#RM
District_Industrial_Centre	jilA_Oxyogika_kenxra#jilA_Oxyogika_kenxra#noun#3#RM
District_Rural_Development_Agencies	jZilA_grAmINa_vikAsa_ejeMsI#jZilA_grAmINa_vikAsa_ejeMsI#noun#4#RM
Drought_Prone_Area_Programme	sUKA_pravaNa_kRewra_kAryakrama#sUKA_pravaNa_kRewra_kAryakrama#noun#4#RM
Duty_Drawback_Scheme	Sulka_vApasI_yojanA#Sulka_vApasI_yojanA#noun#3#RM
Duty_Exemption_Scheme	Sulka_CUta_yojanA#Sulka_CUta_yojanA#noun#3#RM
Economic_Commission_for_Africa	aPrIkI_ArWika_Ayoga#aPrIkI_ArWika_Ayoga#noun#4#RM
Economic_Commission_for_Area_and_the_Far_East	eSiyA_Ora_suxUra_pUrva_xeSoM_kA_ArWika_Ayoga#eSiyA_Ora_suxUra_pUrva_xeSoM_kA_ArWika_Ayoga#noun#8#RM
Economic_Commission_for_Latin_America	lEtina_amarIkA_kA_ArWika_Ayoga#lEtina_amarIkA_kA_ArWika_Ayoga#noun#5#RM
Employees_State_Insurance_Corporation	karmacArI_rAjya_bImA_nigama#karmacArI_rAjya_bImA_nigama#noun#4#RM
Engineering_Export_Promotion_Council	iMjIniyarI_niryAwa_saMvarXana_pariRaxa#iMjIniyarI_niryAwa_saMvarXana_pariRaxa#noun#4#RM
European_Economic_Community	yUropIya_ArWika_samuxAya#yUropIya_ArWika_samuxAya#noun#3#RM
European_Free_Trade_Association	yUropIya_mukwa_vyApAra_saMGa#yUropIya_mukwa_vyApAra_saMGa#noun#4#RM
European_Monetary_Agreement	yUropIya_muxrA_karAra#yUropIya_muxrA_karAra#noun#3#RM
European_Monetary_System	yUropIya_mOxrika_praNAlI#yUropIya_mOxrika_praNAlI#noun#3#RM
Export_Bills_Credit_Scheme	niryAwa_bila_qNa_yojanA#niryAwa_bila_qNa_yojanA#noun#4#RM
Export_Credit_Gurarantee_Corporation_of_India_Ltd	BArawIya_niryAwa_qNa_gAraMtI_nigama_li..#BArawIya_niryAwa_qNa_gAraMtI_nigama_li..#noun#4#RM
Export_Marketing_Fund_Programme_of_EXIM_Bank	ekjZima_bEMka_kA_niryAwa_vipaNana_niXi_kAryakrama#ekjZima_bEMka_kA_niryAwa_vipaNana_niXi_kAryakrama#noun#4#RM
Export_Promotion_Council	niryAwa_saMvarXana_pariRaxa#niryAwa_saMvarXana_pariRaxa#noun#3#RM
Extended_Fund_Facility	praxawwa_niXi_suviXA#praxawwa_niXi_suviXA#noun#3#RM
Farmers_Service_Societies	kqRaka_sevA_samiwiyAz#kqRaka_sevA_samiwiyAz#noun#3#RM
Finance_Ministry	vwwia_maMwrAlaya#vwwia_maMwrAlaya#noun#2#RM
Fixed_Deposit_Receipt	sAvaXi_jamA_rasIxa#sAvaXi_jamA_rasIxa#noun#3#RM
Food_Corporation_of_India	BArawIya_KAxya_nigama#BArawIya_KAxya_nigama#noun#2#RM
Foreign_Bills_Discounted	BunAye_gaye_vixeSI_bila#BunAye_gaye_vixeSI_bila#noun#3#RM
Foreign_Bills_Negotiated	parakrAmiwa_vixeSI_bila#parakrAmiwa_vixeSI_bila#noun#3#RM
Foreign_Bills_Purchased	KarIxe_gaye_vixeSI_bila#KarIxe_gaye_vixeSI_bila#noun#3#RM
Foreign_Bills_for_Collection	vasUlI_ke_lie_prApwa_vixeSI_bila#vasUlI_ke_lie_prApwa_vixeSI_bila#noun#4#RM
Foreign_Currency_Assets	vixeSI_muxrA_AswiyAz#vixeSI_muxrA_AswiyAz#noun#3#RM
Foreign_Exchange_Regulations_Act	vixeSI_muxrA_viniyamana_aXiniyama#vixeSI_muxrA_viniyamana_aXiniyama#noun#4#RM
Foreign_Inward_Remittance_Certificate	vixeSI_Avaka_preRaNa_pramANapawra#vixeSI_Avaka_preRaNa_pramANapawra#noun#4#RM
Foreign_Travel_Scheme	vixeSa_yAwrA_yojanA#vixeSa_yAwrA_yojanA#noun#3#RM
Foreign_Travel_Tax	vixeSa_yAwrA_kara#vixeSa_yAwrA_kara#noun#3#RM
Free_Trade_Zone	mukwa_vyApAra_kRewra#mukwa_vyApAra_kRewra#noun#3#RM
General_Agreement_of_Tariffs_and_Trade	tEriPa_Ora_vyApAra_saMbaMXI_sAmAnya_karAra#tEriPa_Ora_vyApAra_saMbaMXI_sAmAnya_karAra#noun#2#RM
General_Currency_Area_Licences	sAmAnya_muxrA_kRewra_lAiseMsa#sAmAnya_muxrA_kRewra_lAiseMsa#noun#4#RM
General_Insurance_Corporation	sAXAraNa_bImA_nigama#sAXAraNa_bImA_nigama#noun#3#RM
German_Democratic_Republic	jarmana_janavAxI_gaNarAjya#jarmana_janavAxI_gaNarAjya#noun#3#RM
Government_Promissory_Note	sarakArI_vacanapawra#sarakArI_vacanapawra#noun#3#RM
Gross_Domestic_Product	sakala_xeSI_uwpAxa#sakala_xeSI_uwpAxa#noun#3#RM
Gross_National_Product	sakala_rARtrIya_uwpAxa#sakala_rARtrIya_uwpAxa#noun#3#RM
High_Power_Committee	ucca_aXikAra_prApwa_samiwi#ucca_aXikAra_prApwa_samiwi#noun#3#RM
High_Yield_Varieties_Programme	aXika_upajavAlI_kismoM_kA_kAryakrama#aXika_upajavAlI_kismoM_kA_kAryakrama#noun#4#RM
Hindu_Undivided_Family	hinxU_aviBakwa_parivAra#hinxU_aviBakwa_parivAra#noun#3#RM
Housing_Development_Finance_Corporation	AvAsa_vikAsa_viwwa_nigama#AvAsa_vikAsa_viwwa_nigama#noun#4#RM
Import_REplenishment_Licence	AyAwa_puna:pUrwi_lAiseMsa#AyAwa_puna:pUrwi_lAiseMsa#noun#3#RM
Import_Trade_Control	AyAwa_vyApAra_niyaMwraNa#AyAwa_vyApAra_niyaMwraNa#noun#3#RM
India_Tourim_Development_Corporation	BArawa_paryatana_vikAsa_nigama#BArawa_paryatana_vikAsa_nigama#noun#4#RM
Indian_Accounts_and_Audit_Service	BArawIya_leKA_Ora_leKA-parIkRA_sevA#BArawIya_leKA_Ora_leKA-parIkRA_sevA#noun#5#RM
Indian_Council_of_Agricultural_Research	BArawIya_kqRi_anusaMXAna_pariRaxa#BArawIya_kqRi_anusaMXAna_pariRaxa#noun#2#RM
Indian_Farmers_Fertilisers_Corporation	BArawIya_kqRaka_urvaraka_nigama#BArawIya_kqRaka_urvaraka_nigama#noun#4#RM
Indian_Handicrafts_Development_Corporation	BArawIya_haswaSilpa_vikAsa_nigama#BArawIya_haswaSilpa_vikAsa_nigama#noun#4#RM
Indian_Institute_of_Bankers	BArawIya_bEMkara_saMsWAna#BArawIya_bEMkara_saMsWAna#noun#2#RM
Indira_Vikas_Patra	iMxirA_vikAsa_pawra#iMxirA_vikAsa_pawra#noun#3#RM
Industrial_Development_Bank_of_India	BArawIya_Oxyogika_vikAsa_bEMka#BArawIya_Oxyogika_vikAsa_bEMka#noun#3#RM
Industrial_Finance_Corporation_of_India	BArawIya_Oxyogika_viwwa_nigama#BArawIya_Oxyogika_viwwa_nigama#noun#3#RM
Industrial_Raw_Material_Assitance_Centre	Oxyogika_kaccA_mAla_sahAyawA_kenxra#Oxyogika_kaccA_mAla_sahAyawA_kenxra#noun#5#RM
Industrial_Reconstruction_Bank_of_India	BArawIya_Oxyogika_punarnirmANa_bEMka#BArawIya_Oxyogika_punarnirmANa_bEMka#noun#3#RM
Industrial_Training_Institute	Oxyogika_praSikRaNa_kenxra#Oxyogika_praSikRaNa_kenxra#noun#3#RM
Institutional_Credit_for_Agriculture_Rural_Development	qNa_vyavasWA_kI_punarIkRaNa_samiwi#qNa_vyavasWA_kI_punarIkRaNa_samiwi#noun#6#RM
Integrated_Rural_Development_Programme	samanviwa_grAmINa_vikAsa_kAryakrama#samanviwa_grAmINa_vikAsa_kAryakrama#noun#4#RM
Integrated_Tribal_Development_Project	samanviwa_janajAwi_vikAsa_pariyojanA#samanviwa_janajAwi_vikAsa_pariyojanA#noun#4#RM
Intensive_Agriculture_District_Programme	samAXAna_KewI_kA_jilA_kAryakrama#samAXAna_KewI_kA_jilA_kAryakrama#noun#4#RM
Intensive_Cotton_District_Programme	saGana_kapAsa_jilA_kAryakrama#saGana_kapAsa_jilA_kAryakrama#noun#4#RM
Intensive_Jute_Development_Programme	gahana_jUta_vikAsa_kAryakrama#gahana_jUta_vikAsa_kAryakrama#noun#4#RM
International_Air_Transport_Association	anwarrARtrIya_havAI_parivahana_saMGa#anwarrARtrIya_havAI_parivahana_saMGa#noun#4#RM
International_Bank_for_Reconstruction_and_Development	aMwarrARtrIya_punarnirmANa_Ora_vikAsa_bEMka#aMwarrARtrIya_punarnirmANa_Ora_vikAsa_bEMka#noun#6#RM
International_Credit_Card	aMwarrARtrIya_kredita_kArda#aMwarrARtrIya_kredita_kArda#noun#3#RM
International_Development_Association	aMwarrARtrIya_vikAsa_saMGa#aMwarrARtrIya_vikAsa_saMGa#noun#3#RM
International_Finance_Corporation	aMwarrARtrIya_viwwa_nigama#aMwarrARtrIya_viwwa_nigama#noun#3#RM
International_Fund_for_Agricultural_Development	aMwarrARtrIya_kqRi_vikAsa_niXi#aMwarrARtrIya_kqRi_vikAsa_niXi#noun#5#RM
International_Labour_Organization	aMwarrARtrIya_Srama_saMgaTana#aMwarrARtrIya_Srama_saMgaTana#noun#3#RM
International_Marketing_Federation	aMwarrARtrIya_vipaNana_mahAsaMGa#aMwarrARtrIya_vipaNana_mahAsaMGa#noun#3#RM
International_Monetary_Fund	aMwarrARtrIya_muxrA_koRa#aMwarrARtrIya_muxrA_koRa#noun#3#RM
Japan_External_Trade_Organisation	jApAnI_vixeSa_vyApAra_saMgaTana#jApAnI_vixeSa_vyApAra_saMgaTana#noun#4#RM
Jute_Corporation_of_India	BArawIya_jUta_nigama#BArawIya_jUta_nigama#noun#2#RM
Kandla_Free_Trade_Zone	kAMdalA_mukwa_vyApAra_kRewra#kAMdalA_mukwa_vyApAra_kRewra#noun#4#RM
Land_Development_Bank	BUmi_vikAsa_bEMka#BUmi_vikAsa_bEMka#noun#3#RM
Land_Mortgage_Bank	BUmi_banXaka_bEMka#BUmi_banXaka_bEMka#noun#3#RM
Lead_Bank_Scheme	agraNI_bEMka_yojanA#agraNI_bEMka_yojanA#noun#3#RM
Life_Insurance_Corporation_of_India	BArawIya_jIvana_bImA_nigama#BArawIya_jIvana_bImA_nigama#noun#3#RM
Marginal_Farmers_Development_Agency	sImAnwa_kqRaka_vikAsa_ejeMsI#sImAnwa_kqRaka_vikAsa_ejeMsI#noun#4#RM
Marginal_Farmers_and_Agricultural_Labourers_Agency	sImAnwa_kqRaka_Ora_Kewihara_majaxUra_ejeMsI#sImAnwa_kqRaka_Ora_Kewihara_majaxUra_ejeMsI#noun#6#RM
Minerals_Metals_Trading_Corporation_of_India	BArawIya_Kanija_Ora_XAwu_vyApAra_nigama#BArawIya_Kanija_Ora_XAwu_vyApAra_nigama#noun#4#RM
Motor_Transport_Receipt	motara_parivahana_rasIxa#motara_parivahana_rasIxa#noun#3#RM
National_Bank_for_Agricultural_and_Rural_Development	rARtrIya_kqRi_Ora_grAmINa_vikAsa_bEMka#rARtrIya_kqRi_Ora_grAmINa_vikAsa_bEMka#noun#7#RM
National_Commission_on_Agriculture	rARtrIya_kqRi_Ayoga#rARtrIya_kqRi_Ayoga#noun#4#RM
National_Dairy_Development_Board	rARtrIya_derI_vikAsa_borda#rARtrIya_derI_vikAsa_borda#noun#4#RM
National_Development_Council	rARtrIya_vikAsa_pariRaxa#rARtrIya_vikAsa_pariRaxa#noun#3#RM
National_Equity_Fund	rARtrIya_IkvitI_niXi#rARtrIya_IkvitI_niXi#noun#3#RM
National_Housing_Bank	rARtrIya_AvAsa_bEMka#rARtrIya_AvAsa_bEMka#noun#3#RM
National_Industrial_Classification	rARtrIya_Oxyogika_vargIkaraNa#rARtrIya_Oxyogika_vargIkaraNa#noun#3#RM
National_Industrial_Development_Corporation	rARtrIya_Oxyogika_vikAsa_nigama#rARtrIya_Oxyogika_vikAsa_nigama#noun#4#RM
National_Institute_of_Bank_Management	rARtrIya_bEMka_prabaMXa_saMsWAna#rARtrIya_bEMka_prabaMXa_saMsWAna#noun#2#RM
National_Institution_for_Training_in_Industrial_Engineering	rARtrIya_Oxyogika_iMjIniyarI_praSikRaNa_saMsWAna#rARtrIya_Oxyogika_iMjIniyarI_praSikRaNa_saMsWAna#noun#7#RM
National_Mineral_Development_Corporation	rARtrIya_Kanija_vikAsa_nigama#rARtrIya_Kanija_vikAsa_nigama#noun#4#RM
National_Rural_Development_Bonds	rARtrIya_grAmINa_vikAsa_bAMda#rARtrIya_grAmINa_vikAsa_bAMda#noun#4#RM
National_Rural_Development_Programme	rARtrIya_grAmINa_rojZagAra_kAryakrama#rARtrIya_grAmINa_rojZagAra_kAryakrama#noun#4#RM
National_Sample_Survey_Organisation	rARtrIya_pawixarSa_sarvekRaNa_saMgaTana#rARtrIya_pawixarSa_sarvekRaNa_saMgaTana#noun#4#RM
National_Saving_Certificate	rARtrIya_bacawa_pramANapawra#rARtrIya_bacawa_pramANapawra#noun#3#RM
National_Small_Industries_Corporation	rARtrIya_laGu_uxyoga_nigama#rARtrIya_laGu_uxyoga_nigama#noun#4#RM
National_Textile_Corporation	rARtrIya_vaswra_nigama#rARtrIya_vaswra_nigama#noun#3#RM
Neighbourhood_Travel_Scheme	padosI_xeSoM_kI_yAwrA_yojanA#padosI_xeSoM_kI_yAwrA_yojanA#noun#3#RM
No_Objection_Certificate	q`Apawwi_nahIM''#q`Apawwi_nahIM''#noun#3#RM
Non_Resident_External_Rupee_Account_Scheme	anivAsI_bAhaya_rupayA_KAwA_yojanA#anivAsI_bAhaya_rupayA_KAwA_yojanA#noun#6#RM
Official_Development_Assistance	AXikArika_vikAsa_sahAyawA#AXikArika_vikAsa_sahAyawA#noun#3#RM
Oil_Exporting_Developing_Countries	wela_niryAwaka_vikAsaSIla_xeSa#wela_niryAwaka_vikAsaSIla_xeSa#noun#4#RM
Oklahoma_City	oklahomA_Sahara#oklahomA_Sahara#noun#2#RM
Open_General_Licence	KulA_sAmAnya_lAiseMsa#KulA_sAmAnya_lAiseMsa#noun#3#RM
Outward_Bills_for_Collection	vasUlI_ke_lie_jAvaka_bila#vasUlI_ke_lie_jAvaka_bila#noun#4#RM
Primary_Agricultural_Credit_Society	prAWamika_kqRi_qNa_samiwi#prAWamika_kqRi_qNa_samiwi#noun#4#RM
Primary_Land_Development_Bank	prAWamika_BUmi_vikAsa_bEMka#prAWamika_BUmi_vikAsa_bEMka#noun#4#RM
Regional_Rural_Bank	kRewrIya_grAmINa_bEMka#kRewrIya_grAmINa_bEMka#noun#3#RM
Replenishment_Licence	puna:pUrwi_lAiseMsa#puna:pUrwi_lAiseMsa#noun#2#RM
Reserve_Bank_of_India	BArawIya_rijZarva_bEMka#BArawIya_rijZarva_bEMka#noun#2#RM
Returning_Indians_Foreign_Exchange_Entitlement_Scheme	svaxeSa_lOtanevAle_BArawIyoM_kI_vixeSI_muxrA_pAwrawA_yojanA#svaxeSa_lOtanevAle_BArawIyoM_kI_vixeSI_muxrA_pAwrawA_yojanA#noun#6#RM
Revised_Minimum_Need_Programme	saMSoXiwa_nyUnawama_AvaSyakawA_kAryakrama#saMSoXiwa_nyUnawama_AvaSyakawA_kAryakrama#noun#4#RM
Rural_Electrification_Corporation	grAmINa_vixyuwIkaraNa_nigama#grAmINa_vixyuwIkaraNa_nigama#noun#3#RM
Santacruz_Electronics_Export_Processing_Zone	sAMwAkrUja_ilektroYnika_niryAwa_aBisaMskaraNa_kRewra#sAMwAkrUja_ilektroYnika_niryAwa_aBisaMskaraNa_kRewra#noun#5#RM
Scheduled_Commercial_Bank	anusUciwa_vANijya_bEMka#anusUciwa_vANijya_bEMka#noun#3#RM
Selective_Credit_Control	cayanAwmaka_qNa_niyaMwraNa#cayanAwmaka_qNa_niyaMwraNa#noun#3#RM
Shipping_Corporation_of_India	BArawIya_nOvahana_nigama#BArawIya_nOvahana_nigama#noun#2#RM
Ships_Acquired_From_Abroad_Under_New_Scheme	nayI_yojanA_ke_aMwargawa_vixeSoM_se_prApwa_jahAja#nayI_yojanA_ke_aMwargawa_vixeSoM_se_prApwa_jahAja#noun#7#RM
Small_Farmers_Development_Agency	laGu_kqRaka_vikAsa_ejeMsI#laGu_kqRaka_vikAsa_ejeMsI#noun#4#RM
Small_Farmers_Development_Corporation	laGu_kqRaka_vikAsa_nigama#laGu_kqRaka_vikAsa_nigama#noun#4#RM
Small_Industries_Development_Fund	laGu_uxyoga_vikAsa_niXi#laGu_uxyoga_vikAsa_niXi#noun#4#RM
Small_Industries_Development_Organisation	laGu_uxyoga_vikAsa_saMGaTana#laGu_uxyoga_vikAsa_saMGaTana#noun#4#RM
Small_Loan_Guarantee_Scheme	laGu_qNa_gAraMtI_yojanA#laGu_qNa_gAraMtI_yojanA#noun#4#RM
Special_United_Nations_Fund_for_Economic_Development	ArWika_vikAsa_kI_viSeRa_saMyukwa_rARtra_niXi#ArWika_vikAsa_kI_viSeRa_saMyukwa_rARtra_niXi#noun#7#RM
Standing_Committee_on_Export_Finance	niryAwa_viwwa_saMbaMXI_sWAyI_samiwi#niryAwa_viwwa_saMbaMXI_sWAyI_samiwi#noun#5#RM
Standing_Coordination_Committee	sWAyI_samanvayana_samiwi#sWAyI_samanvayana_samiwi#noun#3#RM
State_Bank_of_India	BArawIya_steta_bEMka#BArawIya_steta_bEMka#noun#2#RM
State_Electricity_Board	rAjya_vixyuwa_borda#rAjya_vixyuwa_borda#noun#3#RM
State_Financial_Corporation	rAjya_viwwIya_nigama#rAjya_viwwIya_nigama#noun#3#RM
State_Industrial_Development_Corporation	rAjya_Oxyogika_vikAsa_nigama#rAjya_Oxyogika_vikAsa_nigama#noun#4#RM
State_Industrial_Investment_Corporation	rAjya_Oxyogika_niveSa_nigama#rAjya_Oxyogika_niveSa_nigama#noun#4#RM
State_Land_Development_Bank	rAjya_BUmi_vikAsa_bEMka#rAjya_BUmi_vikAsa_bEMka#noun#4#RM
State_Level_Banking_Committee	rAjyaswarIya_bEMkiMga_samiwi#rAjyaswarIya_bEMkiMga_samiwi#noun#4#RM
State_Level_Inter_Institutional_Committee	rAjyaswarIya_aMwara_saMsWAgawa_samiwi#rAjyaswarIya_aMwara_saMsWAgawa_samiwi#noun#5#RM
State_Small_Industries_Development_Corporation	rAjya_laGu_uxyoga_vikAsa_nigama#rAjya_laGu_uxyoga_vikAsa_nigama#noun#5#RM
State_Trading_Corporation	rAjya_vyApAra_nigama#rAjya_vyApAra_nigama#noun#3#RM
State_Warehousing_Corporation	rAjya_BANdAgAraNa_nigama#rAjya_BANdAgAraNa_nigama#noun#3#RM
Statistical_Commission	sAMKyikIya_Ayoga#sAMKyikIya_Ayoga#noun#2#RM
Statutory_Cash_Reserve	sAMviXika_nakaxI_prArakRiwa_niXi#sAMviXika_nakaxI_prArakRiwa_niXi#noun#3#RM
Statutory_Liquidity_Ratio	sAMviXika_calaniXi_anupAwa#sAMviXika_calaniXi_anupAwa#noun#3#RM
Statutory_Reserve_Fund	sAMviXika_prArakRiwa_niXi#sAMviXika_prArakRiwa_niXi#noun#3#RM
Steel_Authority_of_India	BArawIya_ispAwa_prAXikaraNa#BArawIya_ispAwa_prAXikaraNa#noun#2#RM
Tea_Trading_Corporation_of_India	BArawIya_cAya_vyApAra_nigama#BArawIya_cAya_vyApAra_nigama#noun#3#RM
Trade_Development_Authority_of_India	BArawIya_vyApAra_vikAsa_prAXikaraNa#BArawIya_vyApAra_vikAsa_prAXikaraNa#noun#3#RM
Trade_Fair_Authority_of_India	BArawIya_vyApAra_melA_prAXikaraNa#BArawIya_vyApAra_melA_prAXikaraNa#noun#3#RM
Uniform_Customs_Procedure	samarUpa_viXi_prakriyA#samarUpa_viXi_prakriyA#noun#3#RM
Union_Cabinet	kenxrIya_maMwrImaMdala#kenxrIya_maMwrImaMdala#noun#2#RM
Union_Public_Service_Commission	saMGa_loka_sevA_Ayoga#saMGa_loka_sevA_Ayoga#noun#4#RM
Unit_Trust_of_India	BArawIya_yUnita_trasta#BArawIya_yUnita_trasta#noun#2#RM
Unitarian_Church	axvEwavAxI_girajAGara#axvEwavAxI_girajAGara#noun#2#RM
United_Arab_Emirates	saMyukwa_araba_amIrAwa#saMyukwa_araba_amIrAwa#noun#3#RM
United_Nations_Conference_on_Trade_and_Development	saMyukwa_rARtra_vyApAra_Ora_vikAsa_sammelana#saMyukwa_rARtra_vyApAra_Ora_vikAsa_sammelana#noun#7#RM
United_Nations_Technical_Assitance_Board	saMyukwa_rARtra_wakanIkI_sahAyawA_borda#saMyukwa_rARtra_wakanIkI_sahAyawA_borda#noun#5#RM
United_States_Information_Services	saMyukwa_rAjya_sUcanA_sevA#saMyukwa_rAjya_sUcanA_sevA#noun#4#RM
World_Health_Organisation	viSva_svAsWya_saMgaTana#viSva_svAsWya_saMgaTana#noun#3#RM
