Aboriginal_Australian	oYstreliyAyI_AxivAsI#oYstreliyAyI_AxivAsI#noun#2#RM
Albert_Edward	alabarta_edavarda#alabarta_edavarda#noun#2#RM
Albert_Einstein	Albarta_AinastEna#Albarta_AinastEna#noun#2#RM
American_Dream	amerIkI_svapna#amerIkI_svapna#noun#2#RM
American_English	amarIkI_aMgrejI#amarIkI_aMgrejI#noun#2#RM
Anglican_Catholic	aMgalIkana_kEWolika#aMgalIkana_kEWolika#noun#2#RM
Anglican_Church	AMgla_girajAGara#AMgla_girajAGara#noun#2#RM
Anglican_Communion	AMglo_kamyUniyana#AMglo_kamyUniyana#noun#2#RM
symmetric_Tool_Book	asamayiwa_tUla_buka#asamayiwa_tUla_buka#noun#3#RM
Australian_Aborigine	oYstreliyA_kA_prAcInaxeSavAsI#oYstreliyA_kA_prAcInaxeSavAsI#noun#2#RM
Baptist_Church	bapawismA_girajAGara#bapawismA_girajAGara#noun#2#RM
Black_African	kAlA_aPZrIkI#kAlA_aPZrIkI#noun#2#RM
Catholic_Church	kEWolika_girajAGara#kEWolika_girajAGara#noun#2#RM
Celestial_City	xivya_Sahara#xivya_Sahara#noun#2#RM
Central_Africa	maXya_aPZrIkA#maXya_aPZrIkA#noun#2#RM
Central_America	maXya_amarIkA#maXya_amarIkA#noun#2#RM
Central_American	maXya_amarIkI#maXya_amarIkI#noun#2#RM
Central_Dravidian	maXya_xravidZIya#maXya_xravidZIya#noun#2#RM
Communist_China	sAmyavAxa_cIna#sAmyavAxa_cIna#noun#2#RM
Congregational_Church	sAmuxAyika_girajAGara#sAmuxAyika_girajAGara#noun#2#RM
Coptic_Church	misrI_IsAI_girajAGara#misrI_IsAI_girajAGara#noun#2#RM
Corpus_Christi	kArpasa_kristI#kArpasa_kristI#noun#2#RM
Eastern_Catholicism	pUrvI_kEWolika_Xarma#pUrvI_kEWolika_Xarma#noun#2#RM
Eastern_Church	yUnAnI_girajAGara#yUnAnI_girajAGara#noun#2#RM
European_Common_Market	yUropIya_sAJA_bAjAra#yUropIya_sAJA_bAjAra#noun#3#RM
European_Currency_Unit	yUropIya_muxrA_ikAI#yUropIya_muxrA_ikAI#noun#3#RM
Fleet_Admiral	PlIta_edamirala{nOsenA_kA_ucca_aXikArI}#PlIta_edamirala{nOsenA_kA_ucca_aXikArI}#noun#2#RM
Fleet_Street	PlIta_strIta{laMxana_kI_eka_sadZaka_kA_nAma}#PlIta_strIta{laMxana_kI_eka_sadZaka_kA_nAma}#noun#2#RM
Flying_Dutchman	havAI_jahAjZa_xala_kA_hAlEMda_nivAsI#havAI_jahAjZa_xala_kA_hAlEMda_nivAsI#noun#2#RM
French_Congo	PrAMsIsI_kAMgo#PrAMsIsI_kAMgo#noun#2#RM
French_Fries	AlU_ke_lambe_kaware{wale_hue}#AlU_ke_lambe_kaware{wale_hue}#noun#2#RM
Gautama_Buddha	gOwama_buxXa#gOwama_buxXa#noun#2#RM
Greek_Catholic	grIka_kEWolika#grIka_kEWolika#noun#2#RM
Greek_Church	yUnAnI_girajAGara#yUnAnI_girajAGara#noun#2#RM
Jesus_Christ	IsA_masIha#IsA_masIha#noun#2#RM
John_Doe	joYna_do#joYna_do#noun#2#RM
John_Donne	joYna_donI#joYna_donI#noun#2#RM
Julius_Caesar	jUliyasa_sIjZara#jUliyasa_sIjZara#noun#2#RM
Kansas_City	kAnasAsa_Sahara#kAnasAsa_Sahara#noun#2#RM
Lutheran_Church	lUWaravAxa_girajAGara#lUWaravAxa_girajAGara#noun#2#RM
Methodist_Church	niyamavAxI_girajAGara#niyamavAxI_girajAGara#noun#2#RM
Mexico_City	mEksiko_Sahara#mEksiko_Sahara#noun#2#RM
Middle_East	araba_xeSa#araba_xeSa#noun#2#RM
Middle_English	maXyavargIya_aMgrejI#maXyavargIya_aMgrejI#noun#2#RM
Mormon_Church	XArmika_jAwi_kA_girajAGara#XArmika_jAwi_kA_girajAGara#noun#2#RM
Neolithic_Age	navapARANa_yuga#navapARANa_yuga#noun#2#RM
New_Britain	neyu_britana#neyu_britana#noun#2#RM
New_York	nyUyArka#nyUyArka#noun#2#RM
New_York_City	nyUyArka_Sahara#nyUyArka_Sahara#noun#3#RM
North_America	uwwarI_amarIkA#uwwarI_amarIkA#noun#2#RM
North_American_sales	uwwara_amarIkI_xvArA_bikrI#uwwara_amarIkI_xvArA_bikrI#noun#3#RM
North_American	uwwarI_amarIkI#uwwarI_amarIkI#noun#2#RM
North_Carolina	uwwarI_kerolAinA#uwwarI_kerolAinA#noun#2#RM
North_Dravidian	uwwara_xravidZIya#uwwara_xravidZIya#noun#2#RM
Panama_City	panAmA_Sahara#panAmA_Sahara#noun#2#RM
Presbyterian_Church	pAxarI_praSAsanavAxI_girajAGara#pAxarI_praSAsanavAxI_girajAGara#noun#2#RM
Roman_Catholic	romana_keWolika#romana_keWolika#noun#2#RM
Roman_Catholicism	romana_kEWolika_Xarma#romana_kEWolika_Xarma#noun#2#RM
Roman_Church	romana_girajAGara#romana_girajAGara#noun#2#RM
Roman_Empire	roma_kA_sAmrAjya#roma_kA_sAmrAjya#noun#2#RM
Rome_Beauty	roma_kI_sunxarawA#roma_kI_sunxarawA#noun#2#RM
Saint_Emilion	seMta_emiliyana#seMta_emiliyana#noun#2#RM
San_Diego	sEndIyAgo#sEndIyAgo#noun#2#RM
Santa_Claus	sEMtA_klAjZa#sEMtA_klAjZa#noun#2#RM
Santa_Clause	sEMtAklojZa#sEMtAklojZa#noun#2#RM
Scotch_Egg	walA_aMdA{goSwa_lagA_huA}#walA_aMdA{goSwa_lagA_huA}#noun#2#RM
Scots_English	skAta_kI_aMgrejI#skAta_kI_aMgrejI#noun#2#RM
South_African	xakRiNa_aPZrIkI#xakRiNa_aPZrIkI#noun#2#RM
South_America	xakRiNI_amarIkA#xakRiNI_amarIkA#noun#2#RM
South_American	xakRiNI_amarIkI#xakRiNI_amarIkI#noun#2#RM
South_Australia	xakRiNI_oYstreliyA#xakRiNI_oYstreliyA#noun#2#RM
South_Carolina	xakRiNa_kerolAinA#xakRiNa_kerolAinA#noun#2#RM
South_Dravidian	xakRiNa_xravidZIya#xakRiNa_xravidZIya#noun#2#RM
Spanish_Armada	spena_ke_ladZAkU_jahAjZa#spena_ke_ladZAkU_jahAjZa#noun#2#RM
Swiss_Confederation	svisa_saMgaTana#svisa_saMgaTana#noun#2#RM
Thomas_Edison	WAmsa_edisana#WAmsa_edisana#noun#2#RM
West_African	paScimI_aPZrIkI#paScimI_aPZrIkI#noun#2#RM
Western_Australia	paScimI_oYstreliyA#paScimI_oYstreliyA#noun#2#RM
Western_Church	pAScAwya_girajAGara#pAScAwya_girajAGara#noun#2#RM
Afghan_hound	laMmbe_bAlo_vAlA_kuwwA#laMmbe_bAlo_vAlA_kuwwA#noun#2#RM
African_chameleon	aPrIkI_giragita#aPrIkI_giragita#noun#2#RM
African_elephant	aPrIkI_hAWI#aPrIkI_hAWI#noun#2#RM
Air_mosaic	vAyu_mojZEka#vAyu_mojZEka#noun#2#RM
Alaska_cedar	alAskA_xevaxAra#alAskA_xevaxAra#noun#2#RM
Alaska_cod	alAskA_kAda#alAskA_kAda#noun#2#RM
Albanian_capital	alabeniyA_kI_rAjaXAnI#alabeniyA_kI_rAjaXAnI#noun#2#RM
Algerian_capital	alajIriyA_kI_rAjaXAnI#alajIriyA_kI_rAjaXAnI#noun#2#RM
Algerian_dinar	aljIriyAI_xInAra#aljIriyAI_xInAra#noun#2#RM
American_antelope	amarIkI_hiraNa#amarIkI_hiraNa#noun#2#RM
American_badger	amarIkI_bijjU#amarIkI_bijjU#noun#2#RM
American_barberry	amarIkana_JadZaberI#amarIkana_JadZaberI#noun#2#RM
American_beech	amarIkI_bIcavqkRa#amarIkI_bIcavqkRa#noun#2#RM
American_bittersweet	eka_prakAra_kA_amarIkI_XawUrA#eka_prakAra_kA_amarIkI_XawUrA#noun#2#RM
American_buffalo	amerikA_kI_BEMsa#amerikA_kI_BEMsa#noun#2#RM
American_capital	amarIkI_rAjaXAnI#amarIkI_rAjaXAnI#noun#2#RM
American_chameleon	amarIkI_giragita#amarIkI_giragita#noun#2#RM
American_cheese	amarIkI_panIra#amarIkI_panIra#noun#2#RM
American_chestnut	amarIkI_cestanata#amarIkI_cestanata#noun#2#RM
American_cockroach	amarIkI_wilacattA#amarIkI_wilacattA#noun#2#RM
American_coot	amarIkI_murgAbI_pakRI#amarIkI_murgAbI_pakRI#noun#2#RM
American_dewberry	amerikI_dyUberI#amerikI_dyUberI#noun#2#RM
American_dogwood	amerIkI_doYgavuda#amerIkI_doYgavuda#noun#2#RM
American_eagle	amerikI_gixXa#amerikI_gixXa#noun#2#RM
American_egret	amarIkI_bagulA#amarIkI_bagulA#noun#2#RM
American_elder	amarIkI_bujurga#amarIkI_bujurga#noun#2#RM
American_elk	amarIkI_bArahasiMgA#amarIkI_bArahasiMgA#noun#2#RM
American_elm	amarIkI_xevaxAru#amarIkI_xevaxAru#noun#2#RM
Angolan_capital	aMgolana_rAjaXAnI#aMgolana_rAjaXAnI#noun#2#RM
Angora_cat	aMgorA_billI#aMgorA_billI#noun#2#RM
Antarctic_continent	xakRiNaXruvIya_mahAxvIpa#xakRiNaXruvIya_mahAxvIpa#noun#2#RM
Arab_chief	araba_pramuKa#araba_pramuKa#noun#2#RM
Arabian_camel	arabI_Uzta#arabI_Uzta#noun#2#RM
Arabian_coffee	arabI_kAPZI#arabI_kAPZI#noun#2#RM
Arabic_alphabet	arabI_akRara#arabI_akRara#noun#2#RM
Arizona_ash	ErijZonA_meM_pAyA_jAne_vAlA_aMgU_vqkRa#ErijZonA_meM_pAyA_jAne_vAlA_aMgU_vqkRa#noun#2#RM
Asiatic_buffalo	eSiyA_kI_BEMsa#eSiyA_kI_BEMsa#noun#2#RM
Asiatic_cholera	eSiyAI_kAlarA#eSiyAI_kAlarA#noun#2#RM
Atlas_cedar	atalesa_xevaxAra#atalesa_xevaxAra#noun#2#RM
Australia_chestnut	AstreliyAI_cestanata#AstreliyAI_cestanata#noun#2#RM
Australian_blacksnake	oYstreliyA_kA_kAlA_sAzpa#oYstreliyA_kA_kAlA_sAzpa#noun#2#RM
Australian_capital	AstreliyAI_rAjaXAnI#AstreliyAI_rAjaXAnI#noun#2#RM
Australian_dollar	AstreliyAI_doYlara#AstreliyAI_doYlara#noun#2#RM
Austrian_capital	Astriyana_rAjaXAnI#Astriyana_rAjaXAnI#noun#2#RM
Bahamian_dollar	bahAmiyI_doYlara#bahAmiyI_doYlara#noun#2#RM
Bahrain_dinar	baharEnI_xInAra#baharEnI_xInAra#noun#2#RM
Baptistic_doctrine	bapawismA_kA_sixXAnwa#bapawismA_kA_sixXAnwa#noun#2#RM
Barbados_dollar	bArbedosa_kA_doYlara#bArbedosa_kA_doYlara#noun#2#RM
Beijing_dialect	bEjiMga_kI_bolI#bEjiMga_kI_bolI#noun#2#RM
Belady's_anomaly	belAdI_asaMgawi#belAdI_asaMgawi#noun#2#RM
Belgian_capital	beljiyana_rAjaXAnI#beljiyana_rAjaXAnI#noun#2#RM
Belgian_endive	beljiyama_cikarI#beljiyama_cikarI#noun#2#RM
Benjamin_bush	benjAmina_nAma_kI_JAdZI#benjAmina_nAma_kI_JAdZI#noun#2#RM
Bermuda_cedar	baramUdA_xevaxAra#baramUdA_xevaxAra#noun#2#RM
Bermuda_dollar	beramUdAI_doYlara#beramUdAI_doYlara#noun#2#RM
Boston_bull	bostana_kA_vqRaBa#bostana_kA_vqRaBa#noun#2#RM
Brazilian_capital	brAjZIliyana_rAjaXAnI#brAjZIliyana_rAjaXAnI#noun#2#RM
British_capital	bratiSa_rAjaXAnI#bratiSa_rAjaXAnI#noun#2#RM
Brunei_dollar	brUneI_doYlara#brUneI_doYlara#noun#2#RM
Brussels_carpet	brasala_kAlIna#brasala_kAlIna#noun#2#RM
Bulgarian_capital	balageriyana_rAjaXAnI#balageriyana_rAjaXAnI#noun#2#RM
Burmese_cat	barmA_billI#barmA_billI#noun#2#RM
Cabin_class	kebina_kakRa#kebina_kakRa#noun#2#RM
California_bluebell	kElIPZorniyA_kA_nIla_GaNtA#kElIPZorniyA_kA_nIla_GaNtA#noun#2#RM
California_buckthorn	kElIPorniyA_kI_bakaWorna_nAma_kI_JAdZI#kElIPorniyA_kI_bakaWorna_nAma_kI_JAdZI#noun#2#RM
California_coffee	kEliPZAraniyA_kAPZI#kEliPZAraniyA_kAPZI#noun#2#RM
Cambodian_capital	kambodiyana_rAjaXAnI#kambodiyana_rAjaXAnI#noun#2#RM
Canadian_aspen	kEnedA_kA_EspinavqkRa#kEnedA_kA_EspinavqkRa#noun#2#RM
Canadian_capital	kanEdiyana_rAjaXAnI#kanEdiyana_rAjaXAnI#noun#2#RM
Canadian_dollar	kenediyana_doYlara#kenediyana_doYlara#noun#2#RM
Canterbury_bell	kEMtarbarI_GaMtI#kEMtarbarI_GaMtI#noun#2#RM
Canterbury_bells	kEMtarbarI_GaMtiyAz#kEMtarbarI_GaMtiyAz#noun#2#RM
Cheshire_cheese	ceSAyara_panIra#ceSAyara_panIra#noun#2#RM
Chilean_cedar	cIliyana_xevaxAra#cIliyana_xevaxAra#noun#2#RM
Chinese_cabbage	cIna_kI_pawwA_goBI#cIna_kI_pawwA_goBI#noun#2#RM
Chinese_celery	cAyanIjZa_selarI#cAyanIjZa_selarI#noun#2#RM
Chinese_character	cInI_pAwra#cInI_pAwra#noun#2#RM
Chinese_checkers	cAInIjZa_cekaras_kA_Kela#cAInIjZa_cekaras_kA_Kela#noun#2#RM
Chinese_chestnut	cInI_cestanata#cInI_cestanata#noun#2#RM
Chinese_cinnamon	cInI_sigareta#cInI_sigareta#noun#2#RM
Chinese_elm	cInI_xevaxAru#cInI_xevaxAru#noun#2#RM
Colorado_beetle	kolErEdo_BqMga#kolErEdo_BqMga#noun#2#RM
Com_port	koYma_xvAraka#koYma_xvAraka#noun#2#RM
Cuban_capital	kyUbA_kI_rAjaXAnI#kyUbA_kI_rAjaXAnI#noun#2#RM
Danish_blue	XenumArgIya_nIlA#XenumArgIya_nIlA#noun#2#RM
Danish_capital	dEniSa_rAjaXAnI#dEniSa_rAjaXAnI#noun#2#RM
Easter_cactus	Istara_nAgaPZanI#Istara_nAgaPZanI#noun#2#RM
Easter_card	Istara_kArda#Istara_kArda#noun#2#RM
Egyptian_bean	ijipta_kI_PalI#ijipta_kI_PalI#noun#2#RM
Egyptian_capital	ijipta_kI_rAjaXAnI#ijipta_kI_rAjaXAnI#noun#2#RM
Egyptian_cat	ijipSiyana_billI#ijipSiyana_billI#noun#2#RM
Egyptian_cobra	miSra_xeSa_kI_sApaz#miSra_xeSa_kI_sApaz#noun#2#RM
Egyptian_corn	miSrI_makaI#miSrI_makaI#noun#2#RM
English_bean	aMgarejZI_PalI#aMgarejZI_PalI#noun#2#RM
English_bulldog	aMgrejZI_buladoYga#aMgrejZI_buladoYga#noun#2#RM
English_class	aMgrejZI_kakRA#aMgrejZI_kakRA#noun#2#RM
English_elm	iMglEMda_kA_xevaxAru#iMglEMda_kA_xevaxAru#noun#2#RM
Ethiopian_banana	IWiyopiyAI_kelA#IWiyopiyAI_kelA#noun#2#RM
Euler's_method	AEYyalara_viXi#AEYyalara_viXi#noun#2#RM
Eurasian_badger	yUreSiyana_bijjU#yUreSiyana_bijjU#noun#2#RM
European_ash	yUropameM_pAyA_jAne_vAlA_aMgU_vqkRa#yUropameM_pAyA_jAne_vAlA_aMgU_vqkRa#noun#2#RM
European_barberry	yUropIya_JadZaberI#yUropIya_JadZaberI#noun#2#RM
European_bean	yUropIya_PalI#yUropIya_PalI#noun#2#RM
European_beech	yUropIya_bIcavqkRa#yUropIya_bIcavqkRa#noun#2#RM
European_blackbird	yUropa_kA_kaswUrA#yUropa_kA_kaswUrA#noun#2#RM
European_blueberry	yoropIya_JaraberI#yoropIya_JaraberI#noun#2#RM
European_box	yUropa_kI_petI#yUropa_kI_petI#noun#2#RM
European_bream	yUropa_kI_eka_prakAra_kI_maCalI#yUropa_kI_eka_prakAra_kI_maCalI#noun#2#RM
European_catfish	yoropiyana_aSalka_mIna#yoropiyana_aSalka_mIna#noun#2#RM
European_chestnut	yUropIya_cestanata#yUropIya_cestanata#noun#2#RM
European_dewberry	yUropa_dyUberI#yUropa_dyUberI#noun#2#RM
European_dogtooth	yUropIya_doYgatUWa#yUropIya_doYgatUWa#noun#2#RM
European_elder	yUropIya_bujurga#yUropIya_bujurga#noun#2#RM
European_elk	yUropIya_bArahasiMgA#yUropIya_bArahasiMgA#noun#2#RM
European_elm	yUropIya_xevaxAru#yUropIya_xevaxAru#noun#2#RM
Fiji_dollar	PZijI_doYlara#PZijI_doYlara#noun#2#RM
French_bean	PZarAsabIna#PZarAsabIna#noun#2#RM
French_blue	PZrAMsIsI_nIlA#PZrAMsIsI_nIlA#noun#2#RM
French_bread	PrAMsa_kI_dabalarotI#PrAMsa_kI_dabalarotI#noun#2#RM
French_bulldog	PrAMsa_kA_buladoYga#PrAMsa_kA_buladoYga#noun#2#RM
French_capital	PrAMsa_kI_rAjaXAnI#PrAMsa_kI_rAjaXAnI#noun#2#RM
French_chalk	PreMca_KadZiyA#PreMca_KadZiyA#noun#2#RM
French_door	PreMca_xaravAjZA#PreMca_xaravAjZA#noun#2#RM
French_dressing_for_fruit_salad	PaloM_ke_salAxa_ke_lie_PreMca_dresiMga#PaloM_ke_salAxa_ke_lie_PreMca_dresiMga#noun#5#RM
French_dressing	PreMca_dresiMga#PreMca_dresiMga#noun#2#RM
French_endive	PreMca_cikarI#PreMca_cikarI#noun#2#RM
Gothic_arch	goYWika_meharAba#goYWika_meharAba#noun#2#RM
Gothic_architecture	goYWika_vAswukalA#goYWika_vAswukalA#noun#2#RM
Greek_architecture	yUnAnI_vAswukalA#yUnAnI_vAswukalA#noun#2#RM
Greek_capital	grIka_kI_rAjaXAnI#grIka_kI_rAjaXAnI#noun#2#RM
Greek_chorus	yUnAnI_vqMxagAna#yUnAnI_vqMxagAna#noun#2#RM
Gregorian_calendar	gregarI_kA_kEleMdara#gregarI_kA_kEleMdara#noun#2#RM
Gregorian_chant	grIgoriyana`nArA#grIgoriyana`nArA#noun#2#RM
Grenada_dollar	grenediyana_doYlara#grenediyana_doYlara#noun#2#RM
Guyana_dollar	gayAnA_doYlara#gayAnA_doYlara#noun#2#RM
Hebrew_calendar	hibru_kA_kEleMdara#hibru_kA_kEleMdara#noun#2#RM
Hungarian_capital	haMgrI_kI_rAjaXAnI#haMgrI_kI_rAjaXAnI#noun#2#RM
Himalayan_cedar	himAlaya_xevaxAra#himAlaya_xevaxAra#noun#2#RM
Hindu_calendar	hinxu_kEleMdara#hinxu_kEleMdara#noun#2#RM
Indian_agent	BArawIya_prawiniXi#BArawIya_prawiniXi#noun#2#RM
Indian_banyan	XvajA_vAhaka_sAmaMwa#XvajA_vAhaka_sAmaMwa#noun#2#RM
Indian_bean	BArawIya_sema#BArawIya_sema#noun#2#RM
Indian_beech	BArawIya_bIcavqkRa#BArawIya_bIcavqkRa#noun#2#RM
Indian_beet	BArawIya_cukaMxara#BArawIya_cukaMxara#noun#2#RM
Indian_blanket	BArawIya_kambala#BArawIya_kambala#noun#2#RM
Indian_buffalo	BArawIya_BEMsa#BArawIya_BEMsa#noun#2#RM
Indian_capital	BArawIya_rAjaXAnI#BArawIya_rAjaXAnI#noun#2#RM
Indian_chief	BArawIya_pramuKa#BArawIya_pramuKa#noun#2#RM
Indian_chocolate	cAkaleta#cAkaleta#noun#2#RM
Indian_cholera	kAlarA#kAlarA#noun#2#RM
Indian_club	BArawIya_klaba#BArawIya_klaba#noun#2#RM
Indian_cobra	nAga#nAga#noun#2#RM
Indian_corn	makaI#makaI#noun#2#RM
Indian_elephant	BArawIya_hAWI#BArawIya_hAWI#noun#2#RM
Iranian_capital	IrAnI_rAjaXAnI#IrAnI_rAjaXAnI#noun#2#RM
Iranian_dinar	irAnI_xInAra#irAnI_xInAra#noun#2#RM
Iraqi_dinar	irAkI_xInAra#irAkI_xInAra#noun#2#RM
Irish_bull	AyararlEMda_kA_vqRaBa#AyararlEMda_kA_vqRaBa#noun#2#RM
Irish_burgoo	AyariSa_nAvikoM_kA_KAxya_viSeRa#AyariSa_nAvikoM_kA_KAxya_viSeRa#noun#2#RM
Irish_capital	AiriSa_rAjaXAnI#AiriSa_rAjaXAnI#noun#2#RM
Irish_coffee	AyaralEMda_kAPZI#AyaralEMda_kAPZI#noun#2#RM
Italian_bee	italI_kI_maXumakKI#italI_kI_maXumakKI#noun#2#RM
Italian_bread	italI_kI_dabalarotI#italI_kI_dabalarotI#noun#2#RM
Italian_capital	italI_kI_rAjaXAnI#italI_kI_rAjaXAnI#noun#2#RM
Italian_dressing	itAliyana_dresiMga#itAliyana_dresiMga#noun#2#RM
Jamaica_apple	jamEkA_kA_seba#jamEkA_kA_seba#noun#2#RM
Jamaica_dogwood	jamEkI_doYgavuda#jamEkI_doYgavuda#noun#2#RM
Jamaican_capital	jamEkA_kI_rAjaXAnI#jamEkA_kI_rAjaXAnI#noun#2#RM
Jamaican_cherry	jamEkA_cerI#jamEkA_cerI#noun#2#RM
Jamaican_dollar	jamEkI_doYlara#jamEkI_doYlara#noun#2#RM
Japan_cedar	jApAna_xevaxAra#jApAna_xevaxAra#noun#2#RM
Japanese_apricot	jApAnI_KubAnI#jApAnI_KubAnI#noun#2#RM
Japanese_banana	jApAnI_kelA#jApAnI_kelA#noun#2#RM
Japanese_barberry	jApAnI_JadZaberI#jApAnI_JadZaberI#noun#2#RM
Japanese_beech	jApAnI_bIcavqkRa#jApAnI_bIcavqkRa#noun#2#RM
Japanese_beetle	jApAnI_BqMga#jApAnI_BqMga#noun#2#RM
Japanese_brome	jApAnI_broma_nAma_kI_GAsa#jApAnI_broma_nAma_kI_GAsa#noun#2#RM
Japanese_capital	jApAna_kI_rAjaXAnI#jApAna_kI_rAjaXAnI#noun#2#RM
Japanese_cedar	jApAnI_xevaxAra#jApAnI_xevaxAra#noun#2#RM
Japanese_cherry	jApAnI_cerI#jApAnI_cerI#noun#2#RM
Japanese_chess	jApAnI_SawaraMja#jApAnI_SawaraMja#noun#2#RM
Japanese_chestnut	jApAnI_cestanata#jApAnI_cestanata#noun#2#RM
Jersey_elm	jarsI_xevaxAru#jarsI_xevaxAru#noun#2#RM
Jewish_calendar	yahUxiyoM_kA_kEleMdara#yahUxiyoM_kA_kEleMdara#noun#2#RM
Jordanian_dinar	joradAna_muxrA#joradAna_muxrA#noun#2#RM
Julian_calendar	jUliyana_kEleMdara#jUliyana_kEleMdara#noun#2#RM
Kohinoor	kohinUra#kohinUra#noun#3#RM
Komodo_dragon	komodo_dregana#komodo_dregana#noun#2#RM
Kuwaiti_dinar	kuvEwI_xInAra#kuvEwI_xInAra#noun#2#RM
Kuwaiti_dirham	kuvEwI_xirahama#kuvEwI_xirahama#noun#2#RM
Laotian_capital	lAoSiyA_kI_rAjaXAnI#lAoSiyA_kI_rAjaXAnI#noun#2#RM
Liberian_capital	liberiyA_kI_rAjaXAnI#liberiyA_kI_rAjaXAnI#noun#2#RM
Libyan_dinar	libiyAnI_xInAra#libiyAnI_xInAra#noun#2#RM
Libyan_dirham	libiyA_kA_xirahama#libiyA_kA_xirahama#noun#2#RM
Mac_segment	mEka__KaMda#mEka__KaMda#noun#2#RM
Macintosh_sales	mekintoSa_kI_bikrI#mekintoSa_kI_bikrI#noun#2#RM
Madagascar_cat	medAgAskara_billI#medAgAskara_billI#noun#2#RM
Malaysian_capital	maleSiyA_kI_rAjaXAnI#maleSiyA_kI_rAjaXAnI#noun#2#RM
Maltese_dog	mAltAI_kuwwA#mAltAI_kuwwA#noun#2#RM
Mandarin_dialect	maxArina_bolI#maxArina_bolI#noun#2#RM
Manila_bean	manIlA_kI_PalI#manIlA_kI_PalI#noun#2#RM
Maxwell's_daemon	mEksavela_dEmana#mEksavela_dEmana#noun#2#RM
Mexican_capital	mEksiko_kI_rAjaXAnI#mEksiko_kI_rAjaXAnI#noun#2#RM
Mohammedan_calendar	mohammaxa_kA_kEleMdara#mohammaxa_kA_kEleMdara#noun#2#RM
Monroe_doctrine	munaro_kA_sixXAnwa#munaro_kA_sixXAnwa#noun#2#RM
Moroccan_dirham	morakko_xirahama#morakko_xirahama#noun#2#RM
Muhammadan_calendar	muhammaxa_kA_kEleMdara#muhammaxa_kA_kEleMdara#noun#2#RM
Muslim_calendar	musalamAnoM_kA_kEleMdara#musalamAnoM_kA_kEleMdara#noun#2#RM
Nautilus_machine	nAtilasa_maSIna#nAtilasa_maSIna#noun#2#RM
Nicaraguan_capital	nikarAguA_kI_rAjaXAnI#nikarAguA_kI_rAjaXAnI#noun#2#RM
Nigerian_capital	nAIjIriyA_kI_rAjaXAnI#nAIjIriyA_kI_rAjaXAnI#noun#2#RM
Panamanian_capital	panAmA_kI_rAjaXAnI#panAmA_kI_rAjaXAnI#noun#2#RM
Paterson's_algorithm	pItarasana_elgoriWma#pItarasana_elgoriWma#noun#2#RM
Pentagon_briefing	paMcaBuja_vivaraNa_xenA#paMcaBuja_vivaraNa_xenA#noun#2#RM
Pentagon_employee	amarIkI_rakRa_viBAga_karmacArI#amarIkI_rakRa_viBAga_karmacArI#noun#2#RM
Persian_cat	PArasI_billI#PArasI_billI#noun#2#RM
Peterson's_algorithm	pItarasana_elgoriWma#pItarasana_elgoriWma#noun#2#RM
Polaroid_camera	polArOyada_kEmarA#polArOyada_kEmarA#noun#2#RM
Portland_cement	portalEMda_sImeMta#portalEMda_sImeMta#noun#2#RM
Portland_stone	pIle_raMga_kA_pawWara#pIle_raMga_kA_pawWara#noun#2#RM
Qatari_dirham	kawArI_xirahama#kawArI_xirahama#noun#2#RM
Roman_arch	romana_meharAba#romana_meharAba#noun#2#RM
Roman_architecture	romana_vAswukalA#romana_vAswukalA#noun#2#RM
Roman_building	romana_imArawa#romana_imArawa#noun#2#RM
Roman_calendar	romana_kEleMdara#romana_kEleMdara#noun#2#RM
Roman_candle	romana_momabawwI#romana_momabawwI#noun#2#RM
Roman_collar	romana_kAlara#romana_kAlara#noun#2#RM
Russian_almond	rUsI_bAxAma#rUsI_bAxAma#noun#2#RM
Russian_bank	raSiyana_bEMka#raSiyana_bEMka#noun#2#RM
Russian_cactus	rUsI_kEktasa#rUsI_kEktasa#noun#2#RM
Russian_capital	raSiyA_kI_rAjaXAnI#raSiyA_kI_rAjaXAnI#noun#2#RM
Russian_dressing	rUsI_dresiMga#rUsI_dresiMga#noun#2#RM
Shanghai_dialect	SEMgAi_kI_bolI#SEMgAi_kI_bolI#noun#2#RM
Shannon's_diagram	SEnana_AreKa#SEnana_AreKa#noun#2#RM
Shannon's_model	SEnana_nixarSa#SEnana_nixarSa#noun#2#RM
Shannon's_theorem	SEnana_prameya#SEnana_prameya#noun#2#RM
Shannon-fano_coding	SEnana_PEno_kodana#SEnana_PEno_kodana#noun#2#RM
Shannon-hartley_law	SEnana_hArtalI_niyama#SEnana_hArtalI_niyama#noun#2#RM
Siamese_cat	syAmI_billI#syAmI_billI#noun#2#RM
Siberian_elm	sAiberiyA_kA_xevaxAru#sAiberiyA_kA_xevaxAru#noun#2#RM
Singapore_dollar	siMgAporI_doYlara#siMgAporI_doYlara#noun#2#RM
Spanish_bayonet	spenI_sEnyaxala#spenI_sEnyaxala#noun#2#RM
Spanish_broom	spena_kI_JAdZU#spena_kI_JAdZU#noun#2#RM
Spanish_burgoo	spena_ke_nAvikoM_kA_KAxya_viSeRa#spena_ke_nAvikoM_kA_KAxya_viSeRa#noun#2#RM
Spanish_capital	spena_kI_rAjaXAnI#spena_kI_rAjaXAnI#noun#2#RM
Spanish_cedar	speniSa_xevaxAra#speniSa_xevaxAra#noun#2#RM
Spanish_chestnut	vAswavika_cestanata#vAswavika_cestanata#noun#2#RM
Spanish_elm	hisapAniyA_kA_xevaxAru#hisapAniyA_kA_xevaxAru#noun#2#RM
Swiss_canton	svisa_KaMda#svisa_KaMda#noun#2#RM
Swiss_cheese	svitajZaralEMda_kA_cIjZa#svitajZaralEMda_kA_cIjZa#noun#2#RM
Tobacco_money	waMbAkU_ke_pEse#waMbAkU_ke_pEse#noun#2#RM
Tobacco_sales	waMbAkU_kI_bikrI#waMbAkU_kI_bikrI#noun#2#RM
Tunisian_dinar	tayUnISiyAI_xInAra#tayUnISiyAI_xInAra#noun#2#RM
Tunisian_dirham	tyUnISiyA_xirahama#tyUnISiyA_xirahama#noun#2#RM
Turkish_bath	wurkI_bAWa#wurkI_bAWa#noun#2#RM
Turkish_boxwood	wurkI_bAksa_nAmaka_JAdZI_kI_lakadZI#wurkI_bAksa_nAmaka_JAdZI_kI_lakadZI#noun#2#RM
Turkish_capital	tarkI_kI_rAjaXAnI#tarkI_kI_rAjaXAnI#noun#2#RM
Turkish_coffee	wurakI_kAPZI#wurakI_kAPZI#noun#2#RM
U.S._Soviet_effort	yU_esa_soviyawa_pariRaxa_prayAsa#yU_esa_soviyawa_pariRaxa_prayAsa#noun#3#RM
Victorian_architecture	viktoriyana_vAswukalA#viktoriyana_vAswukalA#noun#2#RM
Viola_canina	vAyalA_pOXA#vAyalA_pOXA#noun#2#RM
Virginia_bluebell	varjIniyA_kA_nIla_GaNtA#varjIniyA_kA_nIla_GaNtA#noun#2#RM
Yugoslavian_dinar	yUgoslAviyAI_xInAra#yUgoslAviyAI_xInAra#noun#2#RM
Zimbabwean_dollar	jZimbAbave_kA_doYlara#jZimbAbave_kA_doYlara#noun#2#RM
native_American	amarIkI_mUla_nivAsI#amarIkI_mUla_nivAsI#noun#2#RM
native_Australian	oYstreliyAyI_mUlanivAsI#oYstreliyAyI_mUlanivAsI#noun#2#RM
Wall_Street	voYl_strIta#voYl_strIta#noun#2#WM
Thomas_Harris	Thomas_Harris#Thomas_Harris#noun#1#RM	

