#Source :: Extracted this dictionary from agriculture1_wiktionary.txt and agriculture2_wiktionary.txt, Agri_Glossaryt.doc
#Changes:: 1) Separated single word and multi words into separate dictionaries
#          2) English words are converted to lower case
#	   3) Added category as 'noun' by default
#Added  :: By Roja Lakshmi (06-11-14)	
#######################################
abdomen_noun	uxara
abdominal_noun	uxarIya/uxara
abducent_noun	apavarwaka
abiogenesis_noun	jIvowapawwi
abnormal_noun	apasAmAnya
abolish_noun	unmUlana
abrasion_noun	apaGarSaNa
abscess_noun	PodZA
abscission_noun	apacCexana/vilagana
absorbent_noun	avaSoRaka
absorption_noun	avaSoRaNa
abstract_noun	sArAMSa/sAra
abundance_noun	bAhulyawA
abundant_noun	pracura/BarapUra
acacia_noun	akeSiyA
academic_noun	SEkRika
acarology_noun	prawyAyana
accessions_noun	prApwiyAM/vaMSAvaliyAM
acclimatization_noun	paryAnukUlana
accumulation_noun	saMcaya
acecia_noun	ekesiyA
achrosome_noun	SukAgra
acidaemia_noun	amlarakwawA
acidity_noun	amlawA
acid_noun	amla
acquisition_noun	aXigrahaNa
active_noun	sakriya
activity_noun	sakriyawA
adaptability_noun	anukUlanaSIlawA/anukUlanIyawA
adaptation_noun	aMgIkaraNa/svIkAra/anukUlana
adaptive_noun	anukUlI
adequate_noun	paryApwa
adhere_noun	cipakanA
adhering_noun	AsaMjana
adhesiveness_noun	AsaMjakawA
adjacent_noun	nikatavarwI/Asanna
adjoining_noun	saMlagna/samIpavarwI
administer_noun	xavA_xenA
admixture_noun	aXimiSraNa
adopting_noun	apanAkara
adoption_noun	anukUlana/apanAnA/svIkAra_karanA
adsorption_noun	aXiSoRaNa
adulteration_noun	milAvata/apamiSraNa
advalorem_noun	mUlyAnusAra/yaWAmUlya
advance_noun	peSagI/agrima/unnwa/vikasiwa
advantage_noun	lABa/PZAyaxA
advection_noun	aBivahana
adverse_noun	prawikUla
aerate_noun	vAwana_karanA
aeration_noun	vAwana
aerobe_noun	vAyujIvI
aerosol_noun	vAyu-vilaya/vAyu_Gola/erosola
afforestation_noun	vanaropaNa
afforest_noun	vanaropaNa
agarian_noun	BUmi_saMbaMXI/kqRi_saMbaMXI
agglameration_noun	samUhana
agglutination_noun	ASleRaNa
aggregate_noun	samuccaya
agitation_noun	viloDana
agricultural_noun	kqRi_saMbaMXI/kqRi
agriculture_noun	kqRi
agri-input_noun	kqRi_niveSa
agroclimatology_noun	kqRi-jalavAyuvijFAna
agroforestry_noun	kqRi_vAnikI
agrology_noun	sasya_mqxA_vijFAna
agromaterology_noun	kqRi_mOsama-vijFAna
agrometeorology_noun	kqRi_mOsama_vijFAna
agronomical_noun	sasya_saMbaMXI
agronomist_noun	sasya_vijFAnI
agronomy_noun	sasyavijFAna/sasya_vijFAna
agrosilviculture_noun	kqRi_vana_varXana/kqRi_vana_vqkRa_vijFAna
agrotype_noun	kqRi_prArUpa
albino_noun	raMjakahIna_jIva
algal_noun	SevAla/kAI
alignment_noun	saMreKaNa
alkaline_noun	kRArIya/kRArIya/KArA
alkalinity_noun	kRArIyawA
alkaloed_noun	viRaXArI_paxArWa
allele_noun	yugmavikalpI/vikalpI
allied_noun	sambaxXa
allogamy_noun	paraniSecana
alloy_noun	miSrAwu
alluvial_noun	kaCArI_BUmi
almond_noun	bAxAma
alternated_noun	pArI_pArI_se/ekAMwara
alternation_noun	eMkAMwaraNa
altitude_noun	UzcAI/wuMgawA/UEYMcAI
alum_noun	PitakarI
amalgam_noun	amalagama/sammiSra
amaranth_noun	cOlAI
ambient_noun	pariveSa
ambiguous_noun	saMxigXa
amelioration_noun	suXAra
amenable_noun	uwwaraxAI
amendment_noun	saMSoXana
ametabolic_noun	arUpAMwaraNI
amitosis_noun	asUwrIviBAjana
amla_noun	AMvale
ammonification_noun	amoniyAkaraNa/EmoniyAkaraNa
amorph_noun	apraBAvI_rUpa
amorphous_noun	AkAra_rahiwa/akristalIya
amplification_noun	pravarXana
ampule_noun	saMputa/Empyula
amputation_noun	aMgocCexana/aMga_kAtanA
amylase_noun	emilesa
anabolism_noun	upacaya
anaerobic_noun	avAyujIvI
anaesthesia_noun	saMvexanAharaNa
analgesic_noun	pIdZAhArI
analogous_noun	anurUpa/saxqRya
analogue_noun	anurUpa/wulyarUpa
analysis_noun	viSleRaNa
analytical_noun	viSleRaNAwmaka
anamorphism_noun	prakAyAMwaraNa
ananthous_noun	apuRpakramI
anaphase_noun	paScAvasWA/enAPeja
anatomical_noun	SArIrika
androecium_noun	pumaMga
androgenesis_noun	puMjanana
androgenous_noun	puMjanaka
anecdotal_noun	vqwwAMwa
angiology_noun	rakwasaMcAra_vijFAna
angiosperm_noun	AvqwabIjI
anhydrous_noun	nirjala
anion_noun	qNAyana
aniseed_noun	sOMPa_(bIja)
anise_noun	sOMPa
annual_noun	vArSika
anorexia_noun	kRuXAnyUnawA
antacid_noun	prawiamlawA
antagonism_noun	viroXa
antagonist_noun	viroXI
antenna_noun	SrqMgikA
anthelminitic_noun	kqmihara
anther_noun	parAgakoRa/parAgakoSa
anthesis_noun	praPullana/parAgoxBava/praPullana/praPullana_kAla
anthill_noun	vamrakUta/vAlmIka
anthodium_noun	muMdaka
anthrax_noun	giltI_roga
anthropomorphous_noun	mAnavarUpI
antibiosis_noun	prawijIviwA
antibiotic_noun	prawijEvika
anticipatory_noun	prawyASiwa
antidote_noun	prawikAraka
antifungal_noun	prawikavaka/PaMgasaroXI
antigen_noun	prawijana
antiphlogistic_noun	SoWahArI
antipyretic_noun	jvarahara
antiseptic_noun	pUwiroXI
antiserum_noun	prawisIrama/eMtIsIrama
antispasmodic_noun	eMTanaroXI
antithesis_noun	prawipakRa/prawisWApanA
antitoxin_noun	AviSaroXI
antiviral_noun	prawiviSANuka
antogenist_noun	prawiroXI_virUxXa
apex_noun	SIrRa/cotI/SiKAgra
aphid_noun	lAhI/mAhU/ceMpA/EPida
apiary_noun	maXuvAtikA
apical_noun	SiKAgra
apiculture_noun	maXumakKI/maXumakKI_pAlana/mOna_pAlana
apogamy_noun	apayugmana
apparatus_noun	upakaraNa
apparrent_noun	prakata/spaRta
appetite_noun	kRuXA/BUKa
appetizer_noun	kRuXAkArI
application_noun	anuprayoga
appraisal_noun	mUlyAMkana
appreciation_noun	mUlya_vqxXi
apprise_noun	sUcanA_xenA/bawAnA
approach_noun	prayawna/pahuMca/upAya
apricot_noun	KUbAnI
aquaculture_noun	jalajIva_pAlana/jala_kqRi/maCalIpAlana
aquatic_noun	jalIya/jalacara
aqueous_noun	jalIya
aquifer_noun	jalaBarA
arbitrary_noun	manamAnI
arbitration_noun	paMca_PEsalA/maXyasWa_nirNaya
arboreal_noun	vqkRIya/vqkRavAsI
arboretum_noun	vqkRa_samUha
arboriculture_noun	vqkRa-saMvarXana
arborization_noun	SAKAyana
arbour_noun	kuMja
arbuscules_noun	bOnA_vqkRa
areacanut_noun	supArI
aridity_noun	SuRkawA
aridosol_noun	eridosola
aril_noun	bIjacola
aroma_noun	suvAsa/sugaMXa
aromatic_noun	sagaMXIya
arrangement_noun	vinyAsa
array_noun	sAriNI/byUha
arrival_noun	Amaxa
arthropods_noun	mAnavAkAra
arthrospore_noun	saMXi_bIjANu
articular_noun	saMXi/saMXikA
arum_noun	arabI/GuiyAM
asafoetida_noun	hIMga
ash_noun	rAKa
aspiration_noun	cUSaNa
assembling_noun	saMgrahaNa
assesment_noun	mUlyAMkana
assessed_noun	nirXAriwa
assimilation_noun	AwmasAwakaraNa
associate_noun	saMbaMxXa
assume_noun	kalpanA_karanA/grahaNa_karanA/apanAnA,
assymetry_noun	asamamiwi
asthma_noun	SvAsa/xamA
astringent_noun	swaMBaka/kaSAya
asynapsis_noun	asUwrayugmana
atavism_noun	prawyAvarwana
atmometer_noun	vARpana-mApI
atmosphere_noun	vAwAvaraNa
atrophy_noun	apakRaya/kRINawA,
attribute_noun	guNa
auditorium_noun	prekRAgqha
auger_noun	barmA/Agara
augmentation_noun	aBivarXana
aureole_noun	maMda_la
auricula_noun	oYrIkulA/karNapallava
autarchic_noun	ekawaMwrIya
autecology_noun	svapArisWiwikI
authorize_noun	prAXikqwa
autocarp_noun	svaniSecI_Pala
autogamy_noun	svayugmana
autogenesis_noun	svawaH_janana/aniSekajanana
autoheteroploid_noun	svaviSamaguNiwa
autotype_noun	svaprarUpa
auxin_noun	oYksina
average_noun	Osawa/Osawana
award_noun	puraskAra
axil_noun	kakRa
axis_noun	akRa
bacterial_noun	jIvANu
bacteria_noun	jIvANu
bactirium_noun	jIvANu
bale_noun	gAMTa
bark_noun	CAla/valkala
barley_noun	jO/jO/bArlI
barnyard_noun	sAvAM
barren_noun	baMjara
basin_noun	AlavAla/WAlA/WAlA/besina/xroNI
bedding_noun	kyArI_banAnA
beetle_noun	BqMga/BqMga_kIta
behaviour_noun	vyavahAra
beneficiary_noun	lABArWI/_lABa_BogI
benefit_noun	lABa
benthic_noun	niwalasWa
ber_noun	bera
betelvine_noun	pAna
beverage_noun	peya_paxArWa
bilateral_noun	xvipakRIya
bioassay_noun	jEva_AmApana
biochemical_noun	jEva_rasAyanika
biofertilizer_noun	jEva-urvaraka
biogas_noun	gobara-gEsa/boyogEsa
biological_noun	jOvika
biology_noun	jIva-vijFAna
bio-manure_noun	jOvika_KAxa
biomass_noun	jIva_BAra/jEva_mAwrA
biophagous_noun	jIva-BakRI
biosphere_noun	jIva_maMdala
biotechnolgoy_noun	jEva_prOxyogikI
bio-technology_noun	jEva-prOxyogikI
biotic-factor_noun	jEva_kAraka
biotic_noun	jEva/jIvIya
bleaching_noun	viraMjana
bleach_noun	raMga_udZanA/vira_Mjana_karanA
blending_noun	sammiSraNa
blend_noun	miSraNa
blight_noun	1._aMgamArI/SIrNawA/aMgamArI
bloom_noun	KilanA/PUlanA/KilanA
bloowarm_noun	gUlara_kI_sUMdI/blUvarma
blossoming_noun	puRpana
blossom_noun	maMjarI/puRpapuMja
boll_noun	gUlara
borer_noun	beXaka/beXaka/Cixraka
bottlenecks_noun	gawiroXa/mArgAvaroXa
brackiswater_noun	KArAjala
bract_noun	sahapawra
brawn_noun	BUrA_raMga
breeder_noun	prajanaka
breeding_noun	prajanana
breed_noun	nasla
brinjal_noun	bEMgana
broadcasting_noun	CitakAva
brooding_noun	aMde_senA
buckling_noun	AkuMcana
budding_noun	mukulana/mukulana/navoxiwa
bud_noun	kalI/mukula
bulbous_noun	kaMxIya
bunch_noun	gucCa
bunding_noun	meDZa_banAnA
buyer_noun	KarIxAra
cabbage_noun	baMxagoBI
callus_noun	kElasa
calyx_noun	puRpakoSa/bAhya_xalapuMja
camphor_noun	kapUra
capacity_noun	kRamawA/sAmaWrya
capillarity_noun	keSikawva
capital_noun	prawi_vyakwi/pUzjI
carcass_noun	kaMkAla/asWipaMjara
caroing_noun	XunAI
carrot_noun	gAjara
cashewnut_noun	kAjU
castor_noun	aMdI/reMdI/eraMda/araMdI/araNdI
catabolism_noun	apapAcana/apacaya
catchment_noun	sravaNa/jalagraha
caterpillar_noun	illI
cattle_noun	paSu/paSuXana
cell_noun	koSikA/koRTikA
census_noun	janagaNanA
cereal_noun	KAxyAnna
cereals_noun	XAnya/anAja
chaff_noun	BUsA/BUsI/cokara
characterize_noun	aBilakRaNa
charring_noun	jalakara_kAlA_honA
chlorophyll_noun	parNahariwa/kloroPila
chloroplast_noun	hariwa_lavaka/kloroplAsta
chlorosis_noun	harimAhInawA
chopping_noun	saMkarwana/tukadZe_karanA
chromatography_noun	varNaleKana
chromosome_noun	guNasUwra
cinamum_noun	wejapAwa
classification_noun	vargIkaraNa
clay_noun	matiyAra/cikanI_mittI
claypan_noun	kaTora_mqxA_parawa/kaTora_mqxA
clearing_noun	sAPZa_karanA/jaMgala_meM_KulA_sWAna
climate_noun	jalavAyu
climax_noun	caramAvasWA
clinical_noun	nOxAnika
clod_noun	DelA
clone_noun	kqMwaka/klona
cloud_noun	meGa/bAxala
coagulation_noun	skaMxana
coalesce_noun	sammiliwa_honA
coarse_noun	motA/apariRkqwa
cocoon_noun	kosA/koyA/kqmikoRa
coefficient_noun	guNAMka
cognizance_noun	saMjFAna
cohesion_noun	saMsaMjana
collaboration_noun	sahayoga
collar-rot_noun	koYlara-roYta/grIvA_vigalana
combat_noun	saMGarRa/sAmanA
communication_noun	saMparka/saMcAra
compaction_noun	saGanawA
compatible_noun	saMgawa/anukUla/anurUpa
complexity_noun	saMkliRtawA
complex_noun	sammiSra/jatila
component_noun	saMGataka/avayava
components_noun	Gataka
composition_noun	saMGatana
compost_noun	kamposta/kUdZA_KAxa
compound_noun	yOgika
comprise_noun	sammiliwa_karanA/vyApwa_karanA,
concentration_noun	sAMxrawA
conclusively_noun	nirNAyaka_rUpa_se/aMwima_rUpa_se
concomitant_noun	susaMgawa/anurUpa/saxqSa
condensed_noun	saMGaniwa
configuration_noun	vinyAsa
conjuctive_noun	saMyojaka/saMyukwa
conservation_noun	saMrakRaNa
considerable_noun	kAPI/viSeRa/mahawvapUrNa/vicAraNIya
constituents_noun	avayava
constraints_noun	adacana
consultancy_noun	parAmarSa....
consumption_noun	Kapawa
contaminated_noun	saMxURiwa
contamination_noun	saMxURaNa
contended_noun	vivAxa_karanA
contingent_noun	sAMyogika
control_noun	niyaMwraNa/sAmAnya_xaSA
convention_noun	samaJOwA
conversion_noun	rUpAMwaraNa/parivarwana
coordination_noun	samanvaya
coordinator_noun	saMcAlaka
core_noun	bIjakoRa
coriander_noun	XaniyA
cortex_noun	valkuta
cotton_noun	kapAsa
cotyledon_noun	bIjapawra_(navajAwa_pOXoM_kI_pawwiyAM)
countepart_noun	pUra_ka
coupled_noun	yugma
cowpea_noun	lobiyA
creeper_noun	bela
crisis_noun	saMkata/saMkatAvasWA
critical_noun	krAMwika/nAjuka_sWiwi
crop_noun	Pasala
cross-fertilization_noun	para-niSecana
cross-infectivity_noun	para-saMkrAmyawA
cross_noun	saMkara/saMkaraNa
crowbar_noun	sabbala
crucial_noun	kaTina/vikata
crumb_noun	mqxukaNa
crusting_noun	papadZI_jamanA
crust_noun	papadZI/BU-pqRta
cryobank_noun	krAyobEMka
cultivar_noun	kqRi_jopajAwi
cultivation_noun	KewI
curriculum_noun	pATyakrama
cuticle_noun	upawvacA/upacarma/kyUtikala
cyclone_noun	wUPZAna
cytogenetics_noun	koSikAnuvaMSikI
cytology_noun	koSikA_vijFAna
cytomorphologically_noun	koSikA_AkArikI_rUpa_se
cytoplasm_noun	koSikAxravya
cytotypes_noun	koSikA_prarUpa
decayed_noun	sadZA_huA
decay_noun	kRaya
deciduous_noun	parNapAwI/pawaJadZa/parNapAwI/pawaJadZI
decoction_noun	gADZA
decompose_noun	apaGatana
decomposition_noun	avaGatana/galanA/sadZana
deep_noun	gaharI
deficiency_noun	nyUnawA/kamI/kasara
deflation_noun	avasPIwi
deflocculate_noun	avayava_viBakwikaraNa
defoliation_noun	niSpawraNa/vipawraNa/niRpawraNa
deforest_noun	marusWala/vana_katAI
deformity_noun	virUpawA
degradation_noun	nimnikaraNa
degumming_noun	vigoMxana/goMxa_hatAnA
dehiscence_noun	sPutana
dehydrated_noun	nirjaliwa
dehydrate_noun	nirjala_karanA
dehydration_noun	nirjalIkaraNa
delineaction_noun	nirUpaNa/ciwraNa
delinting_noun	binOle_se_rUI_alaga_karanA
demand_noun	mAzga
demographic_noun	janasAMKyikIya
demonstration_noun	praxarSana
denim_noun	mote_vaswra/jInsa_banAne_hewu_upayukwa
denitrification_noun	prawinawrajanIkaraNa
density_noun	Ganawva
deodorised_noun	gaMXahariwa
departure_noun	vicalana/prasWAna
dependency_noun	nirBarawA
depletion_noun	hrAsa
deployed_noun	PElAyA_gayA
deposition_noun	nikRepa/_nikRepaNa
depreciation_noun	mUlya_hrAsa
depression_noun	avanawi
derivatives_noun	saMwawiyAM
derived_noun	vyuwpanna
desertification_noun	marusWalIkaraNa
desi-plough_noun	xeSI_hala
desseminated_noun	prakIrNa
deteriorate_noun	sadZanA/KZarAba_honA
deterioriation_noun	guNahrA_sa
determine_noun	nirXAraNa/niyawa
devaluation_noun	avamUlyana
development_noun	vikAsa
device_noun	yukwi
devised_noun	AviRkAra
dew_noun	osa
diagnosis_noun	nixAna
differential_noun	aMwarIya
differentiation_noun	viBexana
diffusion_noun	prasAra/visaraNa/prasAra
dihybrid_noun	xvisaMkara
dilution_noun	wanukaraNa/avamiSraNa
dimorphism_noun	xvirUpawA
diploid_noun	xviguNiwa
directorate_noun	nixeSAlaya
director_noun	nixeSaka
disease_noun	roga
disperse_noun	avilaya
dissemination_noun	prasAra
dissolve_noun	GulanA
distillation_noun	Asavana
distribution_noun	viwaraNa
distruption_noun	viGatana
diversification_noun	viviXIkaraNa
documented_noun	praleKana
dodden_noun	amara_bela
domestication_noun	grAmyana/pAlawUkaraNa
dominant_noun	prabala/praXAna/praBAvI/prabala
drainage_noun	jalanikAsa
drain_noun	nAlI
drill_noun	baramA/drila
drip_noun	tapaka
dripper_noun	dripara
drizzle_noun	PuhAra
droping_noun	namaka_roga
drought_noun	anAvqRti/sUKA/sUKA
dry-land_noun	baMjara_BUmi/baMjara
dryland_noun	bArAnI
dune_noun	tibbA/tIbA
dwarf_noun	bOnA
earthworm_noun	keMcuA
ebizootic_noun	jaMwumArI
ecofriendly_noun	paryAvaraNa_hiwERI/paryAnukUla
ecological_noun	pAriveRika
ecology_noun	pArisWiwikI/pArisWiwikI/pAripraNAlI
economical_noun	lABaxAyaka/lABakArI
economic_noun	ArWika
eco-relationship_noun	pArisWiwika_saMbaMXa
ecosystem_noun	pArisWiwikI_praNAlI/pAriwaMwra/pAriwaMwra/pArisWiwika_waMwra
edaphic_noun	BUmi_saMbaMXI
edaphology_noun	BUmi_vijFAna
effective_noun	praBAvAwmaka
efficacy_noun	kRamawA
electrophoretic_noun	vExyuwa_kaNa_saMcalana
elevated_noun	aXika/unnawa/baDZe_hue/unnawa
elongated_noun	lambA
elongation_noun	xIrGAkaraNa
elucidate_noun	spaRta_karanA/prakASa_dAlanA
eluviation_noun	apavahana
emasculation_noun	vipuMsIkaraNa
embrionic_noun	BU_raNIya
embroyogenesis_noun	BrUNABa
embryogeneic_noun	BrUNIya
embryology_noun	BrUNavijFAna
embryo_noun	BrUNa
emergance_noun	AvirBAva
emerging_noun	uBarawI
emeritus_noun	praKyAwa/viKyAwa
emission_noun	uwsarjana
emphasis_noun	bala_xenA/jora_xenA
employment_noun	rojagAra
empower_noun	Sakwi_xenA
endemic_noun	sWAnIya
endocarp_noun	aMwaPalaBiwwi
endoparasitism_noun	aMwaparajIviwA
endopathogen_noun	aMwarogajanaka
energy_noun	UrjA
enterprise_noun	uxyoga
entomogamy_noun	kIta_parAgaNa
entomogenous_noun	kIta_jIvI
entomology_noun	kIta-vijFAna
enzyme_noun	eMjAima
ephemeral_noun	svalpAyu
epidemic_noun	mahAmArI
equilibrium_noun	saMwulana/sAmyAvasWA/sAmya
eradicate_noun	unmUlana
eradication_noun	unmUlana/viXvaMSa/nASa
erected_noun	sWApanA
ergonomics_noun	Srama_xakRawA_saMbaMXI
erode_noun	aparaxana_karanA
erodible_noun	aparaxanika
erosion_noun	kAta/aparaxana/kRaraNa/katAva/CIjana/BU-kRaraNa
error_noun	wruti
establishment_noun	sWApanA
estimated_noun	anumAniwa/AMkaliwa
ethnographic_noun	mAnavajAwigawa
evaluation_noun	mUlyAMkana
evaporation_noun	vARpana/vARpIkaraNa/vARpIBavana
evapo-transpiration_noun	vARpowsarjana
evergreen_noun	saxAbahAra/saxAhariwa/saxAparNI
evolution_noun	uxvikAsa
evolved_noun	vikasiwa
exchangeable_noun	vinimaya_yogya
execution_noun	pAlana_karanA/kAryAnvayana
exhaust_noun	recana_karanA
exhibition_noun	praxarSanI
exotic_noun	vixeSI
expand_noun	PElAva
expansion_noun	viswAra/prasAra/PElAva
expedite_noun	SIGra_nibatArA
expenditure_noun	vyaya
explant_noun	karwwowaka
exploit_noun	kAma_meM_lenA
exploration_noun	anveRaNa/Koja
export_noun	niryAwa
extinct_noun	vilupwa
fabric_noun	vaswra
fabulous_noun	kAlpanika
facilitation_noun	saralIkaraNa
facillitate_noun	susAXya/sarala_banAnA
facsimile_noun	anulipi/prawikqwi
fact_noun	waWya
faculty_noun	saMkAya
fallow_noun	padZawI/parawI/parawI_BUmi
family_noun	kula/parivAra
farm_noun	PArma
favourable_noun	anukUla
feedback_noun	punarniveSana/prawipuRti
fennel_noun	sOMPa
fermentation_noun	kiNvana
fertile_noun	upajAU
fertiliser_noun	urvaraka
fertility_noun	upajAUpana
fertilization_noun	niRecana
fertilizer_noun	urvaraka
fiber_noun	reSA/waMwu
fibrous_noun	waMwumaya
field_noun	prakRewra/kRewra/Kewa
fig_noun	aMjIra
filtration_noun	nisyaMxana
fisheries_noun	mAwsyakI
fishery_noun	mawsya_uxyoga/mawsya_kRewra
fixation_noun	yOgikIkaraNa/sWAIkaraNa
flexibility_noun	lacIlApana
flood_noun	bADZa
floods_noun	bADZa
floriculture_noun	PUloxyAna
fluctuation_noun	Gata-baDZa
fluffy_noun	romexAra
fluidity_noun	waralawA
fluster_noun	GabarAnA
focus_noun	kenxra_binxu/pramuKa
fodder_noun	cArA
foliaceous_noun	parNIya
foliage_noun	parNAvalI
foliar_noun	parNila/pawrIya
forage_noun	BUsA/cArA
forecast_noun	pUrvAnumAna
forestry_noun	vanavixyA/vanaKaMda/vanaprAMwa
formation_noun	nirmANa/racanA/viracana,
formulated_noun	sUwrabaxXa
forthcoming_noun	AgAmI
fragile_noun	BurI-BurI
freight_noun	mAla_BAdZA
frequency_noun	Avqwi/Avqwwi/bAraMbArawA
friction_noun	GarRaNa
fuel_noun	IMXana
fumigation_noun	XUmrIkaraNa
fungicide_noun	kavaka_nASI/PaMPUxanASI/PaMgasanASI
fungicides_noun	kavakanASI
fungi_noun	kavaka
fungus_noun	kavaka/PaPUMxa
furrow_noun	KUda/kUMda/nAlI
gene_noun	jIna,/nasla
genera_noun	jenerA
generation_noun	uwpAxana/nirmANa
genesis_noun	uwpawwi_graMWa
genetic_noun	AnuvaMSika
genetics_noun	AnuvaMSikI
genomic_noun	jinomika
genotype_noun	jIna_prarUpa/samajIna
genus_noun	vaMSa
geohydrology_noun	BU-jala_vijFAna
germination_noun	aMkuraNa
germplasm_noun	janana_xravya/janana_xravya/vaMSAvaliyAM
ginning_noun	otAI
globalisation_noun	vEAIkaraNa/BUmaMdalIkaraNa
globalized_noun	BU-maNdalIkqwa
glut_noun	glata/AXikya
gnarl_noun	pora
godown_noun	BaNdAra
governance_noun	SAsana
governed_noun	niyAmaka
grading_noun	SreNIkaraNa
graftage_noun	kalama_baMXana
grafting_noun	kalama_bAzXanA
graft_noun	kalama_uparopa
grain_noun	anAja/anAja/KAxyAnna
gram_noun	canA
grapes_noun	aMgUra
grassland_noun	GAsa_kA_mExAna/carAgAha/gocara_BUmi
gravelly_noun	bajZarIxAra
grazing_noun	carAI
greengram_noun	mUzga
groundnut_noun	mUzgaPalI
groundwater_noun	BUmigawa_jala
growth_noun	vqxXi
guava_noun	amarUxa
guidance_noun	mArgaxarSana
guide_noun	mArgaxarSaka
gully_noun	galI/GAtI/avanAlikA
habitat_noun	parisWAna/prAkqwikavAsa/nivAsa_sWAna
hail_noun	olA/Hard_pan__kadZI_waha/kaTora_aXaHswara
hallow_noun	WoWA
harvest_noun	Pasala
hatchery_noun	sPutanaSAlA
hatching_noun	sPutana/aMdajowpawwi
headway_noun	pragawi
heat_noun	wApa
herbicide_noun	SAkanASI
herbicides_noun	SAkanASI
hereditary_noun	AnuvAMSikIya
heteratic_noun	ojapUrNa
heterogeneity_noun	vijAwIyawA
heterogeneous_noun	viRamAMga
hindering_noun	rUkAvata
holding_noun	kisAna_ke_Kewa/caka
homogencity_noun	sajAwIyawA
horticulture_noun	bAgavAnI
household_noun	GarelU
humidity_noun	ArxrawA/namI/AxrrawA/namI
humus_noun	hyumasa
hybred_noun	hAibreda
hybridization_noun	saMkaraNa
hybrid_noun	saMkara
hydrograph_noun	jalagrAPa/jala_leKAciwra
hydrology_noun	jalavixyA/jalavijFAna
hyetograph_noun	sama_varRA_leKAciwra
hygrometer_noun	AxrrawAmApI
hypocotyl_noun	bIjapawrAXAra
identification_noun	pahacAna
imbalance_noun	asaMwulana
immature_noun	kaccA/apakva
immaturity_noun	aparipakvawA
immobilisation_noun	sWirIkaraNa
immune_noun	asaMkrAmya
immunization_noun	prawirakRaNa
immunogenic_noun	prawirakRAjanI
impact_noun	praBAva/saMGAwa/jamAnA
impaired_noun	vikqwa/kRawi/hAni/xurbala
impending_noun	Asanna/sannikata/samupasWiwi
impervious_noun	aBexya/apAragamya
implantation_noun	BrUNa_ropaNa
implements_noun	OjAra
import_noun	AyAwa
impoverished_noun	kaMgAla
impregnated_noun	saMseciwa
impurities_noun	apaxravya
inadequate_noun	aparyApwa
inbreeding_noun	aMwaHprajanana
incessant_noun	niraMwara/anavarawa/avirAma
incidence_noun	praBAva
income_noun	Aya
incorporation_noun	samAveSana
indent_noun	mAzga
indigenous_noun	svaxeSI/xeSI/xeSI/svaxeSI
induced_noun	preraka/preriwa
induction_noun	preraNa
infected_noun	saMkramiwa
infection_noun	saMkramaNa/roga_saMkramaNa
infertility_noun	anurvarawA/bAMJapana
infestation_noun	bAXA/pIdZA
infiltration_noun	risanA/aMwarJaranA/
infiltrometer_noun	risAva_mApI
inflation_noun	muxrAsPIwi
inflorescence_noun	puRpakrama
infrastructure_noun	avasaMracanA/avaracanA/AXAraBUwa_DAzcA
inheritance_noun	vaMSAgawi
inhibition_noun	saMxamana/niroXa/niReXa
initiation_noun	prAraMBa
innovation_noun	navIna_kArya
inoculants_noun	saMropya
inoculate_noun	saMropaNa
inoculation_noun	niveSana/saMcaraNa
inorganic_noun	akArbanika/ajEvika
input_noun	AxAna/niviRta/niveSa//niveSa/AxAna
insecticide_noun	kItanASI
insect_noun	kIta/kIdZA
insoluble_noun	avileya
instar_noun	avasWA
insulation_noun	roXana
insurance_noun	bImA
integrated_noun	samAkaliwa
integration_noun	samAkalana/samAkalana/ekIkaraNa
intended_noun	aBiprewa
intensification_noun	saGanawA
intensity_noun	wIvrawA/wIvrawA/ugrawA/prakarRa
interaction_noun	pAraparika_kriyA
interception_noun	aMwagrrahaNa/aMwarAvaroXana/aMwaHroXana
intercrop_noun	aMwarA_sasyana/aMwaHsasyana
intercropping_noun	aMwaH_Pasala/aMwara_Pasala/aMwarAsasyana/aMwaHPasalIkaraNa/aMwaraPasalIkaraNa
intercrossing_noun	aMwarA_saMkramaNa
inter-cultivation_noun	nirAI-gudZAI
internode_noun	parva/porI
interplant_noun	aMwapOXa/aMwarA-pOXa
interspecific_noun	aMwarajAwIya
interval_noun	aMwarAla
intervention_noun	maXyavarwI
introgressive_noun	aMwargAmI
invasion_noun	caDZAI
investigator_noun	anveRaka
investment_noun	niveSa
invigorating_noun	SakwivarXaka
invigoration_noun	puStikAraka
invoice_noun	bIjaka
irrigation_noun	siMcAI
isohyet_noun	samavqRti_reKA
isolation_noun	ekalana/vigalana/vilagana/pqWakkaraNa
isotherm_noun	samawApIyaka/samawApIya
item_noun	maxa
journal_noun	pawrikA
jurisdiction_noun	kRewrAXikAra/aXikAra_kRewra
jute_noun	patasana
kennel_noun	girI/garI
kick_noun	nikalanA/niRkAsana
kind_noun	prakAra
kinno_noun	kinnU
labourer_noun	Sramika
labour_noun	Srama
land_noun	BUmi
landslide_noun	BUmi_sKalana/BUmi-KisakanA
lapideous_noun	paWarIlA
larva_noun	diMBaka/lArvA/illI
lateral_noun	pArSva_SAKA
laterite_noun	letarAita
lateritic_noun	lEterAitika/maKamalA
latosol_noun	lEtosola
layer_noun	parawa
layout_noun	aBinyAsa/nakZSA
leaching_noun	apakRAlana/Gulakara_bahanA/Golakara_bahAnA
leaflet_noun	parNaka
lenticel_noun	vAwaraMXu
lentil_noun	masUra
lethal_noun	GAwaka
lime_noun	KattA/nIMbU/jambIra/cUnA/aXabuJA
linear_noun	reKIya
lines_noun	vaMSAvaliyAM
linkage_noun	liMkeja/samparka
linseed_noun	alasI
lint_noun	rUI
lister_noun	meMdZakArI
litchi_noun	lIcI
literacy_noun	sAkRarawA
litter_noun	meMdZakArI
livelihood_noun	jIvikA
livestock_noun	paSuXana
load_noun	BAra
loam_noun	xumata
loan_noun	qNa/qNa/karjZa
local_noun	sWAnIya
lodging_noun	Pasala_giranA/rihAyaSa_nivAsa_vAsA
longevity_noun	badZI_umra
loosening_noun	DIlA_karanA/asaMgaTana
lowering_noun	avanamana/nimnana
lowland_noun	nimnaBUmi/warAMU_BUmi
lysimeter_noun	lAisImItara
maintenance_noun	anurakRaNa
maize_noun	jvAra/makkaI
malformation_noun	kurUpawA,/vikqwi
malnutrition_noun	kupoRaNa
management_noun	prabaMXa/prabaMXana
mango_noun	Ama
mantained_noun	banAe/kAyama_yA_jArI_raKanA
manure_noun	KAxa
mapping_noun	mAnaciwraNa
marginal_noun	sImAMwa/upAMwIya
markedly_noun	suspaRta_rUpa_se
marked_noun	aMkiwa/suspaRta/viSiRta
marketing_noun	vipaNana
market_noun	bAjZAra
marsh_noun	xalaxala
massive_noun	sWUla
mating_noun	saMgama
maturity_noun	paripakvawA
mean_noun	Osawa
median_noun	mAXyikA
medicinal_noun	OSaXIya
medium_noun	poRa_paxArWa/mAXyama
menace_noun	saMkata/joKima
meristematic_noun	viBajyowakI/viBajyowaka
mesocarp_noun	maXyaPalaBiwwI
mesoclimate_noun	maXya_jalavAyu
metabolic_noun	upApacayI
metabolities_noun	upApacayaNa/metAbolAitIja
meteorology_noun	mOsama-vijFAna
methods_noun	viXiyAM
microbe_noun	jIvANu
microbes_noun	sUkRmajIva/jIvANu/sUkRma_jIvANu
microbiology_noun	sUkRmajIvavijFAna
microclimate_noun	sUkRma-jalavAyu
microflora_noun	sUkRma_vanaspawi
micrometeorology_noun	sUkRma-mOsamavijFAna
micro-nutrients_noun	sUma_poRaka
microorganism_noun	sUkRmajIva
midrib_noun	maXyanAlI
milch_noun	xuXArU
milchy_noun	xUXiyA
mildew_noun	AsiwA
milky_noun	xUXiyA
million_noun	miliyana
mineralisation_noun	KanijIkaraNa
mineralization_noun	KanijIBavana/Kanijana
mineralized_noun	KanijIkqwa/KanijIyukwa
mineral_noun	Kanija
minor_noun	laGu
mite_noun	kIta
mitigating_noun	kama_karanA
mitigation_noun	Ramana/kamI
mobilization_noun	saMGatana
moderate_noun	sAmAnya/maXyama
module_noun	mApaxaMda/mAdyula
moisture_noun	namI/namI/AxrrawA
monsoon_noun	mAnasUna
morpholigical_noun	Akqwika
mortality_noun	mqwyu_saMKyA/xara
mortar_noun	gArA
moss_noun	kAI/moYsa
motes_noun	bIjikA
moth_noun	pawaMgA
mulbery_noun	SahawUwa
mulching_noun	palavAra_biCAnA/palavAranA
mulch_noun	palavAra/malca
mullarp_noun	mUlArpa
multiplication_noun	vqxXikaraNa/praguNiwa
mushroom_noun	Kumba/kukuramuwwA
mustard_noun	sarasoM
mutant_noun	uwparivarwI
mutation_noun	uwparirvawana
mycorrhiza_noun	mUlakavaka
na_noun	sodiyama
native_noun	xeSI
naturally_noun	svaBAvika_rUpa_se
necrosis_noun	gala_jAnA
need_noun	AvaSyakawA
ngo_noun	gO_sa_saM_(gOra_sarakArI_saMgaTana)
niger_noun	rAmawila
nitrification_noun	nAitrIkaraNa/nawrajanIkaraNa
node_noun	parvasaMXi/gAMTa
nodular_noun	graMWikI
nodulation_noun	graMWana
nodule_noun	gutikA/noYdyUla
non-productive_noun	anuwpAxI
normal_noun	sAmAnya
npk_noun	nAitrojana/PAsPorasa/potASa
nursery_noun	narsarI/pOXaSAlA/narsarI
nut_noun	girI
nutrient_noun	poRaka
nutrient_adjective	poRaka_wawva
nutrition_noun	poRaNa/poSaNa/AhAra
occupation_noun	vyavasAya
oil_noun	wela
oilseed_noun	wilahana
okra_noun	BiNdI
olericulture_noun	SAka_BAjI_uwpAxana
onomastic_noun	nAmika
ontogemy_noun	vyakwivqwwa/vyaRti_vikAsa
opaline_noun	xuXiyA
opportunity_noun	avasara
optimum_noun	anukUlawama
organic_noun	kArbanika
organism_noun	jIva
organogenesis_noun	aMga_vikAsa
orientation_noun	pUrvABimuKIkaraNa/sWiwi_nirXAraNa
ornithology_noun	pakRIvijFAna
outlay_noun	parivyaya
outreach_noun	AutarIca/pahuMca
ovary_noun	aMdASaya
overgrazing_noun	awi_carAI
overstocking_noun	jyAxA_sAmAna_BaranA/awi_saMcaya_karanA
ovule_noun	bIjAMda
paddy_noun	XAna
pamphlet_noun	puswikA
pan_noun	kadZAhI/kuMdA/pEna/papadZI
papaya_noun	papIwA
paracitism_noun	parajIviwA
parameter_noun	prAcala/samaRti
parameters_noun	mApaxaMda
parasite_noun	parajIvI/parajIva
parasites_noun	parajIvI
parasitism_noun	parajIviwA
parenchyma_noun	mqxUwaka/pErenkAimA
parents_noun	mUla/janaka/pEwq_ka
parthenogenesis_noun	aniRekajanana
participate_noun	BAga_lenA
participatory_noun	BagIxArI
particulars_noun	byorA/vivaraNa
partner_noun	BAgIxAra
partnership_noun	BAgIxArI
part-time_noun	aMSakAlika
pastoral_noun	lobiyA
pasture_noun	carAgAha
pathogenecity_noun	rogajanakawA
pathogen_noun	roga_janaka/rogANu/rogajanaka
peach_noun	AdU
pea_noun	matara
pelleting_noun	kotiMga/parawa_caDZAnA
penetrability_noun	veXanIyawA
perceive_noun	mahasUsa/anuBava_karanA/samaJanA
percentage_noun	prawiSawa
perclation_noun	risana/risanA/aMwaHsrAva/cyAvana/cyavana
percntage_noun	prawiSawa
percolate_noun	CAnanA/PEla_jAnA
perennial_noun	cirasWAI/bahuvarRI
performance_noun	niRpAxana/praxarSana
performation_noun	kArya
permeability_noun	pAragamyawA
perturbations_noun	avyavasWA
pesticide_noun	pIdZakanASI
pesticides_noun	kItanASI/nASIjIva
pest_noun	kIta/nASIjIva/nASaka_jIva/pIdZaka/isake_aMwargawa
phenology_noun	qwu_jEvika_caryA_vijFAna/qwujEvikI
photoperiodism_noun	prakASAvaXi_praBAva
photosynthesis_noun	prakASa_saMSleRaNa
photosynthesized_noun	prakASa_saMSleRI
picking_noun	cunanA
pigenopea_noun	arahara
pigeonpea_noun	arahara/wUvara/wUra
pineapple_noun	annAnasa
planning_noun	niyojana
plantation_noun	ropaNa/lagAnA
planter_noun	ropAI_yaMwra
planting_noun	ropAI
plantlet_noun	pAxapaka
plant_noun	pOXA/pAxapa
platy_noun	pletI
ploughing_noun	juwAI
plum_noun	AlU_buKArA
pollination_noun	parAgaNa
pollution_noun	praxURaNa
polymorphism_noun	bahurUpawA
polyploids_noun	bahuguNiwa
pomegranate_noun	anAra
population_noun	AbAxI
porosity_noun	CixralawA/saraMxrawA
post-climax_noun	paSca_caramAvasWA/caramAvasWA_ke_bAxa
potency_noun	kRamawA
potentialities_noun	kRamawA
potential_noun	Sakwi
pre-bearing_noun	Palana_pUrva
precipitate_noun	varRaNa
precipitation_noun	avapawana/avakRepaNa
pre-climax_noun	caramAvasWA_pUrva
predators_noun	paraBakRI
preliminary_noun	prAraMBika
premeability_noun	pAragamyawA
preparedness_noun	wEyAriyAz
preservation_noun	parirakRaNa
pressing_noun	xabAI/presiMga
presumably_noun	anumAnawaH/saMBavawaH
prevailed_noun	praBAvI/prabala,
prevalent_noun	pracaliwa
probe_noun	jAMca
processor_noun	saMsAXaka
producer_noun	uwpAxaka
produce/yield_noun	pOxAvAra
production_noun	uwpAxana
productivity_noun	uwpAxakawA
product_noun	uwpAxa
profile_noun	proPAila
profitability_noun	lABaxeyawA
profit_noun	lABa
progenies_noun	saMwawi/vaMSa_ja
projection_noun	prakRepa
project_noun	pariyojanA
proliferation_noun	pracuroxBava
prolong_noun	baDZanA/laMbA/xIrGa
prominence_noun	viRiStawA/pramuKawA
promotion_noun	paxonnawi
prone_noun	praNawa
properties_noun	guNa/Xarma/guNa
property_noun	saMpawwi
proportionate_noun	samAnupAwika_xara
proportion_noun	anupAwa
proposal_noun	praswAva
proposition_noun	praswAviwa_yojanA
propriety/justification_noun	Ociwya
protein_noun	protIna
protoplasm_noun	jIva_xravya
pruning_noun	pOXoM_kI_kAta_CAMta
public_noun	sArvajanika
puddling_noun	gIlI_juwAI/mittI_yA_gArA_lagAnA
pulp_noun	lugaxI
pulpwood_noun	gUxexAra_lakadZI
pulses_noun	xalahana/xAleM/xalahaneM/xalahana
purification_noun	pariSuxXikaraNa
putative_noun	waWAkalpiwa
quadrat_noun	cawuRkoNaka/kvAda
qualitative_noun	guNAwmaka
quality_noun	guNavawwA
quantity_noun	mAwrA/parimANa
quarantine_noun	saMgaroXa
race_noun	praBexa/prajAwi
raddish_noun	mUlI
radicle_noun	mUlAMkura
rainfall_noun	vqRti/varRA/meha
rainfed_noun	bArAnI/varRA_AXAriwa
rain_noun	varRA
raisins_noun	kiSamiSa
random_noun	samasaMBAvika
range_noun	xUrI/kRewra/ilAkA/maMdala
rate_noun	xAma
rationalization_noun	warkabaxXa_vyAKyA
ratooning_noun	pedZI/mUdZI
reaction_noun	prawikriyA
recessive_noun	apraBAvI
reclamation_noun	suXAra/suXAra/uxXAra
recognition_noun	mAnyawA
recommended_noun	anuSaMsiwa/siPZAriSa/praswAviwa
record_noun	aBileKa
recoverable_noun	vasUlI_yogya
recovery_noun	upalabXi/punaH_prApwi
recycling_noun	puna/punaHcakra
reduction_noun	apacayana
refinement_noun	pariSkaraNa
reforms_noun	suXAra
regeneration_noun	kqwrima_pravqxXi/punarjanana
regression_noun	samASraNa
regular_noun	niyamiwa
regulator_noun	niyaMwraka/niyAmaka
reimbursement_noun	prawipUrwi
rejuvenate_noun	nayA_kara_xenA/navIkaraNa/kAyAkalpa
relatively_noun	apekRAkqwa
relative_noun	sApekRa
release_noun	vimocana
relevance_noun	prAsaMgikawA/upayukwawA
remunerative_noun	lABakArI
renewable_noun	navIkaraNIya
renifarm_noun	vqkkAra/renIPArma
replacement_noun	prawisWApana
replanting_noun	punaHropaNa
repository_noun	saMgraha
representative_noun	prawiniXi
reproductive_noun	jananIya
requirements_noun	AvaSyakawAez/apekRAez
residual_noun	avaSiRta
resistant_noun	prawiroXI
resources_noun	saMsAXana
respiration_noun	Asana
respone_noun	anukriyA
response_noun	prawyuwwara/anukriyA
responsiveness_noun	prawikriyASIla
restoration_noun	punaH_sWApana
result_noun	pariNAma
resurgence_noun	punarjIviwa/punarUwWAna
retailer_noun	Putakara_vyApArI
retained_noun	rahane_xenA/banAe_raKanA
retardant_noun	avaroXaka
reverine_noun	naxIya
rhizome_noun	prakaMxa
rhizosphere_noun	saMkavakI
rigorous_noun	kaTora/xqDZa
rill_noun	alpasariwa
rind_noun	CilakA
root_noun	mUla
rotation_noun	pariBramaNa/hera-Pera/GUrNana
rust_noun	rawuvA
safflower_noun	kusuma
sale_noun	bikrI/vikraya
saline_noun	lavaNIya
salinity_noun	lavaNawA/lavaNIya
salinization_noun	KArI_banAnA
sample_noun	namUnA
sandy_noun	rewIlI
sapodilla_noun	cIkU
saponification_noun	svaPejana
satisfactory_noun	saMwoRajanaka
saturated_noun	saMwqpwa
savannah_noun	savAnA/uccakatibaMXIya_GAsa_ke_mExAna
scenario_noun	parixqSya
screening_noun	CAnabIna/saMvIkRaNa
script_noun	AleKa
scrutiny_noun	saMvIkRA
seasonal_noun	mOsamI/sAmayika/mOsamI
sediment_noun	walaCata/kalka/avasAxa
seedling_noun	bIja_pOXA/pOXa
seedlings_noun	pOXa
seed_noun	bIja
seepage_noun	prasrava
selected_noun	cuniMxA
selection_noun	cayana/varaNa
seller_noun	vikrewA
senescence_noun	jIrjawA/pawwiyAM_girAnA
separate_noun	pqWaka
sequence_noun	anukrama
sericulture_noun	koSakIta_pAlana/reSama_uwpAxana/reSama_uwpAxana
sewage_noun	nikAsa_jala
shaking_noun	hilAnA/hilanA
shear_noun	karwana
sheathing_noun	AvaraNa
shedding_noun	JadZanA
shoot_noun	praroha
shrub_noun	JAdZI/kRupa
significant_noun	ulleKanIya/sArWaka
silviculture_noun	vana-vqkRa_vijFAna
skills_noun	kOSala
slope_noun	DAla/DalAna/pravaNawA
sloppy_noun	DAlU
smut_noun	kaMduvA
soclime_noun	mqxA_jalavAyu
softwood_noun	mqxukARTa/narama_lakadZI
soil_noun	mqxA/mqxA/mittI
solubility_noun	vileyawA/GulanaSIlawA
solution_noun	Gola
solvent_noun	vilAyaka
somatic_noun	kAyika
sorghum_noun	jvAra
source_noun	srowa
sowing_noun	bovAI/buAI/ropAI
spacing_noun	aMwarAla/aMwarAlana/xUrI
spange_noun	CiyAwuraI
spathe_noun	SUkICaxa
spatial_noun	AkASIya
specialist_noun	viSeRajFa
species_noun	prajAwi
specimen_noun	namUnA
spectacular_noun	camawkArI/AScaryajanaka
spectrum_noun	varNakrama
spices_noun	masAleM
sponsored_noun	prAyojiwa/prAyojiwa_karanA
spore_noun	bIjANu
sporulation_noun	bIjAnukajanana
spounding_noun	aNdajanana
spraying_noun	CadZakAva
spray/sprayer_noun	PuhAra
sprinkle_noun	CidZakAva
sprinkler_noun	secaka
sprinkling_noun	PavvArA_siMcAI
sprouting_noun	aMkuraNa
stakeholders_noun	paNaXArI
staking_noun	sahArA_xenA
stalk_noun	daMTa_la/vqnwa
stamens_noun	puMkesara
standard_noun	mAnaka
static_noun	sWira
statistics_noun	sAMKyikIya
status_noun	sAmAjika_sWiwi/avasWA/vaswusWiwi
stem_noun	wanA
sterility_noun	anurvarawA/baMXyawA
sterilization_noun	nirjalIkaraNa/nirjarmIkaraNa
stiffness_noun	kadZApana
stigma_noun	vawikAgra
stimulated_noun	preriwa_karanA/prowsAhiwa_karanA
stipule_noun	anuparNa
stomatal_noun	raMXI/stomI
storm_noun	wUPZAna/pravAwa/JaMJAvAwa
strain_noun	nasla/nasla/viBexa
strategies_noun	yojanAeM/yuxXanIwi/raNanIwi/yuxXa_yojanA
streamlining_noun	saMgawa_banAnA
stress_noun	prawyAbala/xabAva/stresa/prawibalawA
strides_noun	weja/wIA_gawi
structure_noun	saMracanA/racanA/banAvata/nirmANa/nirmiwa
structures_noun	saMracanAeM
stubble_noun	DUzTa/mUdZI/mUda
subsequant_noun	paravarwI
subsidy_noun	imaxAxa
sub-soiling_noun	avaBUmi
substance_noun	xravya
substantial_noun	samqxXa
sub-tropical_noun	upoRNa
suceptible_noun	sugrAhya
sucking_noun	cURaka
sunfower_noun	sUrajamuKI
supply_noun	ApUrwi/pUrwi
suppression_noun	xamana/niroXa
surveyer_noun	sarvekRaka
survey_noun	sarvekRaNa
survival_noun	jIviwa_rahanA
susceptibility_noun	grahaNaSIlawA
sustainable_noun	tikAU/tikAU/sawawa
symbiosis_noun	sahajIvana/sahajIviwA
symbiotic_noun	sahajIvI
synchronizing_noun	samakAlika/eka_hI_samaya_meM_honA
synchronous_noun	samakAlika
syndorm_noun	siMdroma/saMlakRaNa
synergist_noun	sahayogI
synthesis_noun	saMSleRaNa
synthetic_noun	saMSleRiwa/kqwrima
systemic_noun	saMrvAMgI/xEhika
tank_noun	tEMka/taMkI/hOjZa/kuMda
technology_noun	prOxyogikI
temperate_noun	SIwoRNa
temperature_noun	wApa/wApamAna
tendril_noun	kopale
tensiometer_noun	pqRTawanAvamApI
terracing_noun	sIDIxAra_Kewa_banAnA
tetraploid_noun	cawurguNiwa
texture_noun	gaTana/gaTana/banAvata/AkAra/Uwaka
thermoperiodicity_noun	WarmAepIriyadZisitI
thickness_noun	motAI
thining_noun	viralana/pawalA_karanA
think-tank_noun	vicAra-BaMdAra
thrips_noun	Wripsa
thunderstrom_noun	wadZiwa_JaMJA
tillage_noun	juwAI
tiller_noun	kqRaka/jowane_vAlA/tillara/xojI
tilth_noun	tilWa/bone_yogya/vApsA
tobacco_noun	wambAkU
tolerant_noun	sahiRNu
topoclimatology_noun	sWAlAkqwi/jalavAyuvijFAna
topography_noun	sWAlAkqwi_vijFAna
toposequence_noun	sWAlAkqwi
toxicity_noun	viRElApana
tracing_noun	anureKaNa
tracts_noun	saMBAga
trade_noun	vyApAra
trail_noun	parIkRaNa
transformation_noun	rUpAMwaraNa
transgenic_noun	parajIvI
translocation_noun	saMkramaNa/sWAnAMwaraNa
transmission_noun	saMcAraNa/saMwaraNa/haswAMwaraNa/pAraNa
transpiration_noun	vARpowsarjana
transplantation_noun	prawiropaNa
transportation_noun	parivahana
transport_noun	parivahana
trasplanter_noun	prawiropaka
treatise_noun	SoXa-prabaMXa_puswaka
tree_noun	pedZa
trench_noun	KAI
trial_noun	jAMca
trough_noun	nAlI
tube-well_noun	nalakUpa
turf_noun	KarapawavAra
turgidity_noun	ASunawA
turmeric_noun	halxI
twig_noun	tahanI
ulcerative_noun	alasaretiva
uncultivable_noun	akqRya
unfavourable_noun	prawikUla
unprecedented_noun	aBUwapUrva/pUrva
unpredictability_noun	ananumeya
unremunerative_noun	alABakara/GAte_kA
upgradation_noun	unnawi/unnayana
uplift_noun	Upara_uTAnA
uptake_noun	uxgrahaNa
urban_noun	nagara_saMbaMXI
usage_noun	prayoga/upayoga
utilisation_noun	upayoga
vaccination_noun	tIkI_karaNa
vaccine_noun	vEksIna/tIkA
vaporization_noun	vARpowsarjana
variability_noun	parivarwanaSIlawA
variable_noun	parivarwanaSIla/vicaraNa
variety_noun	kisma/vErAitI/prajAwi/praBexa/viBexa/kZisma
varities_noun	kismeM
vector_noun	vAhaka
vegetative_noun	kAyika/vAnaspawika
vermicompost_noun	keMcuvA_KAxa/kqmi_kaMposta
virulence_noun	ugrawA
virulent_noun	viRAkwa/wIvra_viSElA
virus_noun	viRANu
vitamins_noun	vitAmina
volatilisation_noun	vARpaSIla_honA/vARpaSIla_karanA/uxvARpana
vulnerable_noun	xoRapUrNawA
wage_noun	majZaxUrI
walnut_noun	aKarota
watershed_noun	jalAgama/jalasaMcayana/jalagrahaNa/jalasaMBara/jala_viBAjaka
weedicide_noun	KarapawavAranASI
weeding_noun	nirAI-gudZAI/nirAI/nIMxanA/nirAnA
weed_noun	KarapawavAra/GAsapAwa/apawqNa/kuwqNa
weevil_noun	Xuna
wholesale_noun	Woka
wilting_noun	SiWilana
wilt_noun	mlAni/muraJAna
winnowing_noun	osAI
witt_noun	muraJA
woodland_noun	vanasWalI/vana_BUmi
workshop_noun	kAryaSAlA
xanthophyceae_noun	jEnWoPAisI_(pIwa_hariwa_SEvAla)
xanthophyll_noun	jEnWoPila/parNapIwa
x-disease_noun	eksa
xenia_noun	jIniyA
xerophyte_noun	marUxBixa
yearly_noun	eka_varRIya
yeast_noun	KZamIra/yIsta
yield_noun	upaja/pExAvAra
zeolite_noun	jiyolAita
zone_noun	KaMda/praxeSa/kRewra/maMdala
polysaccharides_noun	bahuSarkarAeda
clover_noun	wipawiyA
sustainable_adjective	vahanIya
