#civil dictionary extracted by Monika Sharma. Formatted by Roja (26-01-2016)
#Changes:: 1) Separated single word and multi words into separate dictionaries
#          2) English words are converted to lower case
#          3) Added category as 'noun' by default
###############################################################################
a.i.r.a.c._noun	e.AI.Ara.e.sI.
abacus_noun	aMkagaNaka/SIrRaPalaka
abatement_noun	upaSamana
abeam_noun	pUrA_AdZe
abetment_noun	xuRpreraNa
abeyance_noun	AsWagana
ablation_noun	apakRaraNa
ablaze_noun	prajvaliwa
abolish_noun	mitA_xenA/Kawma_karanA
aboriginal_noun	Axima/prAcIna
abrasive_noun	apaGarRI/apaGarRaka
abridgement_noun	saMkRepaNa
abrogation_noun	nirAkaraNa
abrupt_noun	apacCinna/Akasmika
absence_noun	anupasWiwi
absolute_noun	nirapekRa/parama/pariSuxXa
absolve_noun	vimukwa_karanA/xoRa_rahiwa_sixXa_karanA
absorb_noun	sa_o_Ka_nA/avaSa_o_R_A_Na_karanA/avaSa_o_iR_A_wa_karanA
absorber_noun	avaSoRaka
absorption_noun	avaSoRaNa/Amelana/vilayana
abstract_noun	sAra
abutment_noun	anusImA/sAWa_satA_huA
acceleration_noun	wvaraNa
accelerometer_noun	wvaraNamApI
acceptance_noun	svIkqwi
accessory_noun	upasAXana
accident_noun	xurGatanA
acclimatization_noun	parisWiwi-anukUlana/xaSAnukUlana
accord_noun	sa_maJO_wA/praxA_na_karanA/xa_na_e_A/ana
accountability_noun	javAbaxehI
accounting_noun	leKAMkana
accumulation_noun	saMcayana/saMcaya
accumulator_noun	saMcAyaka
accusation_noun	aBiyoga/xoRAropaNa
accuse_noun	aBiyoga_lagAnA/Aropa_lagAnA
accused_noun	aBiyukwa/AropI
across_noun	Ara-pAra
act_noun	kArya/aXiniyama_(vi)
action_noun	kArravAI
activate_noun	uwpreirawa_karanA/sakriya_karanA
active_noun	sakriya
activities_noun	kriyAkalApa/gawiviXiyAM
activity_noun	kriyAkalApa
acton_noun	ektana/EcCika_saMcAlana
actuate_noun	saMcAliwa_karanA/pravarwiwa_karanA/calAnA
adaptation_noun	anukUlana
addendum_noun	pariSiRta/anubaMXa/anuSeRa
adhesion_noun	AsaMjana
adhesive_noun	AsaMjaka
adhoc_noun	waxarWa
adiabatic_noun	'
adjacent_noun	saMlagna/nikatavarwI/Asanna
adjoining_noun	satA_huA/saMlagnaka
adjournment_noun	viXeyaka_para_carcA_kA_sWagana/sWagana
adjudication_noun	aXinirNaya/nyAya_nirNayana
adjustment_noun	samAyojana
administer_noun	praBAva_meM_lAnA/praSAsana_karanA/saMcAlana_karanA/prabaMXa_karanA
administration_noun	praSAsana
administrative_noun	praSAsanika
admissibility_noun	grAhyawA/svIkAryawA
admissible_noun	grAhya/svIkArya
admittance_noun	praveSyawA
admitted_noun	gqhIwa/svIkqwa
admonish_noun	BarwsanA_karanA
adulteration_noun	milAvata/apamiSraNa
advance_noun	agrima/peSagI
advocate_noun	vakIla/edavoketa
aerate_noun	vAwana/vAyu_saMcAraNa
aerobatics_noun	eyarobetiksa/havAI_kalAbAjI
aerodrome_noun	havAIaddA/eyarodroma
aerodynamics_noun	vAyugawikI
aerology_noun	vAyu_vijFAna
aeromechanics_noun	vimAna_yAMwrikI
aeronautics_noun	vEmAnikI
aeroplane_noun	vAyuyAna
aerostat_noun	vAyusWAyI
aerostatic_noun	vAyusWEwikI
aerostation_noun	vimAna_steSana
aerostructure_noun	vimAna_saMracanA
affidavit_noun	SapaWa_pawra/halaPanAmA
affirmation_noun	prawijFAna
agenda_noun	kAryasUcI
agent_noun	aBikarwA/ejenta
aggregation_noun	samuccaya/samUha
aggrieved_noun	vyaWiwa
agm_noun	sahAyaka_mahAprabaMXaka
agrarian_noun	BUmi_saMbaMXiwa/kqRi_saMbaMXI
agreement_noun	anubaMXa/karAra/samaJOwA
aileron_noun	EleroYna/saha_pakRa
air-cooled_noun	vAyu-SIwiwa
air-tight_noun	vAyu
aircraft_noun	havAI_jahAja/vimAna
aircrew_noun	vAyu_peca
airfield_noun	vimAna_kRewra
airfoil_noun	vimAna_PoYyala
airframe_noun	eyaraPrema
airline_noun	eyaralAina
airplane_noun	vAyuyAna
airport_noun	vimAnapawwana/havAI_addA/eyaraporta
airship_noun	vAyupowa
airspeed_noun	vAyu_mApI
airway_noun	vAyupaWa/vAyumArga
airways_noun	vimAna_sevA
airworthiness_noun	udZanayogyawA
aledo_noun	XavalawA
alignment_noun	nirXAriwa_sIXa/siXAI_saMreKaNa/saMreKaNa
allegation_noun	Aropa/xoRAropaNa
allegiance_noun	niRTA/rAjya_niRTA
alliance_noun	mEwrI/gaTabanXana
allocation_noun	AbaMtana/niyawana
allotment_noun	AbaMtana
allow_noun	anumawi_xenA
allowance_noun	CUta/BawwA
allowances_noun	Bawwe
alloy_noun	miSra_XAwu/elAya
alpha_noun	alPA
alteration_noun	parivarwana/Perabaxala
alternator_noun	prawyAvawiwra/Altaranetara
altimeter_noun	wuMgawAmApI/Aroha_mApaka/UMcAI_mApaka
altitude_noun	UMcAI
altitudes_noun	uzcAI/wuMgawA/uEYMcAI
alto-status_noun	maXyaswarIya
am-pm-receiver_noun	e_ema-pI_ema/risIvara
amalgamation_noun	samAmelana/samAhiwa_karanA
ambit_noun	viswAra_kRewra/xAyarA/sImA_pariXi
ambulance_noun	EMbuleMsa
amelioration_noun	behawarI/nivAraNa/nirAkaraNa
amendment_noun	saMSoXana/suXAra
amenities_noun	suKa-suviXAeM
ammeter_noun	EmItara
amortization_noun	pariSoXana
ampere_noun	vixyuwa_pravAha_mApa
amplidyne_noun	emplIdAina
amplification_noun	pravarXana
amplifier/booster_noun	pravarXaka/varXaka
amplifier_noun	pravarXaka
amplitude_noun	AyAma/koNAMka
analogous_noun	anu
anchor_noun	laMgara/sWiraka
ancillary_noun	anuRaMgI/sahAyaka/gONa
anemograph_noun	vAyuvega_leKI/enImogrAPa
anemometer_noun	vAyuvega_mApI
angles_noun	koNa
anglo-indian_noun	AMgla-BArawIya
anisotropic_noun	viRaNa_xESika
annexure_noun	anubaMXa
announcement_noun	GoRaNA
annuity_noun	vArRikI
anode_noun	Enoda/XanAgra
anomaly_noun	asaMgawi
antecedent_noun	pUrvagAmI/pUrvavqwwa
anticlockwise_noun	vAmAvarwa/viparIwa_xiSA_se
anticyclone_noun	prawicakravAwa
antiquities_noun	purAvaSeRa
apex_noun	SIrRa/ucca
apparatus_noun	upakaraNa
appendant_noun	upAbanXa/saMlagnaka
appendix_noun	pariSiRta
appliance_noun	upakaraNa
applicability_noun	lAgU_honA/prayojyawA
applicant_noun	Avexaka
application_noun	Avexana
appointment_noun	niyukwi
apportionment_noun	praBAjana/vimAnana/saMvimAjana
appraisal_noun	AMkanA/mUlyani
apprehension_noun	SaMkA
apprentice_noun	praSikRu/praSikRaNArWI
apprised_noun	avagawa_karAnA
approach_noun	nikatawA/pahuMca/ruKa/saMparka_karanA
approbation_noun	anumoxana
appropriation_noun	viniyoga
approval_noun	anumoxana/svIkqwi
apron_noun	eprana
apropos_noun	ke_saMxarBa_meM
arbitrary_noun	eka_waraPA/manamAnA
arch_noun	maharAba
archives_noun	aBileKAgAra
arduous_noun	kaTina/xuRkara
arrears_noun	bakAyA
arrival_noun	Agamana
article_noun	anucCexa
artisan_noun	SilpI
aspersion_noun	lAMCana/Aropa
assayer_noun	pAraKI/mUlyAMkanakarwA
assemble_noun	samavewa_honA/ekawra_honA
assent_noun	sahamawi/svIkqwi/anumawi
assessed_noun	nirXAriwa/mUlyAMkiwa
assessment_noun	nirXAraNa/mUlyAMkana/Akalana
asset_noun	parisampawi
assets_noun	parisaMpawwiyAM/AswiyAM
atmosphere_noun	vAyumaMdala
atmospherics_noun	vAyumaMdalIya_kolAhala
attitude_noun	muxrA/ravEyA/pravqwwi
auction_noun	nIlAmI
authority_noun	prAXikaraNa
autopilot_noun	oYtopAyalata
autorotation_noun	svaGUrNana/oYto_roteSana
aviation_noun	vimAnana
aviator_noun	vimAna_cAlaka
avionics_noun	vEmAnikI/evioniksa
axis_noun	akRa
axle_noun	XurA/XurI/eksala
backing_noun	piCalA_BAga/pqRTAXAra
baffle_noun	bAXikA
balance_noun	SeRa
ballast_noun	gittI
ballistic_noun	prakRepika
ban_noun	prawibaMXa/roka
bankrupt_noun	xivAliyA
bar_noun	CadZa
barograph_noun	vAyuxAba_leKI
barometer_noun	vAyuxAba_mApI
baroreceptor_noun	xAbagrAhI
barrier_noun	avaroXa/roXikA/roXa
battery_noun	bEtarI
beacon_noun	bIkana/bImana/saMkewaxIpa
beading_noun	mAnikAyana
beam_noun	Xarana/kiraNa_puMja
bearing_noun	beyariMga
beater_noun	WApI/bItara
beneficiaries_noun	lABArWI
benevolence_noun	hiwakAriwA
bid_noun	bolI
biennial_noun	xvivArRika
bifurcation_noun	xo_BAgoM_meM_bAMtanA/viBakwa_karanA
bilateral_noun	xvipakRIya
binding_noun	bAMXanA/baMXanI/bAXyakara/anivArya
biplane_noun	xvipaMKI_vimAna
blizzard_noun	barPAnI_wUPAna
boarding_noun	vimAna_para_savAra_honA/bordiMga
body_noun	piMda/kAya/nikAya
boiler_noun	boYyalara
bolt_noun	kAbalA/bolta
bonafide_noun	vAswavika/sAvapUrvaka/sAva_se
bond_noun	baMXa-pawra/bAMda
bonus_noun	bonasa
boom_noun	gUMja/XUma
boring_noun	veXana/praveXana
borrowing_noun	karja/qNa
bounce_noun	kulAMca/uCAla
brake_noun	breka/AroXa
breakfast_noun	nASwA
breeze_noun	samIra
brevity_noun	saMkRipwawA
broadcasting_noun	prasAraNa
brochure_noun	vivaraNikA
budget_noun	bajata
bulletin_noun	buletina/samAcAra
buoyancy_noun	uwplAvakawA/plavanaSIlawA
business_noun	kAma-kAja/kArya/vyApAra
buy-back_noun	prawi-kraya/punaH_KarIxa
bye-law_noun	upaniyama
cabin_noun	kakRa/kebina
cabinet_noun	maMwrimaMdala/alamArI/petikA
cadre_noun	saMvarga/kAdara
calibrate_noun	aMSa-SoXana_karanA/aMSAkana_karanA
camber_noun	uBAra/nyujawA/kEmbara
camshaft_noun	kEma_SAPta
cancellation_noun	apavawa_rna/inarasa_na/raxxa_karanA/ivalo_pana/raxxakaraNa
candidate_noun	ummIxavAra/aByarWI
candidature_noun	ummIxavArI/aByarWiwA
canvassing_noun	mawArWana
capitulation_noun	AwmasamarpaNa_pawra
captain_noun	kEptana/kapwAna
carburization_noun	kArbana_vyApana
cargo_noun	kArgo/sAmAna
carriage_noun	vahana
cartelization_noun	saMGabaxXa_honA
cascade_noun	sopAnI
casting_noun	DAlanA/DalAI
casual_noun	aniyawa/nEmiwwika
catalogue_noun	graMWa-sUcI/sUcIpawra
category_noun	SreNI
catering_noun	AhAra_prabaMXa
causality_noun	hewukawA/kAraNawA
caution_noun	sAvaXAnI/sAvaXAna
cavitation_noun	Cixrana
cease_noun	banxa_karanA/samApwa_karanA
ceiling_noun	uccawama_sImA/aMwima_sImA/sIliMga
censure_noun	ninxA/apavAxa
certification_noun	pramANIkaraNa/pramANana
certiorari_noun	uwpreRaNa-leKa
cess_noun	upakara
chain_noun	SrqMKalA/cena
chair_noun	saBApITa
chairman_noun	saBApawi/aXyakRa
chairperson_noun	aXyakRa
chambers_noun	kakRa
chapter_noun	aXyAya/pATa
charge_noun	cArja/AveSa/praBAra
chargeman_noun	cArjamEna
charges_noun	praBAra
chargesheet_noun	Aropa_pawra
chart_noun	cArta
chassis_noun	cOkI
check-in-counter_noun	cEka-ina-kAuMtara
check-in-formalities_noun	cEka-ina-OpacArikawAeM
checklist_noun	jAzcasUcI
chronology_noun	kAlakrama
circuit_noun	paripaWa
circulars_noun	paripawra
circulated_noun	paricAliwa
circulation_noun	paricAlana/parisaMcaraNa
circulator_noun	parisaMcAriwra
clarification_noun	spaRtIkaraNa
clause_noun	XArA
clearance_noun	anumawi
climatology_noun	jalavAyu_vijFAna
clockwise_noun	xakRiNAvarwa
closure_noun	samApana
clubbing_noun	sAWa-sAWa/saMyukwa_karanA
co-activator_noun	saha-kriyaka
co-pilot_noun	saha-pAyalata
coalition_noun	milI_julI/sAJA/gaTabaMXana/sammilana
cockpit_noun	cAlaka_kakRa/kAkapita
coercion_noun	xabAva/niyaMwraNa/bala_prayoga
cognizance_noun	vicArAXikAra/saMjFAna
collision_noun	takkara
commemorative_noun	smAraka/smqwi_sva
commencement_noun	prAramBa/AraMBa_karanA
commendable_noun	praSaMsanIya/sarAhanIya
commensurate_noun	anu
comments_noun	tIkA_tippaNI/tippaNI/vicAra
compass_noun	kuwubanumA/xivasUcaka/kampAsa
compassionate_noun	anukampA
compensation_noun	kRawipUrwi/harjAnA
compliance_noun	anupAlana
component_noun	avayava/Gataka
compressor_noun	kamprESara
compute_noun	saMgaNana_karanA/saMgaNanA
concentration_noun	ekAgrawA/saMkexraNa
concept_noun	parikalpanA/saMkalpanA
concurrence_noun	sahamawi
condenser_noun	kaNdeMsara/xraviNawra/saMGaniwra/saMGAriwra/saMBAriwa_(bijalI)
conduct_noun	AcaraNa/vyavahAra/saMcAlana
conductivity_noun	cAlakawA
conductor_noun	saMvAhaka
connection_noun	saMparka
connector_noun	kanektara
consensus_noun	sahamawi
consider_noun	vicAra_karanA
consideration_noun	vicAra_ke_liye
consignee_noun	pareRiwI/prApwakarwA
consignment_noun	pareRaNa
consignor_noun	pareRaka
constitute_noun	gaTiwa_karanA/gaTana_karanA
constitution_noun	saMviXAna/viXAna/niyama/vyavasWA
construe_noun	arWa_lagAnA/samaJanA
consultant_noun	parAmarSaxAwA
contain_noun	aMwarviRta
contemplated_noun	vicAra_karanA_apekRiwa
contemporaneous_noun	samakAlIna
contiguous_noun	saMsakwa/satA_huA/nikatasWa
contingencies_noun	Akasmika_vyaya/AkasmikawAeM/samBAvyawA/prAsaMgikawA
continued_noun	kramAgawa
contractor_noun	TekexAra
convection_noun	saMvahana
convertor_noun	saMparivarwaka
conveyer_noun	vahiwra/vAhaka/kanveyara
coolant_noun	SIwaka_xravya/kulenta
cooler_noun	SIwaka/kUlara
copper_noun	wAMbA/wAmra
core_noun	krora
cost_noun	lAgawa
costing_noun	lAgawa_nirXAraNa
couple_noun	yugma/balayugma
coupler_noun	yugmaka/kaplara
coupling_noun	yugmana/yugmaka/kapaliMga
courting_noun	AvaraNa/DZakkana
crack_noun	xarAra
crash_noun	GvaMsa/xurGatanA
credit_noun	uXAra
creditors_noun	lenaxAra/qNaxAwA
criteria_noun	mApaxaNda
cruise_noun	pariBramaNa
cumulative_noun	saMcayI
curtain_noun	paraxA
custodian_noun	saMrakRaka_aBirakRaka
damage_noun	kRawi
damages_noun	harjAnA
dealer_noun	vyApArI/dIlara
debenture_noun	dibeMcara/qNa-pawra
debtor_noun	xenaxAra/qNI
decoding_noun	kUta_vAcana/dikodiMga
defaults_noun	cUka/wrutiyAM
deficiency_noun	kamI
deficit_noun	kamI
definition_noun	pariBARA
deflector_noun	vikRepaka/diPlektara
delegate_noun	prawyAyojiwa_karanA/sOMpanA
delegation_noun	SiRtamaMdala/prawiniXi-maMdala/prawyAyojana
delete_noun	kAtanA/hatAnA/nikAla_xenA/mitAnA
deletion_noun	ucCexa/vilopa/vilopana/apamArjana/hatA_xiyA_jAnA
deliberated_noun	saMkalpiwa_suvicAriwa/vicAra-_vimarSa/paryAlocana
delivery_noun	supurxagI
demotion_noun	paxAvanawi
density_noun	saGanawA/Ganawva
departure_noun	prasWAna
depose_noun	aBisAkRya_xenA
depreciation_noun	mUlyahrAsa
deputation_noun	prawiniyukwi
derailment_noun	avapaWana/patarI_se_uwaranA
dereservation_noun	ArakRaNa_samApwa_karanA
derogation_noun	alpIkaraNa/anAxara
descending_noun	avarohI/avarohana
designated_noun	nAmoxxiSta/paxanAmiwa/paxABihiwa
designation_noun	paxanAma
desirability_noun	vAMCanIyawA
destination_noun	gaMwavya_sWAna
detector_noun	saMsUcaka/ditektara_(siganala)
determine_noun	nirXAraNa
detrimental_noun	hAnikara
devaluation_noun	avamUlyana
deviate_noun	lIka_se_hatanA
deviation_noun	vicalana
device_noun	viXi/upAya
devolution_noun	anwaraNa/haswAMwaraNa
dgm_noun	upa_mahAprabaMXaka
diameter_noun	vyAsa
diaphragm_noun	dAyAPrAma/wanupata/maXyapata
die_noun	dAI/TappA
dies-non_noun	agaNanIya_xivasa/akArya_xina_(vi)
difference_noun	aMwara
dignitary_noun	gaNamAnya_vyakwi/prawiRTiwa_vyakwi
dignity_noun	garimA
dilatory_noun	vilambakArI
diligent_noun	pariSramI/uxyamI/aXyavasAyI
dimensions_noun	AyAma
dinner_noun	rAwri
diplomatic_noun	rAjanayika/kUtanIwijFa
directive_noun	nixeSa
discharge_noun	visarjana/nissaraNa
discretion_noun	vivekAXikAra/viveka
disembarked_noun	avawariwa
disfigure_noun	vi
dishonest_noun	beImAna/kapatI
disintegration_noun	viGatana/kaNIkaraNa
disinvestment_noun	viniveSa
dismantle_noun	purje_KolanA/viKaMdIkaraNa
dismay_noun	vyaWiwa_honA/mohaBaMga_honA
dismiss_noun	paxacyuwa_karanA
disparity_noun	asamAnawA
displeasure_noun	aprasannawA/nAKuSI/nArAjagI
disposal_noun	nipatAna
dispute_noun	vivAxa
disqualification_noun	niraharwA/ayogyawA
distortion_noun	vi
distributor_noun	viwaraka
disturbance_noun	vikRoBa
divergences_noun	apasaraNa
dividend_noun	lABAMSa
documentation_noun	praleKana
documents_noun	kAgZajAwa/xaswAvejZa/prapawra/kAgajZAwa
domestic/international_noun	Garelu/anwarrARtrIya
domestic_noun	aMwaraxeSIya_(GarelU)
domicile_noun	aXivAsa/nivAsa
donation_noun	xAna
downgrade_noun	mahawva_meM_kamI_karanA/dAunagreda_karanA
draft_noun	prA
drafting_noun	prA
drag_noun	walakarRaNa
drill_noun	baramA/beXanI
drizzle_noun	PuhAra
duly_noun	viXivawa
dummy_noun	akriya
durability_noun	tikAUpana
duration_noun	avaXi
dy.crss&t_)_noun	upa_rela_saMrakRA_Ayukwa(siga.evaM_xUra.)
dynamics_noun	gawivijFAna/gawikI
earmark_noun	uxxiRta_karanA/alaga_se_cinhiwa_karanA/nirxiRta_karanA
easting_noun	pUrvI_nirxeSAMka
eccentricity_noun	uwkenxrawA
eclecticism_noun	sAra-saMgraha
economic_noun	ArWika
educator_noun	apasAraka
effectually_noun	praBAvakArI_rIwi_se
efficacious_noun	praBAvowpAxaka
efficiency_noun	kArya_kuSalawA
effusion_noun	ni(kolana)saraNa
elaborate_noun	viswAra_se_bawAnA
elapsed_noun	vyapagawa
elected_noun	nirvAciwa
element_noun	alpAMSa/elimeMta/avayava/Gataka
elevate_noun	Upara_uTAnA
elevation_noun	ucAna/uwWAna/UzcAI
elevators_noun	elivetara
eligibility_noun	pAwrawA
eligible_noun	pAwra
embankment_noun	wata-banXa
embargo_noun	roka
embarkation_noun	savAra_honA
embezzlement_noun	gabana
emolument_noun	parilabXi
empennage_noun	eyarakrAPta_kA_piCalA_sirA/vimAna_paSca
encased_noun	samAvqwwa/AkoRiwa
endeavour_noun	prayAsa
endorsement_noun	pqRTAMkana
endurance_noun	avaXi_kRamawA
energizing_noun	UrjAyana
engine_noun	iMjana
enquiry_noun	pUCawACa/jAMca/jAMca-padZawAla
enrooted_noun	pAravahana
entitle_noun	aXikAra_xenA/hakaxAra_banAnA
entitled_noun	pAwra
entitlement_noun	hakaxArI/aXikAriwA/pAwrawA
entrepreneur_noun	uxyamI/vyavasAyI
environment_noun	paryAvaraNa
envisage_noun	kA_sAmanA_karanA/kA_XyAna_karanA/saMkalpanA_karanA
envisaged_noun	parikalpiwa
epitome_noun	sAra/niRkarRa
equal/equality_noun	samAna/samawA/samAnawA
equilibrium_noun	sAmyavasWA/saMwulana/sAmya
errata_noun	SuxXi-pawra
escalator_noun	calawI_sIDZI/cala_sopAna
escape_noun	awivAhI/nissaraNa
establishment_noun	sWApanA
estimates_noun	anumAna/Akalana
etiquette_noun	SiRtAcAra
evaluation_noun	mUlyAkaMna
evidence_noun	sAkRya/sabUwa
ex-officio_noun	paxena
ex-parte_noun	eka-pakRIya
excavation_noun	KuxAI
exclude_noun	apavarjiwa_karanA/alaga_karanA
executive_noun	kAryapAlaka/kAryakArI
exempted_noun	CUta_xenA/avamukwa
exemption_noun	vimocana/unmocana/CUta/mAPI/avamukwi/vimukwi
exercise_noun	aByAsa/prayAsa
exigency_noun	wAwkAlika_AvaSyakawA
existing_noun	vixyamAna/varwamAna/praswuwa/mOjUxA/pracaliwa
exit_noun	nirgama
exonerate_noun	Aropa-mukwa_karanA
exosphere_noun	bAhyawama_maMdala
expand_noun	viswAra
expatriates_noun	vixeSI
expedient_noun	samIcIna
expenditure_noun	vyaya/Karca
explicit_noun	spaRta
exploder_noun	visPotiwra
exploitation_noun	xohana/SoRaNa
explosive_noun	visPotaka
exponent_noun	prawipAxaka/prawiniXi
expulsion_noun	niRkAsana/bahiRkaraNa/nikAla_xenA
eyelet_noun	akRikA
fabricate_noun	gaDZanA
facilitate_noun	Age_baDZAnA/sarala_banAnA
facility_noun	suviXA/sugamawA
fad_noun	Jaka/sanaka
fading_noun	prabalawA_vicaraNa/maMxana
failure_noun	KarAbI/BaMga/viPalawA
fan_noun	paMKA
faucet_noun	laGutoMtI
feathering_noun	paMKaraNa/viswaraNa/SUnya_praNoxana
federal_noun	keMxrIya_SAsana_se_saMbaMXiwa
filament_noun	xIpwi-waMwu/waMwu
fin_noun	paMKa
financing_noun	viwwa_poRaNa/viwwa_vyavasWA
finding_noun	Koja/nirNaya/jAMca_pariNAma/niRkarRa
findings_noun	niRkarRa_pariNAma
flap_noun	pallA
flaps_noun	prAlaMba
flat_noun	patiyA/capatA/capita
fleet_noun	vimAna-bedZA/bedZA
flick_noun	JatakA
fluidity_noun	waralawA
flush_noun	samawala/sapAta
fog_noun	koharA
foot_noun	pAxa/Puta
footboard_noun	pAyaxAna/Puta_borda
forecasting_noun	pUrvAnumAna_lagAnA
forfeit_noun	jabwa_karanA
foxtrot_noun	PoYkstrota
fracto-stratus_noun	KaNdiwa_swarI
fraud_noun	kapata/kapata_kArya
freight_noun	mAla-BAdZA/BAdZA
fund_noun	niXi/koRa
gadget_noun	yaMwrikA/maSIna
gage_noun	geja/pramApI
gale_noun	JaMJA
gallery_noun	gElarI/xIrGA
galling_noun	gaMBIra_KaroMcanA
galvanise_noun	jaswA_caDZAnA/yaSaxa_lepana
garage_noun	gErAja
gauze_noun	nAlI
gazette_noun	rAjapawra/gajata
gear_noun	giyara/garArI/yaMwrAvalI_(damabIMxapeu)/upaskara_(msamabajawapabaMsa)
generator_noun	janiwra/jenaretara
getter_noun	grAhI/avaSoRI
girder_noun	gardara
girdle_noun	meKalA
glacier_noun	himanaxa/himAnI
glider_noun	glAidara
golf_noun	golPa
governor_noun	gavarnara/aXiniyaMwraka
grade_noun	greda/SreNI
gradienter_noun	DAla_mApaka/pravaNawA_mApaka
grants_noun	anuxAna
gratification_noun	pariwoRaNa
gratuitous_noun	Anugrahika/muPwa/binA_prawiPala
gratuity_noun	upaxAna/grecyUtI
grease_noun	grIja
grievances_noun	SikAyaweM
grinding_noun	apaGarRaNa
groove_noun	KAMcA
grooving_noun	KAMcA_banAnA
guarantee_noun	prawyABUwi
guardian_noun	aBiBAvaka/saMrakRaka
gudgeon-pin_noun	gajana_pina
guidelines_noun	xiSA-_nirxeSa
guilty_noun	xoRI
gyroplane_noun	GUrNAkRa_vimAna/jAyaroplena/GUrNAkRawala
hail_noun	olA/karakA/karakApAwa
hall_noun	Gara/mahala/saBAgqha/kakRa
hammer_noun	Gana/haWOdZA
handle_noun	xaswA/mUTa/hawWA
hangar_noun	vimAnaSAlA/vimAnagqha/hEMgara
hanger_noun	mahAcCaxa/Alamya/hEMgara/vimAna_Caxa
hardenability_noun	kaToraNIyawA
hardware_noun	yaMwropaxAna/lOha_Axi_mAla_sAmAna
haze_noun	XunXa
header_noun	wodZA/muKyaka
heading_noun	hediMga/SIrRa
headway_noun	maXyAMwara/yAnAMwara
helicopter_noun	helIkoYptara
helipad_noun	helIpEda
heliport_noun	helIporta
highway_noun	mahAmArga/rAjamArga
honorarium_noun	mAnaxeya
horn_noun	hArna/wUrya/SraMga
hotel_noun	hotala
hunting_noun	cAla_xolana/cAla_preKaNa
hurricane_noun	praBaMjana/wUPAna
hut_noun	gumatI
hyetograph_noun	varRa_cArta
hygrometer_noun	ArxrawAmApI/hAigromItara
hypersphere_noun	bahuvima_golA
icing_noun	himana
identification_noun	pahacAna/SinAKwa
illegal_noun	gEra-kAnUnI
illumination_noun	jagamagAhata/praxIpwi/prakASa-vyavasWA
immigration_noun	ApravAsa
immunity_noun	unmuikwa
impeachment_noun	mahABiyoga
impedance_noun	prawibAXA
impedence_noun	prawibAXA
impeller_noun	praNoxaka/impelara
implementation_noun	kAryAnvayana
imprest_noun	agraxAya/peSagI
improbable_noun	asaMBAviwa/asaMBava
impromptu_noun	wawkAla/binA_wEyArI_ke
impropriety_noun	anOciwya/anuciwa
improvisation_noun	kAmacalAU_vyavasWA/wAwkAlika_vyavasWA
imputation_noun	AropaNa/lAMCana
inclusion_noun	aMwarveSana/samAveSana
increaser_noun	viswAraka
increment_noun	vewana_vqxXi
incriminate_noun	aparAXa_meM_PaMsAnA
incumbent_noun	paxaXArI/paxasWa/ASrayI
indemnity_noun	kRawipUrwi
indent_noun	xanwura_cihna/iMdeMta/aXiyAcana/mAMga
indentor_noun	mAMgakarwA
indenture_noun	vileKa/xaswAveja
index_noun	anukramaNikA
indexing_noun	sUcIkaraNa/anuBAjana
india_noun	BArawa/iMdiyA
indicator_noun	sUcaka
induction_noun	preraNa
infant_noun	SiSu
inflammablet_noun	valanaSIla
informatics_noun	sUcanA_vijFAna
infrastructure_noun	AXaraBUwa_DAMcA/avasaMracanA/avasWApanA
infringement_noun	ullaMGana/awikramaNa
initials_noun	AxyakRara
initiative_noun	svapreraNA
injury_noun	kRawi
innocuous_noun	hAnirahiwa/anapakArI/nirApaxa
inr_noun	BArawIya_rupayA
insensitiveness_noun	asaMvexiwA
insertion_noun	niveSana
inspection_noun	nirIkRaNa
instability_noun	asWAyiwva
installation_noun	prasWApana/sWApanA/aXiRTApana/saMsWApana/prawiRTApana
installment_noun	kiswa
instructions_noun	anuxeSa
instruments_noun	upakaraNa-yaMwra
intake_noun	anwagrarhaNa/anwargrAhI
integrity_noun	ImAnaxArI/niRTA/sawya_niRTA
intelligence_noun	AsUcanA
intelligibility_noun	boXagamyawA
inter-se-seniority_noun	paraspara_variRTawA
interaction_noun	pArasparika_kriyA/anyonya_kriyA/anwaHkriyA
interceptometer_noun	aMwarroXanamApI
interchangeable_noun	anwaraparivarwanIya
interdependent_noun	anyonyASriwa
interest_noun	byAja
interference_noun	vyawikaraNa
interflow_noun	aMwarvAha
interim_noun	aMwarima
intermediary_noun	maXyavarwI
intermediation_noun	maXyasWawA
international_noun	aMwararARtrIya/anwarrARtrIya
interpretation_noun	nirvacana/vyAKyA/arWanirNaya/prawipAxana
interpreter_noun	xuBARiyA/vyAKyAkAra
interrupter_noun	anwarAyijFa/aMwarAmaka
interruptions_noun	vyavaXAna/viGna/bAXa
interval_noun	aMwara/aMwarAla
intervene_noun	haswakRepa_karanA/bIca_meM_padZanA/xaKala_xenA
intervening_noun	maXyavarwI/anwaHsWa
interview_noun	sAkRAwkAra
intricate_noun	jatila/pecIxA
introduced_noun	puraHsWApiwa
introduction_noun	praswAvanA/paricaya
invalid_noun	aviXimAnya
investigation_noun	CAnabIna/anveRaNa
investment_noun	niveSa/pUMjI_niveSa
invoice_noun	bIjaka
isolator_noun	vilagakArI
iteration_noun	punarAvarwI
jack_noun	jEka
jamming_noun	avaroXa/saMkewa_avaroXana/jAma_karanA
janitor_noun	xaravAna/cOkIxAra/xvArapAla
jeopardise_noun	Kaware_meM_dAlanA/KatAI_meM_dAlanA
jerk_noun	JatakA
joining_noun	jodZanA
journalist_noun	pawrakAra
journey_noun	yAwrA/saPara
juliet_noun	julieta
junior_noun	kaniRTa
justification_noun	nyAyociwa/warkasaMgawa
keen_noun	uwsuka
keep_noun	XaranA/raKanA
keg_noun	CotA_pIpA
kerb_noun	upAMwa/karba
kilo_noun	kilo
kingdom_noun	rAjya
kingfisher_noun	kiMgaPiSara
kink_noun	vikuMca
knob_noun	goYTa
knock_noun	Kata-KatAnA
knot_noun	noYta_(gawi_kA_mApana)
knowledge_noun	jAnakArI
lab_noun	prayogaSAlA
labour_noun	Sramika/majaxUra
lack_noun	kamI
ladder_noun	nisenI/sIDZI/ni(kolana)SreNI/sopAna
laminate_noun	swarikA/patala/Apattana/patalana/swaraNa
land_noun	BUmi/uwAranA
landing_noun	avawaraNa_cOkI/cOkI/sopAna
lavatory_noun	prekRaNAlaya
ldeology_noun	vicAraXArA
leave_noun	CuttI/anumawi/prasWAna
levanter_noun	leventara_(pavana)
level_noun	wala/sawaha/samawala
liability_noun	xeyawA/xeyawAeM/xenaxArI
liaison_noun	samparka
licence_noun	lAisensa/anujFapwi
license_noun	lAiseMsa
licensee_noun	lAisensaXArI/anujFApI
lie-by_noun	paSrvikA
lift_noun	uwWApaka
lima_noun	limA
liquidator_noun	parisamApaka
log_noun	loYga
lounge_noun	viSrAma_kakRa
lubricant_noun	snehaka
lubrication_noun	snehana/wela_xenA
lubricator_noun	snehaka
luminous_noun	xIpwi/praxIpwi/jyowi
lunch_noun	xopahara_kA_Bojana/maXyAhnana_Boja
machinability_noun	maSInana-sukarawA
machine_noun	yaMwra/maSIna
magneto_noun	mEganito
magnifier_noun	AvarXaka
main_noun	muKya
maintenance_noun	anurakRaNa/raKa-raKAva
majority_noun	bahumawa/vayaskawA
manager_noun	prabaMXaka
mandatory_noun	AxeSAwmaka/aXixeSAwmaka
manipulation_noun	yukwi_prayoga
manoeurve_noun	prahaswana/kOSala
manpower_noun	janaSakwi
manufacturer_noun	vinirmAwA
map_noun	mAnaciwra
masking_noun	AvaraNa
matter_noun	mAmalA/viRaya
meals_noun	Bojana
mechanism_noun	waMwra/warIkA
meeting_noun	bETaka/saBA/goRTI/aXiveSana
member-in-charge_noun	praBArI_saxasya
member_noun	saxasya
membership_noun	saxasyawA
memorandat_noun	FApana
memorandumt_noun	FApana
merit_noun	guNa/yogyawA
message_noun	sanxeSa/sUcanA
metallic_noun	XAwuka
meteorograph_noun	mOsama_leKI
mica_noun	aBraka
micrography_noun	sUkRma_ciwraNa/sUkRma_AleKI
mike_noun	mAika
minimizing_noun	nyUnawamIkaraNa/nyUnIkaraNa
ministerial_noun	lipikavargIya/sacivIya
minority_noun	avayaskawA/alpasaMKyaka/alpamawa
minutes_noun	kAryavqwwa
miscellaneous_noun	prakIrNa/viviXa
misconduct_noun	kaxAcAra/apacAra/xurvyavahAra
misrepresentation_noun	anyaWA-kaWana/galawa_ciwraNa
mist_noun	kuhAsA
mitigate_noun	kama_karanA/GatAnA/Samana_karanA
mixer_noun	miSraka
modernization_noun	AXunikIkaraNa
modification_noun	parivarwana/pariSoXana
momento_noun	yAxagAra/niSAnI/smqwi_cihnana/smaraNa
monitoring_noun	praboXana/moYnItariMga
monoplane_noun	eka_paMKI_vimAna
mortagage_noun	rehana
mortar_noun	masAlA
mortgage_noun	baMXaka
motivation_noun	aBipreraNa
mould_noun	sAMcA
moulding_noun	saMcakana/sAMcA_nirmANa
multiengine_noun	maltI_iMjana/bahu-iMjana
multilateral_noun	bahupakRIya
multiplane_noun	bahu_paMKI_vimAna
nacelle_noun	naselle
negotiation_noun	bAwacIwa
neutral_noun	uxAsIna/nyUtrala
nomenclature_noun	nAma-waMwra/nAma_paxXawi
nominee_noun	nAmiwI
non-bailable_noun	ajamAnawIya/gEra-jamAnawI
non-combatant_noun	ayoXI/gEra-ladZAkU
non-compliance_noun	apAlana/ananupAlana/gEra-anupAlana
non-financial_noun	gEra-viwwIya
non-interference_noun	ahaswakRepa
non-judicial_noun	nyAyikewara
non-liability_noun	axeyawA
non-refundable_noun	apriwaxeya
non-saleable_noun	avikreya
non-statutory_noun	asAMviXika/gEra-kAnUnI
non-voted_noun	axawwamawa
normal_noun	sAmAnya/sAXAraNa
not-traceable_noun	pawA_nahIM_laga_rahA_hE/aprApya
notice_noun	sUcanA/jAnakArI
notification_noun	aXisUcanA
notified_noun	aXisUciwa
notional_noun	noSanala/sExXAMwika
notwithstanding_noun	ke_howe_hue_BI/ke_hone_para_BI
novice_noun	nOsiKiyA
nozzle_noun	noYjala/toMtI/wuMda
numbering_noun	saMKyAMkana
numeric_noun	aMkIya
oanidtertional_noun	sarvaxiSAwmaka
oath_noun	SapaWa
obedience_noun	AjFApAlana
obligatory_noun	bAXyakara
observability_noun	prekRaNIyawA
observation_noun	nirIkRaNa/avalokana_tIkA_tippaNI
obsolescence_noun	apracalana
offence_noun	aparAXa
office_noun	kAryAlaya
officer-in-charge_noun	praBArI_aXikArI
oiliness_noun	wEliwA
opaque_noun	apAraxarSI/apArya
operation_noun	pracAlana/paricAlana
opposition_noun	vipakRa/viroXa_karanA/prawivAxa_karanA
oppressed_noun	sawAyA_gayA/prawAdZiwa
option_noun	vikalpa
orders_noun	AxeSa
ordinance_noun	aXyAxeSa
organic_noun	jEva/jEvika
organisation_noun	saMgaTana
oriel_noun	JaroKA
ornamental_noun	sajAvatI/SoBAkArI/alaMkArI
oscar_noun	oYskara
oscillation_noun	xolana
oscillograph_noun	xolana_leKI
osslueion_noun	aXiXAraNa
outflow_noun	barhipravAha
outstanding_noun	bakZAyA
ovation_noun	jaya-jayakAra/aBinanxana/svAgawa
overcharge_noun	aXipraBAra/praBArAXikya
overflow_noun	aXipravAha/uwplAva
overhang_noun	pralamba
overhauling_noun	prawyavasWAna/jIrNoxXAra/ovarahoYla_karanA
overheated_noun	aXiwapwa
overlapping_noun	parwa_caDZAnA
overrunning_noun	awiXAyana
oversee_noun	nigarAnI_raKanA/xeKaBAla
overstability_noun	awisWAyiwva
painstaking_noun	pariSramI/aXyavasAyI/kaTina
pampero_noun	pEmparo
pamphlets_noun	parce
panel_noun	sUcI/pEnala/nAmikA
parachute_noun	pErASUta/CAwA
paradox_noun	viroXABAsa/vidambanA
parameter_noun	mAnaxaMda/AXAra/mAnaka
paramount_noun	parama/sarvocca/sarvopari
pardon_noun	kRamA
parking_noun	pArkana/pArka_karanA/avasWAma
particle_noun	kaNa
passenger_noun	yAwrI
passport_noun	pArapawra/pAsaporta
pathway_noun	paWikA
patronage_noun	saMrakRaNa/sahArA/praSraya/ASraya
paucity_noun	aBAva/kamI/alpawA
pauper_noun	akiMcana/nirXana
pavement_noun	kuttima/paWa
payload_noun	pEloda
payoff_noun	cukawA/BugawAna
pecuniary_noun	Xana-saMbaMXI/ArWika
penalties_noun	SAswiyAM/arWaxaNda
penalty_noun	SAswi/jurmAnA
pending_noun	laMbiwa
performance_noun	kAryakaraNa/niRpAxana
periodicity_noun	niyawa_avaXi_para_howe_rahanA
periphery_noun	parireKA/pariXi
perishable_noun	naSvara
perisphere_noun	parivqwa
perks_noun	anulabXiyAM/parilabXiyAM
permeability_noun	pAragamyawA
permit_noun	paramita
perpoising_noun	SiSukana
perquisite_noun	anulABa
persistent_noun	sawawa
persistently_noun	bAra-bAra/lagAwAra
personnel_noun	kArmika
pertinent_noun	saMgawa/sambaxXa
perusal_noun	avalokana/paDZanA
perverse_noun	anuciwa/vikqwa/BraRta
petition_noun	yAcikA
petitioner_noun	yAcikAkarwA
phonogram_noun	PonogrAma
phrases_noun	paxAvalI
pilers_noun	plAyarsa/plAsa
pilot-in-command_noun	muKya_pAyalata
pilot_noun	vimAna_cAlaka/pAyalata
pipe_noun	pAipa
pitch_noun	pica/aMwarAla
pitting_noun	garwana
pivot_noun	XurAgra/kIlaka/pivata/cala
plaintiff_noun	vAxI
plazometer_noun	xAboccawA_mApI/pIjo_mItara
pletting_noun	aMkana
plugging_noun	dAta_lagAnA/plagana
pointer_noun	saMkewaka/sUcaka
polarised_noun	Xu_raviwa/waraMgiwa
pole_noun	Xu_rava
policies_noun	nIwiyAM
porcelain_noun	cInI_mittI/porsalina
porpoising_noun	SiMSukana
post-dated_noun	uwwara-xinAMkiwa
post_noun	KaMBA/dAka/cOkI
postponement_noun	sWagana
potential_noun	vixyuwa_xAba/saMBAvya/kAryakRama
power_noun	Sakwi
pre-audit_noun	pUrva-leKA_parIkRA
pre-eminent_noun	sarvaSreRTa/sarvowwama/uwkqRta
preamble_noun	praswAvanA/uxxeSikA
precaution_noun	ehawiyAwa/sAvaXAnI/pUrvopAya
precedent_noun	pUrva_uxAharaNa
preclude_noun	roka_xenA/prawivAriwa_karanA
predetermined_noun	pUrvanirXAriwa
predominant_noun	praXAna/prabala/praBAvI/sarvAXika
prefabricated_noun	pUrvaraciwa/pUrvanirmiwa
preface_noun	AmuKa
preferred_noun	aXimAnI
preflight_noun	udZAna_pUrva
preheater_noun	pUrvawApaka
prejudice_noun	prawikUla_praBAva/pUrvAgraha/pUrvaXAraNA
prejudicial_noun	prawikUla/hAnikara
prerequisite_noun	pUrvApekRA/pUrvApekRiwa
prerogative_noun	paramAXikAra/viSeRAXikAra
presentation_noun	praswuwIkaraNa/praswuwi
preside_noun	saBApawiwva/aXyakRawA_karanA
presiding_noun	pITAsIna
pressed_noun	Agraha/anugraha
pressurization_noun	xabAva
presupposed_noun	pUrvakalpiwa
primer_noun	prAraMBaka
principle_noun	sixXAMwa/mUla
priority_noun	agrawA/prAWamikawA
privilege_noun	viSeRAXikAra
pro-rata_noun	AnupAwawaH/AnupAwika/yaWAnupAwa
probation_noun	parivIkRA
problem_noun	samasyA
procedure_noun	prakriyA/kriyAviXi
proceedings_noun	kAryavAhI/pragawi/pragamana/kAryavivaraNa
proceeds_noun	Agama/prApwi/lABa
proclamation_noun	GoRaNA/ux_GoRaNA
procurement_noun	prApaNa
proficiency_noun	pravINawA/nipuNawA
profile_noun	proPAila/
profiteering_noun	munAPAKorI/lABa-arjana
prohibited_noun	niRixXa
promotion_noun	paxonnawi
promulgate_noun	praKyApiwa_karanA/GoRiwa_karanA/jArI_karanA
promulgation_noun	praKyApana/pravarwana
proofing_noun	pramANana
propagate_noun	pracAra_karanA
propeller_noun	propelara
proposal_noun	praswAva/prasWApanA/viRaya
proscribe_noun	aBiniRixXa_karanA/prawibaMXiwa_karanA
protagonist_noun	samarWaka
protocol_noun	nayAcAra/protokoYla
prototype_noun	Axi
provided_noun	baSarwe/yaha_ki
provision_noun	prabaMXa/vyavasWA/prAvaXAna
proviso_noun	paraMwuka/Sarwa/upabaMXa
psychrometer_noun	sAkromItara/sAikromApI
publication_noun	prakASana
publicity_noun	pracAra
punishment_noun	xaMda
punture_noun	veXana/paMkcara
purview_noun	kRewra/sImA
quadruplicate_noun	cOharA/cAra_prawiyAM
quandary_noun	xuviXA/ulaJana/asamaMjasa
quantitative_noun	parimANAwmaka/mAwrAwmaka
quantum_noun	mAwrA
quarantine_noun	saMgaroXa
quartz_noun	sPatika/kvArtaja
quash_noun	aBiKaMdiwa_karanA
quasi-judicial_noun	arxXa-nyAyika
quebec_noun	kyUbEka
questionnaire_noun	praSnAvalI
quinquennial_noun	paMcavArRika/paMcavArRikI
quittance_noun	unmocana/CutakArA/BarapAI/rasIxa
quorum_noun	korama/gaNapUrwi
quotation_noun	sUcI/koteSana
radar_noun	rAdAra
radiation_noun	vikiraNa
radiator_noun	rediyetara/vikiraka
radiotelephony_noun	rediyo_teliPona_waMwra
raid_noun	CApA
ramp_noun	rEmpa
random_noun	sAMyogika/aniyamiwa
range_noun	sImA
rank_noun	ohaxA
ranking_noun	krama_vinyAsa
rates_noun	xareM
ratification_noun	sawyApana/aBipuRti/anusamarWana
rating_noun	nirXAraNa
ratio_noun	anupAwa
rational_noun	vivekapUrNa
rationale_noun	warkAXAra/mUlAXAra
rationalization_noun	ya_iu_kwakaraNa/Ociwya_sWApana/sa_v_u_yavasWIkaraNa
re-constitute_noun	punargaTana_karanA
re-evaporation_noun	punarvARpana
re-install_noun	punaH_sWApiwa_karanA/punaH_niyukwa_karanA
reachability_noun	upagamyawA
reactance_noun	prawiGAwa
reaeration_noun	punaHvAwana
recall_noun	punarAhAvAna
receiver_noun	aBigrAhI
receptacle_noun	aBigrAhI_pAwra
recirculation_noun	punaH_saMcAraNa
reckond_noun	samaJanA/ginanA/BarosA_raKanA
recognition_noun	anujFAna/mAnyawA
recommendation_noun	siPAriSa/anuSaMsA/saMswuwi
reconditioning_noun	prawyavasWApana
reconfirmation_noun	punaH_puRtikaraNa
reconsideration_noun	punarvicAra
record_noun	rikArda
recruitment_noun	BarwI
recurrence_noun	punarAvqwwi/Avqwwi
recursion_noun	prawivarwana
redeployment_noun	punaH_wEnAwI
redundant_noun	anAvaSyaka
refer_noun	vicArArWa_Baja_e_nA/havAlA_xana_e_A/ullaK_e_A_karanA
reference_noun	saMxarBa
references_noun	ulleKa
referendum_noun	janamawa_saMgraha
refinance_noun	punarviwwapUrwi
refractrometer_noun	uccawApa_sahamApI
refreshments_noun	jalapAna
refund_noun	XanavApasI
refute_noun	KaMdana_karanA/asvIkAra_karanA
regional_noun	kRewrIya
regulation_noun	niyaMwraNa/vyavasWApana/viniyama
regulatory_noun	viniyAmaka
reimburse_noun	prawipUrwi/prawipUrwi_karanA
reimbursement_noun	prawipUrwi/vApasI
reinstatement_noun	bahAlI/purnasWApanA
reiterate_noun	xoharAnA/punarAvqwwi_karanA
relaxation_noun	CUta/riyAyawa
relay_noun	rile
remuneration_noun	parilabXi
renewal_noun	navIyana/navIkaraNa
repaid_noun	axAyagI/lOtAnA/pana_u:_axAyagI/pana_u_Barga_u_wAna
repair_noun	marammawa
replacement_noun	prawisWApana
reports_noun	riporta/prawivexana
representation_noun	aByAvexana
representative_noun	prawiniXi
repudiation_noun	nirAkaraNa
repugnant_noun	prawikUla/viruxXa
requisition_noun	mAMga
rescind_noun	viKaMdana_karanA
reservation_noun	ArakRaNa
reserves_noun	BaMdAra/ArakRiwa
residence_noun	nivAsa
residuary_noun	avaSiRta
resignation_noun	wyAga_pZawra
resistance_noun	prawiroXa
resistor_noun	prawiroXaka
resolution_noun	saMkalpa
response_noun	anukriyA/uwwara/prawikriyA
restriction_noun	prawibaMXa/pAbaMxI/roka
result_noun	pariNAma
resultant_noun	pariNAmI
resume_noun	sArakqwa/punaH_kArya_AraMBa_karanA
retention_noun	XAraNa
retirement_noun	sevAnivqwwi
return_noun	prawiPala/prawilABa/vivaraNI
revaluation_noun	punarmUlyana/punarmUlyAMkana
revamped_noun	suXAranA
revert_noun	prawivarwiwa_honA
revised_noun	saMSoXiwa/pariSoXiwa
revoke_noun	prawi-saMharaNa_karanA/vApasa_lenA
rider_noun	Sarwa/nibaMXana
rigorous_noun	kaTora
rivet_noun	ripata/kIla/KUMtA
romeo_noun	romio
ropeway_noun	rajjupaWa
rotorcraft_noun	rotarakrAPta
rti_noun	sUcanA_kA_aXikAra
ruling_noun	vinirNaya
run-up_noun	rana-apa
running_noun	iMjanaGara
runway_noun	XAvanapaWa/ranave
sanction_noun	maMjUrI/svIkqwi
sanctity_noun	paviwrawA/SuxXawA
sanitation_noun	svacCawA_prabaMXa
schedule_noun	samayAvalI/anusUcI
scholarship_noun	CAwravqwwi
scraping_noun	KuracanA
screen_noun	Cawwaka/jAlI/avawaraNa
screeners_noun	skrInarsa
screening_noun	CAnabIna
scruper_noun	KuracanI
secretariat_noun	sacivAlaya
secretary_noun	saciva
section_noun	KaMda/anuBAga/XArA
sector_noun	sektara/kRewra
securities_noun	prawiBUwiyAM
security_noun	prawiBUwi/surakRA
segregated_noun	pqWakkqwa
segregation_noun	viyojana/pqWakkaraNa
selection_noun	cayana
semi-automatic_noun	arxXa-svacAilawa
seminar_noun	saMgoRTI
seniority_noun	variRTawA
service_noun	sevA
sewerage_noun	mala-jala_vyavasWA
shower_noun	bOCAra/PuhArA
sierra_noun	sierA
simoon_noun	simUna
simulator_noun	simuletara/anukaraNa_yaMwra
skin_noun	AvaraNa
slacks_noun	DIle_sWAna
smoking_noun	XUmrapAna
snacks_noun	alpAhAra
solicit_noun	nivexana_karanA/yAcanA
solidity_noun	Tosapana
span_noun	spEna/viswqwi
spares_noun	awirikwa_hisse/purje
speaker_noun	aXyakRa/vakwA
specialization_noun	viSeRIkaraNa
specified_noun	vinirxiRta
specimen_noun	namUnA/prawixarSa
sphere_noun	vilagiwa_golA
spin_noun	cakraNa
spiral_noun	sarpila
squall_noun	JaMJAvAwa
square_noun	varga
stability_noun	sWAyiwva
stabilizer_noun	sWiraka
staff_noun	karmacArI_varga/stAPa
stagnation_noun	gawiroXa/sampqkwA
stair_noun	sIDZI/sopAna
stakeholder_noun	paNaXArI/stekaXAraka
stall_noun	stAla
standard_noun	mAnaka
standardization_noun	mAnakIkaraNa
statement_noun	vakwavya/vivaraNa
station_noun	steSana
stationery_noun	leKana_sAmagrI
statoscope_noun	sUkRma_vAyu_xAbamApI
status_noun	hEsiyawa
statute_noun	saMviXi
statutory_noun	sAMviXika
sterile_noun	rogANu_rahiwa
stick_noun	stika/yoka
stimulation_noun	uxxIpana
stipend_noun	vqwwikA/vajIPA
stopway_noun	virAma_kRewra
strata_noun	swara
stratosphere_noun	samawApa_maMdala
streamline_noun	XArAreKiwa/suvAhya
sub-clause_noun	upa-KaMda
sub-committee_noun	upa-samiwi
sub-heading_noun	upaSIrRa
subjudice_noun	nyAyAXIna
submission_noun	praswuwa_karanA/nivexana/praswuwi
subscription_noun	aBixAna/Sulka/aMSaxAna
subsidence_noun	avawalana
substantial_noun	sArapUrNa
substantiate_noun	siXxa_karanA
subvert_noun	XvaMsa_karanA
suggestion_noun	suJAva
supercharger_noun	aXiBaraka/aXiBariwra
suppress_noun	xamana_karanA/xabAnA/CipAnA
suppression_noun	aXikramaNa
suppressor_noun	niroXI
surcharge_noun	aXiBAra
surface_noun	sawaha
surplus_noun	aXiSeRa/AXikya
sustained_noun	sawawa
swell_noun	mahAwaraMga/sPIwi
symmetrical_noun	samamiwa
table_noun	sAraNI
tachometer_noun	GUrNana_cAlamApI
tail_noun	pucCa
tailwind_noun	anuvAwa/anukUla_havA
take-off_noun	udZAna_BaranA
tango_noun	tEMgo
tariff_noun	praSulka
taxation_noun	karAXAna
taxi_noun	tEksI/havAI_jahAja_ko_jamIna_para_calAnA_(kriyA)
taxing_noun	tEksIyana
taxiway_noun	tEksIpaWa/tEksIve
technical_noun	wakanIkI
temperature_noun	wApamAna
temporary_noun	asWAyI
tendency_noun	pravqwwi
terminal_noun	tarminala
termination_noun	sevA_samApwi
thermodynamics_noun	URmAgawikI
thermograph_noun	wApaleKI
thermometer_noun	wApamApI
threshold_noun	xehalI/xvAra_sImA/praBAva_sImA
throttle_noun	Wrotala
thrust_noun	bala/Wrasta
toilet_noun	prasAXana_kakRa
token_noun	sAMkewika
topography_noun	sWalAkqwi
touchdown_noun	avawaraNa
track_noun	paWa/patarI
tracking_noun	anureKaNa
traction_noun	karRaNa/KiMcAva
trajectory_noun	praxoRa_paWa
transaction_noun	sOxA/lena-xena/kArobAra_kA_saMcAlana
transcribe_noun	nakala_wEyAra_karanA/anulipi_karAnA/prawileKana_karanA
transcription_noun	prawileKana/anuleKana/lipyaMwaraNa
transit_noun	aBivahana/mArgasWa
translation_noun	anuvAxa
translator_noun	anuvAxaka
transliteration_noun	lipyaMwaraNa
transmissibility_noun	pAragamana_kRamawA
transmission_noun	saMcAraNa
transonic_noun	pAraXvanika
transparency_noun	pAraxarSiwA
transponder_noun	trAMspoMdara
transposition_noun	ulatanA
transverse_noun	anuprasWa
traveller_noun	yAwrI
treachery_noun	viSvAsaGAwa/xroha
treason_noun	rAjaxroha
trim_noun	trima
tripartite_noun	wripakRIya
triplane_noun	wripaMKI
tripper_noun	vimocaka
trustworthy_noun	viSvasanIya
turbulence_noun	vikRoBa
turn_noun	modZa
ubiquitous_noun	sarvavyApI/sarvavyApaka
ultimatum_noun	anwima_cewAvanI
ultramodern_noun	awyAXunika
ultrasonic_noun	parASravya
unacceptable_noun	asvIkArya
unaccounted_noun	behisAba/binA_hisAba_ke
unacquainted_noun	apariciwa
unanimity_noun	ekamawa/sarvasammawi
unanimously_noun	ekamawa_hokara/sarvasammawi_se
unavoidable_noun	aparihArya
uncorroborated_noun	asaMpuRta
undecidability_noun	anirNeyawA
underestimate_noun	ava-Akalana/kama_anumAna
underrate_noun	kama_samaJanA/kama_mahawva_xenA
underspeeding_noun	avacAlana
undertaking_noun	upakrama
undignified_noun	garimArahiwa
uneven_noun	asama/viRama
unidirectional_noun	eka_xiSIya
uniform_noun	eka_samAna/yUniPoYrma/varxI
unloaded_noun	aBAriwa
unloading_noun	nikAsI/aBAraNa/aBaraNa
unmanned_noun	karmacArI_rahiwa
unnecessary_noun	anAvaSyaka
unobservable_noun	aprekRaNIya
unparliamentary_noun	asaMsaxIya/aSiRta
unscrupulous_noun	avivekI/avicArI
unserviceable_noun	sevA_ayogya
unskilled_noun	akuSala/kOSala_rahiwa
untenable_noun	amAnya/asamarWanIya
upgradation_noun	unnayana/swaronnayana
upwind_noun	vAwonmuKa
useful_noun	upayogI
utilization_noun	upayogiwA
vacancy_noun	rikwi/KAlI_paxa/KAlI_sWAna/rikwa_sWAna
vacate_noun	KAlI_karanA
vacation_noun	avakASa/CuttI
vacuum_noun	nirvAwa
vacuumizing_noun	nirvAwakaraNa
vague_noun	aspaRta/aniSciwa
validity_noun	vEXawA/mAnyawA
valuation_noun	mUlya_nirXAraNa
valve_noun	vAlva
vapourizer_noun	vARpaka
variety_noun	kisma
vector_noun	vektara
veering_noun	xik_GUrNana
vegetarian_noun	SAkAhArI/nirAmiRa
velocity_noun	vega
vendavales_noun	veMdAvela
verbatim_noun	SabxaSaH
vested_noun	nihiwa
vexatious_noun	waMga_karane_vAlA/jatila/muSkila
viable_noun	vyavahArya
vibration_noun	kaMpana
vibrator_noun	kampaka
victimisation_noun	xaNdana
victor_noun	viktara
vide_noun	ke_anusAra/xvArA
vigorous_noun	joraxAra/prabala/ojasvI
vindictive_noun	prawiSoXI
violation_noun	ullaMGana
virtue_noun	suRNa
visibility_noun	xqSyawA
void_noun	SUnya
volume_noun	mAwrA
vulnerability_noun	suBexyawA
wage_noun	majaxUrI
wait_noun	prawIkRA
waiver_noun	aXiwyAga
wake_noun	anuwaraMga_rikwi
wavelength_noun	waraMgaxErGya
waypoint_noun	vepoYiMta
weather_noun	mOsama
weathered_noun	apakRINa/qwu-hala
website_noun	vebasAIta
weight_noun	BAra
westing_noun	paScima_nirxeSAMka
whiskey_noun	vhiskI
width_noun	cOdZAI
winch_noun	viMca/carKI
wind_noun	vAyu/pavana/vAwa
wing_noun	paMKa
wings_noun	vimAna_paMKa
wire_noun	wAra
wireless_noun	bewAra
workman_noun	majaxUra/Sramika/karmI
wrench_noun	riMca
x-ray_noun	eksa-kiraNa/eksa-re
yankee_noun	yaMkI
yardstick_noun	mAnaxaMda
yawing_noun	UrXvAkRa_gawi
yield_noun	pExAvAra/upaja
zone_noun	kRewra/maMdala
zulu_noun	jZulu
