#computer dictionary extracted by Monika Sharma. Formatted by Roja (12-03-2016)
#Changes:: 1) Separated single word and multi words into separate dictionaries
#	   2) English words are converted to lower case
#	   3) Added category as 'noun' by default
#################################################################################
abacus_noun	ginawArA
abort_noun	viPalana
abstract_noun	sArAMSa/amUrwwa
access_noun	aBigama
activation_noun	sakriyaNa
addend_noun	yojya
adder_noun	yojaka
address_noun	pawA
addressing_noun	pawABigamana
algol_noun	elgAla
algorithm_noun	kalana_viXi
alignment_noun	sareKana
allocate_noun	niyawana
analog_noun	anurUpa
and_noun	waWA
architecture_noun	vAswukalA/sWApawya_kalA
archiving_noun	purABaMdAraNa
arguement_noun	svawaMwra_cara
array_noun	saraNI
ascii_noun	AskI
aspect_noun	aBimuKawA
assembler_noun	kodAMwaraka
assembly_noun	kodAMwaraNa
asynchronous_noun	awulyakAlika/awulyakAlI
attenuation_noun	kRINana
attenuator_noun	kRINakArI
attribute_noun	guNa
augened_noun	yojaka
author_noun	saMleKaka
automata_noun	svacala_prarUpa
automation_noun	svacAlana
automatisation_noun	svacAlanIkaraNa
autoplotter_noun	svawa:_AleKiwra
avaibility_noun	prApyawA
b-tree_noun	bI-warU
background_noun	pqRTaBUmi
backgrounding_noun	pqRTaBUmi_saMsAXana
base_noun	AXAra
batch_noun	pracaya
batching_noun	pracayana
baud_noun	bAda
begin_noun	prAraMBana
bibliography_noun	graMWa_sUci
binary_noun	xviAXArI
bipolar_noun	xviXuvI
bistable_noun	xvisWiwika
bisynchronous_noun	xvi_wulyakAlIka
bit_noun	xvayaMka
blinking_noun	timatimAnA
block_noun	KaMdaka
book_noun	pqRTiwa_smqwi
borrow_noun	paScAMka
bouncing_noun	ucCalana
bound_noun	paribaMXa
boundary_noun	parisImA
branch_noun	SAKA
branching_noun	SAKana
break_noun	vicCexa
bridgeware_noun	sewu_sAmagrI
bridging_noun	sewu_baMXana
broadband_noun	viswqwa_bEMda
buffer_noun	cayaka
buffering_noun	cayakana
bug_noun	xoRa
bus_noun	basa
byte_noun	bAita
cache_noun	kESe/xruwikA
calculation_noun	parikalana
calculator_noun	parikaliwra
call_noun	AhavAna
calling_noun	AhavAna
cancel_noun	nirasana
capacity_noun	kRamawA
captured_noun	pragrahaNa
card_noun	pawraka
carry_noun	haswaMgawa_hAsila
cartridge-disk_noun	AgutikA_cakrikA
catalogue_noun	kramAxeSa_sUci
cell_noun	koRtikA
chain_noun	SrqMKalA
chaining_noun	SrqMKalana
channel_noun	praNAla
chip_noun	cipa/patalikA
cipher_noun	bIjaleKa
circuit_noun	paripaWa
citation_noun	ulleKa
class_noun	varga
classification_noun	vargIkaraNa
clear_noun	mArjana
clipping_noun	karwana
clockings_noun	samAyojana
cluster_noun	gucCa
co-resident_noun	sahanivAsI
co-routine_noun	sahanemakA
cobol_noun	kobola
codasyl_noun	kodAsila
code_noun	kUta
coder_noun	kodiwra
collision_noun	saMGatata
column_noun	swaMBa
combination_noun	saMcaya
command_noun	samAxeSa
comment_noun	tippaNI
communication_noun	saMcAra
compandor_noun	saMpIdana_prasAriwra
compatibility_noun	susaMgawi/saMgawawA
compiler_noun	anuBARaka
compilition_noun	anuBARaNa
complement_noun	pUraka
component_noun	Gataka
compress_noun	saMpIdana
computability_noun	aBikalanIyawA
computation_noun	aBikalana
computer_noun	kampyUtara/aBikaliwra
computerization_noun	aBikaliwrIkaraNa
concatenate_noun	saMSrqMKalana
concatenation_noun	saMSrqMKalana
concentrator_noun	saMkenxriwra
concurrent_noun	saMgAmI
conditioning_noun	prawibaMXana/prAnukUlana
configuration_noun	vinyAsa
congestion_noun	saMkulana
connection_noun	saMbaMXana
connector_noun	saMbaMXaka
console_noun	kaMsola
contention_noun	prayoga_prawisparXA
context_noun	saMxarBa
conversation_noun	saMvAxa
conversion_noun	rUpAMwaraNa
converter_noun	parivarwaka
copy_noun	prawilipi
core_noun	kroda
correction_noun	saMSoXana
count_noun	ginawI/gaNanA/gaNanAMka
counter_noun	gaNiwra
crowding_noun	aXisaMKyana
cryptographic_noun	gUDAleKI
cursor_noun	prasaMkewaka
cushion_noun	walpa
cycle_noun	cakra
damping_noun	avamaMxana
data_noun	AMkade
database_noun	AMkadA_saMcaya
datagram_noun	AMkadAreKa
deadlock_noun	Akasmika_roXana
deadzone_noun	akriya_kRewra
debug_noun	xoRamArjana
debugger_noun	xoRamArjaka
decade_noun	xaSaka
decible_noun	desIbela
decision_noun	nirNaya
decoder_noun	vikodaka/kUtavAcaka
decrement_noun	apakRaya/hrAsa
default_noun	vyawikrama/cUka
degeneracy_noun	apaBraRtawA
delay_noun	vilamba
delimiter_noun	parisImaka
deque_noun	vipaMkwiyana
design_noun	aBikalpanA
despatch_noun	preRaNa
destination_noun	gaMwabya
device_noun	yukwi
diagnosis_noun	nixAna
dial_noun	dAyala
dialog_noun	saMvAxa
dichotomy_noun	xviBAjana
digitization_noun	aMkarUpaNa
digitizer_noun	aMkarUpaka
dimension_noun	vimA
directive_noun	nirxeSa
directory_noun	nirxeSikA
disassembler_noun	vikoMdAwaraka
discretization_noun	asaMwawakaraNa
diskette_noun	namyikA
dispatch_noun	preRaNa
distortion_noun	virUpaNa
divisor_noun	BAjaka
document_noun	praleKa
dragging_noun	karRaNa
drift_noun	apavAha
duality_noun	xvEwI
dump_noun	sannikRepa
duplexing_noun	xvEXIkaraNa
element_noun	avayava
emulation_noun	yaMwrAnukaraNa
encipher_noun	kUtaleKana
encode_noun	kodana/kUtaleKana
encoder_noun	kodiwra/kUtaleKiwra
enter_noun	praveSa
environment_noun	pariveSa
eprom_noun	eprAma
equilizer_noun	wulyakAraka
equipment_noun	upakaraNa
erase_noun	vyAmArjana
exclusion_noun	apavarjana
execute_noun	niRpAxana
extension_noun	viswAra
extract_noun	niRkarRa
extraction_noun	niRkarRaNa
facsmile_noun	prawikqwi
fan-in_noun	niveSAMka
fetch_noun	Anayana
firmwire_noun	prakriyA_yaMwra_sAmagrI
flag_noun	pawAkA/cihnaka
flowchart_noun	pravAha_saMciwra
folding_noun	valana
font_noun	PANta
fork_noun	xviSAKa
format_noun	saMrUpa/PAramEta
fortran_noun	PortrAna
frame_noun	Prema/swaMBa
framing_noun	Premana/swaMBa_sarjana
frequency_noun	Avqwwi/bAraMbArawA
function_noun	kalana/prakArya
garbage_noun	kacarA
gate_noun	xvAra
grammer_noun	vyAkaraNa
gulp_noun	bAita_samUha
half-adder_noun	arxXayojaka
half-subtractor_noun	arxXa-vyavakalaka
half-word_noun	arxXa-Sabxa
hardware_noun	yaMwra_sAmagrI
hash_noun	xruwAnveRaNa
hashing_noun	xruwAnveRaNa
header_noun	praveSikA
hetrogeneous_noun	viRmAMgI_bahusaMkewana
hexadecimal_noun	RodaSa_AXArI
hit_noun	lakRya_veXa/prahAra/kRoBaja
host_noun	AwiWeya
identifier_noun	aBijFApaka
identity_noun	aBijFApana
ignore_noun	upekRA_anuxeSa
image_noun	prawibimba
inclusion_noun	aMwarveSa/aMwarveSana
increment_noun	vqxXi
indegree_noun	aMwa:koti
indent_noun	aBisWApana
informatics_noun	sUcanA_vijFAna/sUcanikI
initialization_noun	prAraMBikIkaraNa
inscribe_noun	cirAMkana
insert_noun	niveSana
instruction_noun	anuxeSa
interaction_noun	anyonya_kriyA
interface_noun	aMwarApqRTa
interleave_noun	aMwa:pawraNa
interpreter_noun	nirvacaka
invoke_noun	uwkriya_karanA
irrelevance_noun	asaMgawi
iteration_noun	punarAvqwwi
join_noun	sammilana
journal_noun	yaWArUpa
jumper_noun	JaMpaka
junk_noun	kabAda
justification_noun	Ociwya
kilobaud_noun	kilovAda
kilobyte_noun	kilobAita
kilomega_noun	kilomegA
label_noun	lebala
labelling_noun	lebanala
latch_noun	sitakanI
latencytime_)_noun	prasukwi_kAla
letter_noun	akRara
level_noun	swara
lexicon_noun	SabxakoRa
library_noun	kramAxeSa_saMgraha
linearity_noun	rEKikawA
linker_noun	SrqMKalana
literal_noun	AkRara
load_noun	BAra/loda
loader_noun	BAraka
loading_noun	BAraNa
locate_noun	sWAna_nirXAraNa
lock_noun	wAlakana
logging_noun	pracAleKana
look-up-table_noun	avalokaNa_sAraNI
loop_noun	pASa
looping_noun	pASana
machine_noun	yaMwra
macrogenerator_noun	sWUla_janiwra
macroinstruction_noun	sWUla_anuxeSa
macrolibrary_noun	sWUla_kramAxeSa_saMgraha
macroprogramming_noun	sWUla_kramAxeSana
macrosystem_noun	sWUla_waMwra
management_noun	prabaMXa
manifolding_noun	bahu_prawilipIyana
mark_noun	cihna
marker_noun	cihnaka
marking_noun	cihna
mask_noun	AcCaxa
massaging_noun	parimArjana/saMxeSa_preRaNa
master_noun	praXAna
megabyte_noun	megAbAita
megacycle_noun	megA_sAyakila
menu_noun	prasUci
microcobol_noun	mAikrokobola
microcomputer_noun	sUkRma_aBikaliwra
microcontroller_noun	sUkRma_niyaMwraka
microcycle_noun	sUkRma_cakra
microfiche_noun	sUkRmikA
microfilm_noun	mAikroPilma
microfloppy_noun	sUkRma_namyikA
micrographics_noun	sUkRmAleKikI
microimage_noun	sUkRma_prawibimba
micromainframe_noun	sUkRma_aXisaMsAXiwra/sUkRma_vqhawa_aBikaliwra
microphotography_noun	sUkRma_PotogrAPI
microprocessor_noun	sUkRma_saMsAXiwra
microprogram_noun	sUkRma_kramAxeSa/sUkRmAxeSa
middleware_noun	maXyama_sAmagrI
midicomputer_noun	maXyama_aBikaliwra
minicomputer_noun	laGu_aBikaliwra
mips_noun	mipsa
mistake_noun	BUla
mnemonic_noun	smaraka
modifier_noun	Aparivarwaka
modula_noun	mAdulA
monostable_noun	ekasWiwika
morphism_noun	AkAriwA
motherboard_noun	uxagama_patala
multibus_noun	bahubasa
multiplexer_noun	bahusaMkewaka
multiplexing_noun	bahusaMkewana
multiprocessor_noun	bahu_saMsAXiwra
multiprogramming_noun	bahu_kramAxeSana
multithreading_noun	bahusUwraNa
nand_noun	waWApUraka
nibble_noun	cawu:_xvayaMka/nibala
non-compact_noun	asaMhawa
normalize_noun	prasAmAnyIkaraNa
not-and_noun	waWApUraka
not-or_noun	aWavA_pUraka
nybble_noun	cawu:xvayaMka_nibala
off-line_noun	lAinewara
offset_noun	APaseta
on-line_noun	yugapawa/lAina_ArUDa
one-output_noun	eka_nirgama
operand_noun	saMkArya
operator_noun	pracAlaka/saMkAraka
optimization_noun	iRtamIkaraNa
option_noun	vikalpa
or_noun	aWavA
overflow_noun	aXipravAha
pack_noun	saMkula/gaddI
package_noun	pEkaga/saMkula
packet_noun	pEkata
page_noun	pqRTa
paging_noun	pqRTana
panel_noun	pattikA
paragraph_noun	pErAgrAPa
parse_noun	pata_vyAKyA
parser_noun	paxa_vyAKyAyiwra
parsing_noun	paxa_paricaya
partitioning_noun	viBAjana
password_noun	pAraNa_Sabxa
pel_noun	ciwra_avayava
percolation_noun	uwpAraNa
perforator_noun	aviCixiwra
peripheral_noun	upAMwIya/upasAXana/sahAyaka_yaMwra
pipelining_noun	saMpaMkwiyana
pitch_noun	saMprawIka_aMwarAla
pixel_noun	ciwra_avayava
plotter_noun	AleKiwra
polymorphic_noun	bahurUpI
positioning_noun	sWiwi_nirXAraNa
postmortem_noun	uparAMwa_viSleRaNa
precision_noun	pariSuxXawA/pariSuxXi
predicate_noun	nirXAraka/viXeya
preprocessor_noun	pUrva_saMsAXiwra
privacy_noun	gopanIyawA
processing_noun	saMsAXana
processor_noun	saMsAXiwra
programmer_noun	kramAxeSaka
programming_noun	kramAxeSana
prompt_noun	AhavAna
protocol_noun	saMxeSAcAra
push_noun	saMBara
quad_noun	cawu:
quadruple_noun	cawuRka
qualifier_noun	viSeRaka
quantification_noun	pramAwrIkaraNa
quartet_noun	cawuR_taya
query_noun	pqcCA
queue_noun	paMkwi
queuing_noun	paMkwIyana
quiescent_noun	niRpaMxa
radix_noun	mUlAMka
range_noun	parisara
raster_noun	rEstara/reKApuMja
reachability_noun	gamyawA
read_noun	paTana
reader_noun	paTiwra
reconfiguration_noun	punapunarvinyAsa
reconstitution_noun	racanA/punargaTana
reconstruction_noun	punargaTana/punarracanA
recurrence_noun	punarAvqwwi
recursion_noun	punarAvarwana
redundancy_noun	awirikwawA
reenlargement_noun	punarvarxXana
reference_noun	nirxeSa/saMxarBa
reflectance_noun	parAvarwakawA
refresh_noun	punaScaryA/punarjanana
regeneration_noun	punarjanama/punaryojana
register_noun	paMjI
reliability_noun	viSvasanIyawA_suxUra
retry_noun	puna:_prayAsa
return_noun	prawigamana
routine_noun	nemakA
routing_noun	anumArgana
sampling_noun	prawixarSI/prawicayana
saturation_noun	saMwqpwi/saMwqpwikaraNa
scalar_noun	axiSa
scaling_noun	sopAnana
scan_noun	kramavIkRaNa
scanner_noun	kramavIkRaka
schema_noun	vivaraNikA
scratch_noun	liKamita
screen_noun	prapatta
scroll_noun	pariluMTana
searching_noun	KojakriyA
security_noun	surakRA
sense_noun	saMvexa/BAva
sensor_noun	saMvexiwra
sentinel=flag_)_noun	pawAkA
sequence_noun	anukrama
sequencing_noun	anukramaNa
server_noun	parisevaka
shading_noun	CAyAMkaNa
shannon_noun	Senana
sharing_noun	sahaBAjana
sheet_noun	parNa
sibling_noun	sahoxara
signal_noun	saMkewa
simulator_noun	anukArI
skip_noun	pluwi
skipping_noun	pluwi
slice_noun	kawalI
slicing_noun	kawalIpana
slot_noun	KAMcA
smoothing_noun	samakaraNa
snobol_noun	snobola
socket_noun	sAketa
software_noun	prakriyA_sAmagrI
sorter_noun	SAtiwra
sorting_noun	SAtana
space_noun	rikwi/samiRta/nimagra/AkASa
spool_noun	spUla
spooler_noun	spUlaka
spooling_noun	spUlana
standardization_noun	mAnakIkaraNa
starvation_noun	aprApwi
stator_noun	sWirAMga
storage_noun	BaMdAraNa
string_noun	rajju_mAlA
structure_noun	saMracanA
stub_noun	sWUna
stylus_noun	SUka
subschema_noun	upavivaraNikA
subscript_noun	pAxAkRara/pAxAMka
substring_noun	uparajju
subsystem_noun	upawaMwra
subtracter_noun	vyavakaliwra
subtree_noun	upawarU
swap_noun	gamAgama
switch_noun	svica
switching_noun	svicana
symbol_noun	prawIka
synchronization_noun	wulyakAlana
synchronous_noun	wulyakAlika
synergic_noun	samanxiwa
syntax_noun	vAkya_racanA
telenet_noun	xUra_jAla
teleprinter_noun	xUra_muxriwra
teletext_noun	xUra_pATqyAMSa
terminal_noun	aMwaka
testing_noun	parIkRaNa
track_noun	paWa
translation_noun	anuvAxa
transmitter_noun	preRiwra
transponder_noun	pArAnukAriwra
transverse_noun	mAlA_reKA
trap_noun	prapASa
trend_noun	upanawi
trigger_noun	trigara
triplet_noun	wrika
truncate_noun	Cinna
truncation_noun	Cinna
trunk_noun	traMka
tymnet_noun	timaneta
type_noun	prakAra
validation_noun	mAnyakaraNa
write_noun	leKana
