#electrical dictionary extracted by Monika Sharma. Formatted by Roja (26-01-2016)
#Changes:: 1) Separated single word and multi words into separate dictionaries
#          2) English words are converted to lower case
#          3) Added category as 'noun' by default
#################################################################################
abatement_noun	kamI/upaSamana
abetment_noun	xuRpreraNa
ablation_noun	apakRaraNa
abolition_noun	unmUlana
abrasive_noun	apaGarRI/apaGarRaka
abrupt_noun	apacCinna/Akasmika
absence_noun	anupasWiwi/gErahAjirI
absent_noun	anupasWiwa/gErahAjira
absolute_noun	nirapekRa/parama/pUrNa/carama/pariSuxXa
absorb_noun	avaSoRaNa/samAviRta
absorber_noun	avaSoRaka
absorption_noun	avaSoRaNa/samAveSana
abstract_noun	sAra
abutment_noun	aMwyAXAra/pIlapAyA
abutting_noun	prawisparSI/takkara
accelerate_noun	wvariwa_karanA
acceleration_noun	wvaraNa
accelerator_noun	wvaraka
accelerogram_noun	esilogrAma/wvaraNAreKa
accelerograph_noun	esilogrAPa/wvaraNAleKa
accelerometer_noun	wvaraNamApI
acceptable_noun	svIkArya
acceptance_noun	svIkqwi/maMjUrI
access_noun	pahuMca/aBigama
accession_noun	parigrahaNa
accessory_noun	upasAXana/sahAyaka_upakaraNa
accidental_noun	Akasmika/aprawyASiwa
accord_noun	samaJOwA/praxAna_karanA
accordance_noun	anurUpawA/saMgawi
accordingly_noun	waxanusAra/waxanurUpa
account_noun	leKA/KAwA
accountability_noun	javAbaxehI
accountable_noun	uwwaraxAyI/javAbaxeha
accrue_noun	proxBUwa/upaciwa
accumulate_noun	saMciwa
accuracy_noun	pariSuxXawA/yaWArWawA
accurate_noun	pariSuxXa
acetone_noun	EsItona
acetylene_noun	EsItilIna
acid_noun	wejAba/amla
acquire_noun	upArjana
acquisition_noun	aXigrahaNa
acre_noun	ekadZa
act_noun	aXiniyama/kArya
acting_noun	kAryakArI
activate_noun	sakriya_karanA
active_noun	sakriya/kriyASIla
activity_noun	kAryakalApa/gawiviXi/kriyAkalApa
actuals_noun	vAswavika_AMkadZe
actuated_noun	saMcAliwa/pravarwiwa
actuator_noun	saMcAlaka/pravarwaka
adaptability_noun	anukUlanIyawA
adaptation_noun	anukUlana
adapter_noun	anukUlaka/edeptara
adder_noun	yojaka
additional_noun	awirikwa/apara
additive_noun	yojaka/yojya/yogAwmaka/yogaSIla
adhesion_noun	AsaMjana
adhesive_noun	AsaMjaka/cipakAneM_vAlA_paxArWa
adit_noun	praveSa_suraMga/edita
adjacent_noun	nikatavarwI/Asanna
adjoining_noun	samIpavarwI/satA_huA
adjourned_noun	sWagiwa
adjustable_noun	samAyojya
administer_noun	praSAsana_karanA/xenA/xilAnA
admittance_noun	praveSyawA
adoption_noun	aMgIkaraNa
advice_noun	salAha
aeration_noun	vAyumiSraNa/vAwana
aerial_noun	eriyala
aerodynamic_noun	vAyugawika
affidavit_noun	SapaWa-pawra/halaPZanAmA
affiliate_noun	saMbaxXa_karanA
afflux_noun	pravAha/bahAva
afforestation_noun	vanaropaNa/vanIkaraNa
ageing_noun	kAlapraBAvana
agitation_noun	AMxolana/vilodana/prakRoBana
agitator_noun	vilodaka/prakRoBaka
agreement_noun	karAra/anubaMXa
airfoil_noun	vAyupawraka
airless_noun	vAyu_rahiwa
alarm_noun	alArma
align_noun	sIXa_milAnA/saMreKaNa
alignment_noun	saMreKaNa
alkali_noun	kRAra
alkaline_noun	kRArIya
allocate_noun	niyawa_karanA/nirXAriwa_karanA
allocation_noun	niyawana
alloy_noun	miSraXAwu/eloYya
alluvial_noun	jaloDZa
alluvium_noun	jaloDZaka
alternating_noun	prawyAvarwI
alternator_noun	prawyAvarwaka/oYltaranetara
altitude_noun	uccawA/UMcAI
alum_noun	PitakarI
alumina_noun	EluminA
amalgamation_noun	samAmelana
ambient_noun	pariveSI
ammeter_noun	EmItara/XArAmApI
ammonia_noun	amoniyA
ampere_noun	Empiyara
amplidyne_noun	EmplIdAina
amplification_noun	pravarXana
amplifier_noun	pravarXaka/EmplIPAyara
amplitude_noun	AyAma
analogous_noun	anurUpa
analogue_noun	anurUpa
analyser_noun	viSleRaka
analysis_noun	viSleRaNa
anemometer_noun	enemomItara/vAyu_vega_mApI
angle_noun	koNa
angular_noun	koNIya
annular_noun	valayAkAra
annunciation_noun	Xvani_saMkewa
anode_noun	Enoda
antenna_noun	EMtInA
anti-termite_noun	xImakaroXI
anticlockwise_noun	vAmAvarwa
antimetry_noun	prawimApana
aperture_noun	Cixra
apparatus_noun	upakaraNa
appliance_noun	upasAXana
aquaplane_noun	ekvAplena
aquatic_noun	jalIya
aqueduct_noun	jalasewu
aqueous_noun	jalIya
aquifer_noun	jalavAhI_swara/jalaxAyI_swara
arc_noun	cApa/Arka/vqwwaKaNda
arch_noun	dAta/meharAba
area_noun	kRewra/kRewraPala
arid_noun	SuRka
armature_noun	Armecara
armour_noun	kavaca
artificial_noun	kqwrima
asbestos_noun	EsbestoYsa
ash_noun	rAKa
assembler_noun	saMyojaka/yojaka
assembly_noun	saMyojana/asembalI
assets_noun	parisampawwiyAM
assimilate_noun	svAMgIkaraNa_karanA
assimilation_noun	svAMgIkaraNa
asymmetrical_noun	asamamiwa
atmosphere_noun	vAwAvaraNa/vAyumaMdala
atom_noun	paramANu
attenuation_noun	kRINana
attenuator_noun	kRINaka
audible_noun	Sravya
auger_noun	baramA/veXanI
augmentation_noun	saMvarXana
automatic_noun	svacAliwa
automation_noun	svacalana
auxiliary_noun	sahAyaka/anuRaMgI
availability_noun	upalabXawA/sulaBawA
axial_noun	akRIya
axis_noun	akRa/XurI
axle-steered_noun	XurI_saMcAliwa
axle_noun	XurA/XurI
backbone_noun	AXAraBUwa
background_noun	pqRTaBUmi
backlog_noun	piCalA_bakAyA
balanced_noun	saMwuliwa
balancing_noun	saMwulana/saMwulanakArI
ballast_noun	gittI
band_noun	bEMda/pattI
bandwidth_noun	bEMda-cOdZAI
bank_noun	baMXa/wata/kinArA
bare_noun	anAvqwa
barrage_noun	bErAja
barrel_noun	bErala
barrier_noun	roXa/bEriyara
base_noun	AXAra/kRAra
basement_noun	wahaKAnA/besamenta
basic_noun	buniyAxI/mUla/AXAraBUwa/kRArIya
basin_noun	besina
batching_noun	bEciMga
battery_noun	bEtarI
bay_noun	be
beam_noun	Xarana/kiraNa_puMja
bearing_noun	beyariMga
bed_noun	wala/AXAra
bedding_noun	saMswaraNa/bETAnA
bellows_noun	XOMkanI
benching_noun	pEdZI_banAnA
bend_noun	modZa
bending_noun	baMkana/modZanA
bentonite_noun	bEntonAita
benzene_noun	benjIna
betterment_noun	KuSahAlI/unnawi/behawarI
bi-monthly_noun	xvimAsika/pAkRika
bias_noun	aBinawi/JukAva/pUrvAgraha/pakRapAwa
bifurcate_noun	xviviBAjana/xo_BAgo_meM_bAM_tanA
bimetallic_noun	xviXAwvika
binary_noun	xviaMkI/xviAXArI
binding_noun	baMXanakArI/bAXyakArI
binocular_noun	xUravIkRaNa_yaMwra
biodiversity_noun	jEvaviviXawA
bioelectricity_noun	jEvavixyuwa
biosphere_noun	jEvamaMdala
bipartite_noun	xvipakRIya
bisect_noun	samaxviBAga
bit_noun	aNI/bita_(xvayaMka)
bitumen_noun	dAmara/bitumena
blade_noun	Palaka/bleda
blank_noun	korA/SUnya/KAlI
blasting_noun	visPotana
bleed_noun	risanA/srAva
blend_noun	sammiSraNa
block_noun	avaruxXa/roka/bloYka/KaMda
blower_noun	bloara
blowing_noun	AXamana
boiler_noun	boYyalara
bolt_noun	kAbalA/bolta
bonus_noun	bonasa
borer_noun	veXaka
borrower_noun	uXArakarwA/qNI/karjaxAra/uXAra_lene_vAlA
bottleneck_noun	avaroXa/gawyAvaroXa/rukAvateM
boundary_noun	parisImA/sImA/sImAMwa
bounded_noun	AbaxXa/paribaxXa
bracket_noun	breketa/koRTaka
branch_noun	SAKA
brazing_noun	brejiMga/tAMkA_lagAnA/pIwala_kA_raMga_caDZAnA
break-up_noun	viswqwa_byOrA/vivaraNa
breakage_noun	tUta-PUta
breaker_noun	brekara/viyojaka/roXaka
breakwater_noun	waraMgaroXa
breather_noun	Svasana_yaMwra/brIxara
brick_noun	IMta
bridge_noun	pula/sewu
bronze_noun	kAMsA
bubble_noun	bulabulA
bumper_noun	bampara
bunker_noun	baMkara
burner_noun	barnara
burst_noun	PatanA
bushing_noun	buSiMga
butt_noun	kuMxA
bypass_noun	upamArga
cable_noun	kebila/wAra
calibrate_noun	aMSAMkana_karanA
calibration_noun	aMSAMkana
canal_noun	nahara/kEnAla
canopy_noun	CawarI/viwAna
cantilever_noun	ketIlIvara/prAsaM
capacitance_noun	XAriwA
capacitor_noun	kepesitara/saMXAriwra
capital_noun	pUjI/rAjaXAnIM
casing_noun	AvaraNa/kesiMga
catalyst_noun	uwpreraka
category_noun	SreNI/koti
causeway_noun	sewuka/kAjave
cave-in_noun	XaMsanA
caveat_noun	kevieta/sacewa_karanA
cavern_noun	kaMxarA/guPA
cavity_noun	kotara/guhikA
ceiling_noun	uccawama_sImA/BIwarI_Cawa/aMwaSCaxa
cell_noun	prakoRTa/kakRa/sela
central_noun	keMxrIya
centralisation_noun	keMxrIkaraNa
centralised_noun	keMxriwaM
centre_noun	keMxra
centrifugal_noun	apakeMxra
ceramic_noun	siremika
cess_noun	upakara
cessation_noun	anwa/avasAna
challenge_noun	cunOwI
chamber_noun	kakRa/cEmbara
channel_noun	cEnala/vAhikA
channelling_noun	nAlI_kAtanA
charge_noun	AveSa
charging_noun	AveSana/cArjiMga
chemical_noun	rasAyana
chimney_noun	cimanI
chips_noun	cipa/kaNikA/CIlana
chisel_noun	CenI
choke_noun	coka/avaroXa
chromatic_noun	varNika
chute_noun	praveSikA/Uta/DalavAM_nalI/pravaNikA
cinder_noun	siMdara/kerI/CAI
circuit_noun	paripaWa/sarkita
circular_noun	paripawra/vqwwAkAra
circulate_noun	paricAlana
circulation_noun	parisaMcaraNa
circumference_noun	pariXi
cistern_noun	hOja/kuNdikA/sistarna
cladding_noun	paricCAxana
classification_noun	vargIkaraNa
clause_noun	KaMda
clay_noun	mqwwikA
cleat_noun	gutakA/PannI/klIta
client_noun	grAhaka/sevArWI
climate_noun	jalavAyu
climber_noun	ArohI
clip_noun	klipa
clockwise_noun	xakRiNAvarwa/kloYkavAija
co-ordination_noun	samanvaya
co-ordinator_noun	samanvayaka
coat_noun	lepa
coder_noun	kodara
coefficient_noun	guNAMka
cognizance_noun	saMjFAna
coherence_noun	susaMgawi/saMbaxXawA
cohesion_noun	saMsaMjana/saMsakwi
cohesionless_noun	saMsaMjanahIna/sAmaMjasyahIna/saMsakwihIna
coil_noun	kuMdalI
collar_noun	koYlara
collector_noun	saMgrAhaka
column_noun	swaMBa/koYlama
combination_noun	saMyojana
combustion_noun	xahana
commencement_noun	prAraMBa
commendable_noun	praSaMsanIya/sarAhanIya
comment_noun	samAlocanA/tippaNI
commercial_noun	vANijyika
commissioning_noun	cAlU_honA/AraMBa_honA/kamISaniMga/saMcAliwa_honA
commitment_noun	prawibaxXawA/vacanabaxXawA
communicate_noun	saMcAriwa_karanA/sUciwa_karanA
communication_noun	saMcAra/saMpreRaNa/pawra_vyavahAra
commutation_noun	xikparivarwana/parivarwana/saMrASIkaraNa
compact_noun	saMhawa
comparable_noun	wulya/wulanIya
comparison_noun	wulanA
compass_noun	xiksUcaka/kaMpAsa
compatibility_noun	susaMgawa
compatible_noun	susaMgawa
compendium_noun	sAra_saMgraha
compensation_noun	kRawipUrwi/muAvajA
competency_noun	sakRamawA/kRamawA
compilation_noun	saMkalana
complainant_noun	parivAxI/SikAyawakarwA
complaint_noun	SikAyawa/parivAxa
complementary_noun	pUraka
complete_noun	pUrNa/pUrA/samApwa
completion_noun	samApwi/saMpUrNawA
complex_noun	jatila/parisara
compliance_noun	anupAlana
complimentary_noun	mAnArWa
component_noun	Gataka
composite_noun	sammiSra/saMyukwa
composition_noun	saMGatana/racanA
compound_noun	yOgika/saMyukwa
compressed_noun	saMpIdiwa
compressive_noun	saMpIdaka
compressor_noun	saMpIdaka
computing_noun	aBikalana
concave_noun	avawala
concentrator_noun	saMkeMxraka/sAMxraka
conceptual_noun	saMkalpanAwmaka
concern_noun	prawiRTAna/sarokAra
concession_noun	CUta/riyAyawa
conciliation_noun	milAna/samAXAna
conclusion_noun	niRkarRa
conclusive_noun	niScayAwmaka/niScAyaka
concreting_noun	kaMkrItana
concurrently_noun	sAWa-sAWa
condensation_noun	saMGanana/xravaNa
condensed_noun	saMGaniwa/xraviwa
condenser_noun	saMXAriwra/kaMdensara/xravINawra
conductance_noun	cAlakawva
conduction_noun	cAlana
conductivity_noun	cAlakawA
conductor_noun	cAlaka/kaMdaktara
conduit_noun	kaMdyUta
cone_noun	SaMku
configuration_noun	aBivinyAsa
confirm_noun	puRti_karanA
confirmation_noun	puRtikaraNa/sWAyIkaraNa
conformity_noun	anurUpawA/anukUlawA
connect_noun	saMbaMXana/saMyojana
connector_noun	saMbaMXaka
conservation_noun	saMrakRaNa
conservator_noun	saMrakRaka/kaMjavetarra
considerable_noun	vicAraNIya/mahawvapUrNa
considerably_noun	awyaXika/bahuwa
consideration_noun	prawiPala/vicAra
consignee_noun	preRiwI
consigner_noun	preRaka
consignment_noun	pareRaNa/preRiwa_sAmAna/Kepa
consolidate_noun	samekiwa
consolidation_noun	saMpiMdana/saMGanana
consortium_noun	kansortiyama/saMGa/samUha
constant_noun	sWira/sWirAMka/niraMwara
constituent_noun	saMGataka/avayava/Gataka
constraint_noun	avaroXa/bAXA
consultant_noun	parAmarSaxAwA/parAmarSI/salAhakAra
consultation_noun	parAmarSa/salAha
consumer_noun	upaBokwA
consumption_noun	upaBoga/Kapawa
contact_noun	saMparka
contamination_noun	saMxURaNa
contents_noun	aMwarvaswu/viRaya-sUcI/viRaya-vaswu
context_noun	saMxarBa/prasaMga/prakaraNa
contingency_noun	AkasmikawA
contingent_noun	Akasmika/prAsaMgika
continuous_noun	sawawa/lagAwAra/niraMwara
contour_noun	samocca_reKA
contract_noun	TekA/saMvixA
control_noun	niyaMwraNa
controlled_noun	niyaMwriwa
controller_noun	niyaMwraka
convener_noun	saMyojaka
convenient_noun	suviXAjanaka
conventional_noun	paraMparAgawa/pAraMparika
convergence_noun	aBisaraNa/aBisAriwA
conversion_noun	rUpAMwaraNa/parivarwana
converter_noun	parivarwaka
convex_noun	uwwala
convey_noun	le_jAnA/sUciwa_karanA/saMvahana
conveyor_noun	vAhaka
conviction_noun	xoRa_sixXi/xqDZa_XAraNA
cooling_noun	SIwalana
cooperation_noun	sahayoga
coordinate_noun	samanvayana/nirxeSAMka
copy_noun	prawilipi/prawi/kApI/nakala
cord_noun	dorI/wAra
core_noun	kroda/kora
cornice_noun	kArnisa
corona_noun	koronA
correlation_noun	sahasaMbaMXa
corrigendum_noun	SuxXi-pawra
corrosion_noun	saMkRAraNa
cost_noun	lAgawa
counter-claim_noun	prawixAvA
coupler_noun	yugmaka/yojaka/kaplara
coupling_noun	yugmana/kapaliMga
course_noun	swara/parawa/raxxA/paWa
cover_noun	AvaraNa
coverage_noun	vyApwi/AcCAxana
crack_noun	xarAra
crane_noun	krena
creep_noun	visarpaNa/maMxa_virUpaNa
crisis_noun	saMkata/ApAwa
criterion_noun	mAnaxaMda/kasOtI/nikaRa
critical_noun	krAMwika/mahawvapUrNa
crossing_noun	pAra-paWa/krAsiMga
crude_noun	kaccA/apariRkrawq
crush_noun	saMxalana
crusher_noun	xaliwra
crust_noun	parpatI
cube_noun	Gana
culvert_noun	puliyA
cumulative_noun	saMcayI
curing_noun	warAI
current_noun	XArA/karaMta
curve_noun	vakra
curved_noun	GumAvaxAra/vakrAkAra
cusec_noun	kyUseka/GanaPuta_prawi_sekedaM
custodian_noun	aBirakRaka
custody_noun	aBirakRA/hirAsawa
cut-motion_noun	katOwI-praswAva
cut-off_noun	kata-oYPa/kriyAMwa
cycle_noun	cakra
cyclone_noun	cakravAwa
cylinder_noun	belana/siledaraM
cylindrical_noun	belanAkAra
dam_noun	bAMXa
damage_noun	kRawi
damp_noun	nama/Arxra/sIlA
damping_noun	avamaMxana
danger_noun	KawarA/saMkata
data_noun	dAtA
database_noun	dAtAbesa
de-electrified_noun	nirvixyuwIkqwa
de-facto_noun	vaswuwaH/vAswava_meM
debris_noun	malabA
decay_noun	kRaya
decentralisation_noun	vikeMxrIkaraNa
decibel_noun	desIbala
decimal_noun	xaSamalava
decision_noun	nirNaya/PEsalA
declaration_noun	GoRaNA
decoder_noun	vikodaka/kUtavAcaka
decouple_noun	viyugmana
decrease_noun	kama_karanA/kama_honA/kamI
deduction_noun	katOwI
deed_noun	vileKa
default_noun	cUka/bakAyA
defaulter_noun	cUkakarwA/bakAyAxAra
defective_noun	xoRapUrNa/wrutipUrNa
defendant_noun	prawivAxI
deferred_noun	AsWagiwa
deficiency_noun	kamI/nyUnawA
deficit_noun	GAtA/kamI
deflection_noun	vikRepa
deforestation_noun	vano_kI_katAIM/vana_unmUlana
degradation_noun	nimnIkaraNa
degree_noun	digrI/aMSa/koti
dehydration_noun	nirjalIkaraNa
delay_noun	vilaMba/xerI
deliberation_noun	vicAra-vimarSa
delinquent_noun	apacArI
delivery_noun	supurxagI
delta_noun	naxI_kA_muhAnA/deltA
demand_noun	mAMga
demerit_noun	avaguNa
demodulation_noun	vimoYduna/dimoYdyUleSana
demolish_noun	DahAnA
demonstration_noun	praxarSana/nixarSana
demurrage_noun	demareja/vilaMba_Sulka/GAtA_Sulka
dense_noun	GanA/saGana
density_noun	saGanawA/Ganawva
depletion_noun	avakRaya/tTAsa
deposition_noun	jamA/nikRepaNa/aBisAkRya_tTa
depreciation_noun	mUlya_Asa
depth_noun	gaharAI
design_noun	dijZAina/aBikalpa/aBikalpanA
designate_noun	nAmoxxiRta_karanA/paxanAmiwa
desilting_noun	vigAxana
destination_noun	gaMwavya
detail_noun	byOrA/viswqwa_vivaraNa
detection_noun	Koja/pawA_lagAnA/saMsUcana
detector_noun	saMsUcaka
deteriorate_noun	KarAba_honA/bigadZanA/apakarRa
deterrance_noun	prawivAraNa
deterrence_noun	nivAraNa/avaroXa/rukAvata
detonation_noun	aXisPotana
detonator_noun	aXisPotaka
detrimental_noun	hAnikAraka/ahiwakara
devaluation_noun	avamUlyana
deviation_noun	vicalana_aMwara
device_noun	sAXana/yukwi
dewatering_noun	vijalana
diagnose_noun	nixAna_karanA
diagnostic_noun	nExAnika/nixAna_saMbaMXI
diagram_noun	AreKa
diameter_noun	vyAsa
dielectric_noun	dAiilektrika/parAvExyuwa
diffuser_noun	visAraka
digit_noun	aMka
digital_noun	aMkIya/dijitala
dimension_noun	vimA
dimmer_noun	xIpwi_maMxaka
diode_noun	dAyoda
dipole_noun	xviXruva/dAipola
disbursement_noun	saMviwaraNa
disc_noun	cakrikA/diska
discard_noun	alaga_karanA/hatA_xenA
discharge_noun	visarjana/nissaraNa
discipline_noun	anuSAsana/viRaya_kRewra
disclaimer_noun	xAvA-wyAga
disclosure_noun	prakatana
disconnect_noun	viyojana
disconnector_noun	viyojaka
discover_noun	pawA_lagAnA/KojanA
discrepancy_noun	visaMgawi
discretion_noun	viveka/vivekAXikAra
discrimination_noun	BexaBAva
disintegration_noun	viGatana/vicCexa
dismantle_noun	purje_KolanA/viKaMdIkaraNa
disparity_noun	asamAnawA
disperse_noun	visarjiwa_honA
dispersion_noun	prakIrNana/parikRepaNa
displacement_noun	visWApana
disposal_noun	nipatAna/nipatArA/niswAraNa
dispute_noun	vivAxa
disqualified_noun	ayogya
dissemination_noun	prasAra
dissipation_noun	kRaya/visaraNa
dissolve_noun	viGatiwa_karanA/BaMga_karanA/GulanA/vilIna_honA
distempering_noun	distempara_karanA
distillation_noun	Asavana
distortion_noun	vikqwi/virUpaNa
distribution_noun	viwaraNa
distributor_noun	viwaraka
disturbance_noun	vikRoBa/upaxrava
ditto_noun	waxEva/vahI
divergence_noun	apasaraNa
diversion_noun	viRayAMwara/paWAMwara
document_noun	xaswAveja/praleKa/kAgajAwa
documentation_noun	praleKana
dome_noun	gumbaxa/doma
domestic_noun	GarelU/anwarxeSIya
dominant_noun	pramuKa/prabala
downward_noun	aXomuKI
drain_noun	drena/nAlA
drainage_noun	jala_nikAsa/apavAhana
drawn_noun	Ahariwa
drift_noun	apavAha/driPta
drilling_noun	veXana/driliMga
drum_noun	drama
dryness_noun	SuRkawA
duct_noun	vAhikA/dakta
duly_noun	viXivaw
dump_noun	Dera_lagAnA/Peka_xeM_nA
dumper_noun	daMpara
durability_noun	tikAUpana
dust_noun	XUla
dynamic_noun	gawika
dynamics_noun	gawikI/gawivijFAna
dynamometer_noun	balamApI/dAyanamomItara
earmarked_noun	viSeRa_cihniwa
earth-conductor_noun	BU_-saMparka_cAlaka/kaMdaktara
earthing_noun	BU_-saMparkana
echo_noun	prawiXvani
economical_noun	miwavyayI/kiPAyawI
economiser_noun	miwopayojiwra/ikonomAijara
eddy_noun	BaMvara
edge_noun	XAra/kora/kinArA
edging_noun	kinArAbaMxI
effect_noun	praBAva/asara
effective_noun	praBAvI
efficiency_noun	xakRawA
efficient_noun	xakRa
ejector_noun	uwkRepaka/ijektara
elastic_noun	lacIlA/lacakaxAra/prawyAsWa
electric_noun	vixyuwa
electrical_noun	vExyuwa/vixyuwa
electrification_noun	vixyuwIkaraNa
electrified_noun	vixyuwIkqwa
electro-mechanical_noun	vExyuwayAMwrika
electrode_noun	ilektroda
electrolyte_noun	vixyuwa_apaGatya
electromagnetic_noun	vixyuwacuMbakIya
electronic_noun	ilektroYnika
electronics_noun	elektroYnikI
electroplating_noun	vixyuwalepana
electrostatic_noun	ilektrostetika/sWira_vExyuwa
element_noun	wawva/Gataka/avayava
elementary_noun	prAraMBika
elevation_noun	uwWAna/unnayana/uwWApana/uccawA/UzcAI
elevator_noun	uwWApaka/elIvetara/liPta
eliminate_noun	vilopa_karanA
elliptical_noun	xIrGavqwwAkAra
elongation_noun	xIrGIkaraNa
embankment_noun	watabaMXa
embargo_noun	niReXa/prawibaMXa/roka
embedded_noun	aMwaH_sWApiwa
emerge_noun	nirgamana
emissivity_noun	uwsarjakawA
empanel_noun	nAmasUcI/sUcIbaxXa_karanA
employer_noun	niyojaka/niyokwA
empower_noun	aXikAra_xenA/Sakwi_xenA
empowerment_noun	saSakwikaraNa
emulsion_noun	imalSana/pAyasa
encapsulate_noun	saMputiwa_karanA
encashment_noun	nakaxIkaraNa
enclosure_noun	anulagnaka/saMlagnaka/ahAwA
encumbrance_noun	BAragraswa
end_noun	aMwa/sirA
endorsement_noun	pqRTAMkana
endurance_noun	sahanaSakwi
energisation_noun	UrjAyana/UrjIkaraNa
energized_noun	Urjiwa
energy_noun	UrjA
enforce_noun	pravarwana/lAgU_karanA
engineering_noun	iMjIniyarI/aBiyAMwrikI
enhance_noun	vqxXi
enlargement_noun	parivarXana
enlist_noun	sUcIbaxXa_karanA
enquiry_noun	jAzca/pUCawACa
ensuing_noun	AgAmI
ensure_noun	suniSciwa_karanA
enter_noun	praveSa
enterpreneur_noun	uxyamI
enterprise_noun	uxyama
enthalpy_noun	enWElpI
entitlement_noun	hakaxArI
entrap_noun	PaMsanA
entries_noun	praviRtiyAM
entropy_noun	entroYpI
enumeration_noun	gaNanA/ginanA
environment_noun	paryAvaraNa
envisage_noun	parikalpanA
envisaged_noun	parikalpiwa
equal_noun	sama/barAbara
equilibrium_noun	sAmya
equip_noun	sajjiwa_karanA
equipment_noun	upaskara
equitable_noun	sAmyika
equity_noun	ikvitI/aMSapUjIM
equivalent_noun	samakakRa/samawulya/wulyamAna/wulya
eradication_noun	unmUlana
erection_noun	uwWApana
erosion_noun	kAta/katAva/aparaxana
error_noun	wruti
escalation_noun	vqxXi/baDZowarI
escape_noun	bacAva/palAyana
essential_noun	AvaSyaka/jarUrI/anivArya
establishment_noun	sWApanA/prawiRTAna
estimate_noun	anumAna/prAkkalana
ethernet_noun	IWaraneta
ethical_noun	nEwika/nIwiparaka
evaluation_noun	mUlyAMkana
evaporation_noun	vARpana
evaporator_noun	vARpiwra
eventual_noun	saMBAviwa/anwawaH
evidence_noun	sAkRya/gavAhI
evolution_noun	vikAsa
evolve_noun	vikasiwa_karanA_yA_honA
ex-gratia_noun	anugraha_rASi
ex-officio_noun	paxena
ex-serviceman_noun	BUwapUrva_sEnika
examination_noun	parIkRA
examine_noun	jAzca_karanA
excavated_noun	uwKaniwa
excavation_noun	uwKanana/KuxAI/Kanana
excellence_noun	uwkqRtawA
excellent_noun	uwkqRta
exception_noun	apavAxa
exceptional_noun	apavAxa_svarUpa/asAXAraNa
excess_noun	awirikwa/aXika
excessive_noun	awyaXika
exchange_noun	vinimaya/AxAna-praxAna/axalA-baxalI
exchanger_noun	vinimayaka
excitation_noun	uwwejana
exciter_noun	uwwejaka/uwwejiwra
exclusive_noun	ananya/ekamAwra
executant_noun	niRpAxaka
execute_noun	niRpAxana_karanA
executor_noun	niRpAxaka
exempt_noun	CUta_xenA
exhaust_noun	niRkAsana/recana/recaka/niRkAsaka
exhaustive_noun	sarvAMgINa/vyApaka
exhibition_noun	praxarSanI/numAiSa
existence_noun	aswiwva
existing_noun	varwamAna/vixyamAna/mOjUxA/pracaliwa
exit_noun	nirgama/nikAsa
exonerated_noun	Aropamukwa
expansion_noun	prasAra/viswAra/PElAva
expectation_noun	prawyASA
expected_noun	prawyASiwa
expedite_noun	SIGra_kArravAI_karanA/SIGra_nipatAna
expel_noun	nikAla_xenA/niRkAsiwa_karanA
expenditure_noun	vyaya/Karca
expenses_noun	vyaya/Karca
experience_noun	anuBava
experiment_noun	prayoga
experimental_noun	prAyogika/prayogAwmaka
expert_noun	viSeRajFa
expertise_noun	viSeRajFawA/nipuNawA
explanation_noun	spaRtIkaraNa
explosion_noun	visPota
explosive_noun	visPotaka
exposure_noun	anAvaraNa/praBAvana/uxBAsana
extend_noun	baDZAnA/viswAra_karanA/praxAna_karanA
extendable_noun	viswAra_yogya
extension_noun	viswAra
extent_noun	viswAra/sImA
exterpleader_noun	eksataraplIdara
extinguisher_noun	SAmaka
extract_noun	sAra
extraction_noun	niRkarRaNa
extrapolation_noun	bahirvaSana/bahirke_lana
extreme_noun	carama
fabrication_noun	saMviracana
face_noun	muKa/Palaka/pahalU/agraBAga
facilitate_noun	susAXya_banAnA
fact-finding_noun	waWyAnveRaNa
fact_noun	waWya/waWyapUrNa
factor_noun	Gataka/upAxAna/kAraka/KaMda/guNanaKaMda/guNaka
failure_noun	viPalawA/KarAbI/BaMga
fake_noun	nakalI/jAlI
fasten_noun	xqDZa_karanA/bAMZ_XanA
fastener_noun	baMXaka
fastening_noun	baMXana/baMXaka
faulty_noun	xoRa_pUrNa/KarAba
fauna_noun	prANijagawa
favourable_noun	anukUla
feasibility_noun	saMBAvyawA
feature_noun	viSeRawA/lakRaNa
feed_noun	BaraNa
feeder_noun	Baraka/PIdara/praxAyaka/saMBaraka
fencing_noun	jaMgalA/bAdZa
ferrite_noun	PErAita
ferrule_noun	PerUla
fibre_noun	reSA/waMwu/sUwra
fibrous_noun	reSexAra/waMwumaya
fictitious_noun	JUTA/kAlpanika/ParjI/kalpiwa
field_noun	kRewra
figures_noun	AMkadZa/aMe_ka/ciwra/Akqwi
filament_noun	waMwu/PilAmetaM
fill_noun	BarAva/BarAI/BaranA
filter_noun	Piltara/nisyaMxaka
fin_noun	pawwI/paMKa
finalize_noun	aMwima_rUpa_xenA
finance_noun	viwwa
financed_noun	viwwa_poRiwa
financial_noun	viwwIya
findings_noun	niRkarRa
fine_noun	mahIna/pariRkqwa/jurmAnA/arWa_xaMda
finish_noun	parisajjA/wEyAra_karanA
finished_noun	pariRkqwa/wEyAra
firing_noun	jvAlana/xAganA
fisheries_noun	mawsya_pAlana
fissure_noun	xarAra
fixation_noun	niyawana/sWirIkaraNa/nirXAraNa
fixed_noun	sWira/niyawa/acala
fixtures_noun	Piksacara
flake_noun	pApadZI/Salka
flame_noun	jvAlA
flange_noun	PlEnja
flap_noun	pallA/Dakkana
flashover_noun	xamaka_uwsarjana/PlESa_ovara
flat_noun	sapAta/capatA
flaw_noun	xoRa
flexibility_noun	lacIlApana/namyawA
float_noun	plava/guramAlA
flooding_noun	AplAvana
floodlight_noun	pura-xIpa/PladalAita
floor_noun	ParSa/wala
flora_noun	vanaspawi_jagawa
flow_noun	pravAha
flowmeter_noun	pravAhamApI
fluctuation_noun	uwAra-caDZAva/Upara_nIce_honA
flue_noun	XUmra_vAhikA/XUmra_paWa
fluid_noun	warala
flume_noun	avanAlikA
flux_noun	Plaksa/gAlaka/aBivAha
flywheel_noun	gawipAlaka_cakra/PlAI_vhIla
focus_noun	Pokasa
foot_noun	pAxa
force_noun	bala
forebay_noun	agrawAla
forecast_noun	pUrvAnumAna
foreign_noun	vixeSI/bAhya/asaMgawa
forfeit_noun	jabwa_karanA
forfeiture_noun	jabwI
forged_noun	Porjda/jAlI
formation_noun	racanA/nirmANa
formula_noun	sUwra
forwarded_noun	agreRiwa
forwarding_noun	agreRaNa
foundation_noun	nIMva/buniyAxa/AXAra
foundry_noun	DalAI-SAlA/PAuMdrI
fraction_noun	Binna/aMSa/hissA
fractional_noun	BinnAwmaka/AMSika
fragmental_noun	KaMdamaya
frame_noun	DAMcA/Prema
framework_noun	DAMcA/Premavarka
fraudulent_noun	kapatapUrNa
freight_noun	mAla-BAdZA
frequency_noun	Avqwwi/bAraMbArawA
frequently_noun	bArambAra/aksara/prAyaH
friction_noun	GarRaNa
front-end_noun	agrAMwa
fruitful_noun	PalaxAyaka/lABaxAyaka
function_noun	prakArya/Palana
functional_noun	prayojanamUlaka/prakAryAwmaka
fund_noun	niXi
fundamental_noun	mUlaBUwa/AXAraBUwa
furnace_noun	BatTI
fuse_noun	PyUjZa/galanA
g.factor_noun	RhaR_guNaka
gain_noun	prApwi/upalabXi/lABa
galvanisation_noun	gElvenAijeSana/jaswIkaraNa
galvanising_noun	jaswIkaraNa
galvanometer_noun	gElvEnomItara/vixyuwa_XArA_mApI
gap_noun	aMwara/aMwarAla
gasket_noun	gAsketa
gate_noun	xvAra/PAtaka/kapAta
gauge_noun	geja/pramApI/pramApa
gear_noun	giyara
generation_noun	vixyuwa_uwpAxana
generator_noun	janiwra/janaretara
geo-grid_noun	BU-grida
germanium_noun	jarmeniyama
geyser_noun	gIjara
girder_noun	gardara
girth_noun	lapeta/pariXi
glare_noun	camaka/cOMXa
global_noun	vyApaka/viSvavyApI
governance_noun	SAsana
gradient_noun	DalAna/pravaNawA
gradual_noun	kramika/SanEH_SanEH
grant_noun	anuxAna/svIkAra_karanA
graph_noun	grAPa/AleKa
grate_noun	jAlikA
grating_noun	jAlI/gretiMga
gratuity_noun	upaxAna
gravel_noun	bajarI
gravitational_noun	guruwvIya
gravity_noun	guruwva
grid_noun	grida/jAla
grill_noun	jAlI/jaMgalA
grinder_noun	grAiMdara/peRaka
grip_noun	pakadZa
grooming_noun	wEyAra_karanA
groove_noun	KAMcA
grounding_noun	BU-saMparkana
grouting_noun	grAutiMga/Gola_aBipUraNa
growth_noun	vqxXi/baDZowarI/vikAsa
guidelines_noun	mArgaxarSI_sixXAMwa/xiSA-nirxeSa
gutter_noun	gatara/nAlA
gyrator_noun	jAiretara
h.t.line_noun	eca.tI.lAina/ucca_voltawA_lAina
h.v.industry_noun	ucca_voltawA_uxyoga
hammer_noun	Gana/haWOdZA
harbour_noun	baMxaragAha/hArbara
hard_noun	kaTora
hardening_noun	kaTorIkaraNa
hardness_noun	kaTorawA
hardware_noun	hArdaveyara
harmonious_noun	sOhArxapUrNa
haul_noun	DulAI_karanA/anukarRaNa
haulage_noun	DulAI
hazard_noun	joKima
heat_noun	URmA
height_noun	UzcAI
highlights_noun	muKya_bAweM
hinges_noun	kabje
hiring_noun	kirAe_para_lenA
hoist_noun	Upara_uTAnA/PaharAnA/uccAlaka
holds-up_noun	roka/rukAvateM
hole_noun	Cixra
hollow_noun	KoKalA
hood_noun	Cawra/Cawraka/huda
hook_noun	kAMtA/huka
hopper_noun	hoYpara
horizontal_noun	kREwija
hotline_noun	xruwa_lAina/hoYta_lAina
humid_noun	namIyukwa/Arxra
humidity_noun	ArxrawA
hydel_noun	jala_vixyuwa
hydrant_noun	jalowsarjaka/hAidrEMta
hydraulic_noun	xravacAliwa/hAidroYlika/xravIya
hydrogen_noun	hAidrojana
hydrographer_noun	jala_savekRarka
hydrology_noun	jalavijFAna
identical_noun	eka_samAna/samarUpa/samAna
identify_noun	pahacAna_karanA/aBijFAna_karanA/SinAKwa_karanA
idle_noun	kAryahIna/niRkArya/niRkriya/bekAra/nirarWaka
ignition_noun	prajjvalana
illegal_noun	avEXa
illumination_noun	praxIpwi/praxIpana
illustration_noun	uxAharaNa/xqRtAMwa
image_noun	prawibimba/bimba
immediate_noun	wawkAla/wuranwa/avilaMba
impact_noun	praBAva/takkara/saMGatta
impartial_noun	niRpakRa
impedance_noun	prawibAXA
impeller_noun	praNoxaka
implementation_noun	kAryAnvayana
import_noun	AyAwa
imposition_noun	aXiropaNa
imprest_noun	agraxAya/impresta
improper_noun	anuciwa
improvement_noun	suXAra
in-toto_noun	saMpUrNawaH
inadequate_noun	aparyApwa
inadvertently_noun	BUlavaSa
inauguration_noun	uxGAtana
incidental_noun	prAsaMgika
inclination_noun	DalAna/JukAva/pravqwwi
incline_noun	DAla/JukAnA/JukanA
inclined_noun	pravqwwa/icCuka/JukA_huA
incoming_noun	Avaka
inconsistent_noun	asaMgawa
incorporate_noun	nigamiwa_karanA/samAviRta/sammiliwa_karanA
indemnify_noun	kRawipUrwi_karanA
indent_noun	mAMgapawra
indexing_noun	sUcI_banAnA/anuBAjana
indication_noun	saMkewa/sUcana
indigenous_noun	xeSaja/svaxeSI
indirect_noun	aprawyakRa/parokRa
indispensable_noun	aparihArya
inducer_noun	preraka
inductance_noun	prerakawva
induction_noun	preraNa/samAveSana/praveSana
inductive_noun	preraNika
inductivity_noun	prerakawA
industry_noun	uxyoga
ineffective_noun	apraBAvI
inefficient_noun	axakRa/akRama
ineligible_noun	apAwra
infested_noun	graswa
infinite_noun	aparimiwa
inflammable_noun	jvalanaSIla
inflow_noun	aMwarvAha
influence_noun	praBAva
informative_noun	sUcanAwmaka/sUcanAparaka
infrastructure_noun	buniyAxI/AXAraBUwa_DAMcA/buniyAxI_suviXAeM
infringement_noun	awilaMGana
ingredient_noun	saMGataka/avayava
inherent_noun	aMwarnihiwa
initiative_noun	pahala
inlet_noun	aMwargama
innovation_noun	navAcAra/nava_pravarwana/navonmeRa
inposition_noun	sWiwi/mOjUxA_paxasWApanA
input_noun	niviRta/niveSa/inaputa
insecticide_noun	kItanASaka
inspection_noun	nirIkRaNa
inspiration_noun	preraNA
instability_noun	asWAyiwva
installation_noun	saMsWApana/aXiRTApana
installment_noun	kiswa
instantaneous_noun	wAwkRaNika
institute_noun	saMsWAna
institution_noun	saMsWA
institutional_noun	saMsWAgawa/sAMsWAnika
instruction_noun	anuxeSa
instrumentation_noun	mApayaMwraNa/iMstrumeteM_Sana
insubordination_noun	anaXInawA/avajFA
insulation_noun	roXana/vixyuwa_roXana
insulator_noun	roXI/vixyuwaroXI/vixyuwaroXaka
insurance_noun	bImA
intake_noun	aMwargrahaNa/aMwargrAhI/inateka
integer_noun	pUrNAMka
integral_noun	aBinna/ekIkqwa
integrated_noun	ekIkqwa
integration_noun	ekIkaraNa
integrity_noun	aKaMdawA/sawyaniRTA
intensive_noun	gahana
intent_noun	ASaya
inter-dependent_noun	aMwaHnirBara/paraspara_nirBara
inter-state_noun	aMwararAjyIya
interest_noun	hiwa/byAja
interface_noun	iMtaraPesa/aMwarApqRTa
interference_noun	haswakRepa/bAXA_dAlanA
interim_noun	aMwarima
interlacing_noun	aMwargraMWana
interlinked_noun	aMwaH_saMbaxXa
interlock_noun	iMtaraloYka/aMwaHpASa
internet_noun	iMtaraneta
interpolation_noun	aMwarkalana/aMwarveSana
interpretation_noun	vyAKyA/nirvacana
interrupt_noun	vyavaXAna/haswakRepa_karanA/bAXA_dAlanA
intersect_noun	kAtanA/prawicCexa_karanA
interval_noun	anwarAla/maXyAnwara
intervening_noun	xaKala_xenA/haswakRepa_karanA
intervention_noun	haswakRepa/xaKala/maXyasWawA
invalid_noun	amAnya/aviXimAnya/aSakwa
inventory_noun	sAmagrI_sUcI
investigation_noun	jAMca/anveRaNa
investment_noun	niveSa
invoice_noun	bIjaka
invoking_noun	BunAnA
inward_noun	Avaka
ionization_noun	Ayanana
irrevocable_noun	aprawisaMharaNIya/avikalpI
irrigation_noun	siMcAI
isolated_noun	vilagiwa/pqWaka
isolator_noun	Aisoletara/vilagakArI
issue_noun	jArI/muxxA/aMka/nirgama
jammer_noun	jAmaka/jEmara
jamming_noun	jAmaka/jAma_honA/saMkewa_avaroXana
jerk_noun	JatakA
jet_noun	jeta/praXAra
jetty_noun	jetI/GAta
joint_noun	jodZa/saMyukwa
judgement_noun	nirNaya
judicial_noun	nyAyika/axAlawI
jumper_noun	jampara
junction_noun	saMXi/jaMkSana
jurisdiction_noun	aXikAra_kRewra/kRewrAXikAra
justify_noun	Ociwya/nyAyociwa/nyAyasaMgawa
kiln_noun	BatTA
kilometer_noun	kilomItara
kilowatt_noun	kilovAta
knob_noun	mUTa/GaMudI
know-how_noun	wakanIkI_jAnakArI
laboratory_noun	prayogaSAlA
labour_noun	mehanawa/Srama/Sramika
landmark_noun	pahacAna_cihna/sImA_cihna
layer_noun	parawa/swara
laying_noun	biCAnA
layout_noun	rUpareKA/aBinyAsa/KAkA/vinyAsa
lead_noun	sIsA/agrawA/vahana_xUrI
lease_noun	pattA
ledger_noun	KAwA_bahI/rokadZa_bahI
legal_noun	kAnUnI/vEXAnika/viXika
legality_noun	vEXawA
lender_noun	qNaxAwA/uXAraxAwA
lending_noun	uXAra_xenA
level_noun	samawala_karanA/wala/swara
leverage_noun	uwwolana/praBAvana_kRamawA
liability_noun	xeyawA/xenaxArI/xAyiwva
liable_noun	xAyI/xenaxAra/jimmexAra/BAgI
licence_noun	anujFapwi/lAisesaM
lien_noun	punargrahaNa_aXikAra/XAraNAXikAra/liyana
linking_noun	jodZanA/saMparka
liquidate_noun	parisamApana
listed_noun	sUcIbaxXa
lithosphere_noun	sWalamaMdala
live_noun	sakriya/sajIva
load_noun	BAra/loda
loader_noun	BAraka/lodara
loan_noun	qNa/uXAra/karja
location_noun	avasWiwi/sWAna/sWiwi
locking_noun	graMWana
locomotion_noun	gamana/calana
logging_noun	loYgiMga/saMleKana
longitudinal_noun	xeSAMwarIya/anuxErXya
looseness_noun	DIlApana/SiWilawA
lowering_noun	uwAranA/nIce_lAnA
machine_noun	yaMwra/maSIna
macro_noun	bqhaw/mahA/sWUla
magnaflux_noun	mEgnAPlaksa
magnesium_noun	mEgnISiyama
magnet_noun	cuMbaka
magnetic_noun	cuMbakIya
magnetism_noun	cubakawvaM
magnitude_noun	parimANa
maintenance_noun	anurakRaNa/raKaraKAva
management_noun	prabaMXana
managerial_noun	prabaMXakIya
manhole_noun	mEnahola
manifesto_noun	GoRaNA-pawra
manifests_noun	suspaRta/prawyakRa/vyakwa/prakata_karanA
manpower_noun	janaSakwi
manual_noun	niyama_puswaka/niyamAvalI
manufacture_noun	vinirmANa
mapping_noun	nakSA_banAnA/mAnaciwraNa
margin_noun	mArjina
massive_noun	sWUla/awiviSAla/viSAla/vyApaka
material_noun	sAmagrI
maxwell_noun	mEksavela
measure_noun	nApa/upAya/mApa
measurement_noun	mApana
mechanics_noun	yAMwrikI/yaMwravijFAna
mechanism_noun	kriyAviXi/yaMwrAvalI
mechanized_noun	maSInIkqwa
medium_noun	mAXyama/vAhaka
megawatt_noun	megAvAta
megger_noun	megara
membrane_noun	JillI
metal_noun	XAwu
meter_noun	mItara
metering_noun	mApana
method_noun	viXi/paxXawi/praNAlI
methodology_noun	kArya_paxXawi
micrometer_noun	sUkRmamApI/mAikromItara
microprocessor_noun	mAikroprosesara/sUkRma_prakramaka
microwave_noun	sUkRma_waraMga/mAikroveva
milestone_noun	mIla_pawWara/lakRya
mine_noun	KAna
mineral_noun	Kanija
minerology_noun	Kanija_vijFAna
misappropriation_noun	xurviniyojana
miscellaneous_noun	viviXa/Putakara
misconduct_noun	kaxAcAra
mix_noun	miSraNa
mixing_noun	milAnA/miSraNa
mixture_noun	miSraNa
model_noun	nixarSa/moYdala
modernization_noun	AXunikIkaraNa
modification_noun	ASoXana/Aparivarwana
modulation_noun	moYdulana
module_noun	moYdyUla
modulus_noun	mApAMka
moisture_noun	namI/ArxrawA
moistureless_noun	namIhIna/ArxrawAhIna
molecule_noun	aNu
molten_noun	galiwa/piGalA_huA
momentum_noun	saMvega
monetary_noun	mOxrika/ArWika
monitoring_noun	nigarAnI/moYnitariMga/.praboXana
monogram_noun	monogrAma/nAma-cihna
monopoly_noun	ekAXikAra
mortar_noun	masAlA/mortAra
mortgage_noun	baMXaka/rehana
motion_noun	praswAva/gawi
motivation_noun	aBipreraNa/preraNA
motor_noun	motara
mould_noun	sAMcA
muck_noun	malabA/karxama
mud_noun	gArA
multifarious_noun	bahuviXa/viviXa
multiplexing_noun	bahusaMkewana/maltIpleksiMga
mutation_noun	nAmAMwaraNa/xAKila-KArija
natural_noun	prAkqwika/svABAvika
navigation_noun	xiSAsUcana
negotiation_noun	vArwA/sOxA-bAwacIwa
network_noun	netavarka
neutral_noun	uxAsIna/nyUtrala
node_noun	noda
nodule_noun	gAMTa/granWikA
noise_noun	Sora/kolAhala/rava
non-convertible_noun	aparivarwanIya
non-corrosive_noun	asaMkRAraNIya
non-cumulative_noun	asaMcayI/gEra_saMcayI
non-encumberance_noun	BAramukwa
non-standard_noun	amAnaka
notification_noun	aXisUcanA
notwithstanding_noun	wo_BI/Pira_BI/ke_bAvajUxa
nozzle_noun	noYjZala
nuclear_noun	nABikIya
nut_noun	nata/DibarI
obsolete_noun	apracaliwa
ohm_noun	oma
oilflushing_noun	wela_prakRAlana
oiling_noun	snehana/wElIkaraNa
on-probation_noun	parivIkRAXIna
opaque_noun	apAraxarSI
operation_noun	pracAlana/saMkriyA
optimization_noun	iRtawamIkaraNa
optimum_noun	anukUlawama/iRtawama
ore_noun	ayaska
orientation_noun	aBivinyAsa
oscillator_noun	xoliwra/xolaka
oustees_noun	visWApiwa
outage_noun	Auteja
outlay_noun	parivyaya
outlet_noun	nirgama_xvAra/nikAsa
outsource_noun	bAhya_srowa/Auta_sorsa
over-work_noun	kAryAXikya
overageing_noun	aXikAlapraBAvana/awikAla_praBAvana
overdriving_noun	aXicAlana
overdue_noun	awixeya/awiSoXya/vilaMbiwa
overflow_noun	aXipravAha
overlap_noun	awivyApwi/caDZAva
overspeed_noun	awi_cAla/ovara_spIda
overvoltage_noun	awivoltawA
ownership_noun	svAmiwva/mAlikAnA
oximetry_noun	oYksImiwI
ozokerite_noun	ojokerAita/Kanija_moma
package_noun	pEkeja
panel_noun	penala
parameter_noun	pErAmItara/prAcala
patent_noun	petenta/ekasva
pattern_noun	prawirUpa/pEtarna
pendency_noun	anirNIwa/laMbana
pending_noun	laMbiwa
penetration_noun	anwarveSana
perennial_noun	bArahamAsI
perforated_noun	Cixrayukwa/Cixriwa
perforator_noun	Cixraka
performance_noun	niRpAxana
periphery_noun	parireKA/pariXi
permanency_noun	sWAyiwva
permeability_noun	pAragamyawA
permeameter_noun	pAragamyawAmApI/cubaMkaSIlawA_mApI
perpetual_noun	SASvawa/niraMwara/sWAyI
persistent_noun	sawawa
personnel_noun	kArmika
perspective_noun	pariprekRya/parixqSya
perusal_noun	avalokana
petitions_noun	yAcikA
phasing_noun	PejiMga/Peja_samaMjana
photo-synthesis_noun	prakASa_saMSleRaNa
pier_noun	pAyA/praswaMBa
pigtail_noun	pigatela
pillar_noun	KaMBA/swaMBa
pinion_noun	piniyana/garArI/xaMwikA_cakra
pioneer_noun	poYyaniyara/agraNI
piston_noun	pistana
pit_noun	gadDA/garwa
plaint_noun	vAxa-pawra
plaintiff_noun	vAxI
plan_noun	yojanA
plane_noun	samawala
planning_noun	AyojanA
plant_noun	saMyaMwra/plAMta
plaster_noun	aswara/plAstara
plinth_noun	kurasI
plot_noun	BUKaMda/ploYta
plotter_noun	aMkaka
plotting_noun	aMkana
plug_noun	plaga
pneumatic_noun	vAyucAliwa
pointer_noun	saMkewaka
polarization_noun	XruvaNa/XruvIkaraNa
pole_noun	KaMBA/Xruva
portability_noun	suvAhyawA/portebilitI
portal_noun	portala
positive_noun	sakArAwmaka/XanAwmaka
possession_noun	aXikAra/svAmiwva/kabjA
potential_noun	kRamawA/viBava
power_noun	vixyuwa/bijalI/Sakwi
pre-requisites_noun	pUrvApekRAeM/pUrva-apekRiwa
precision_noun	pariSuxXawA/yaWArWawA
prediction_noun	pUrvAnumAna
predominant_noun	praXAna/pramuKa
prejudice_noun	pUrvAgraha/pakRapAwa
preliminary_noun	prAraMBika
premium_noun	prImiyama/bImA-kiswa
prepaid_noun	pUrva_BugawAna
presentation_noun	praswuwIkaraNa
preservation_noun	parirakRaNa
pressure_noun	xAba/xabAva
prevail_noun	pracaliwa_honA/aBiBAvI_honA
prevention_noun	rokaWAma
priority_noun	prAWamikawA
private_noun	nijI/prAiveta/gEra_sarakArI
pro-rata_noun	yaWAnupAwa
proactive_noun	agrasakriya
probe_noun	jAMca/proba
procedure_noun	prakriyA/kArya_praNAlI/kAryaviXi
proceedings_noun	kAryavAhI
process_noun	prakrama
processing_noun	prasaMskaraNa/prakramaNa
procurement_noun	prApaNa
production_noun	uwpAxana
productivity_noun	uwpAxakawA
professional_noun	vyAvasAyika
proficiency_noun	pravINawA
profile_noun	proPAila/rUpareKA
progress_noun	pragawi
project_noun	pariyojanA
projected_noun	xarSAyA_gayA/prakRepiwa
prolonged_noun	xIrGakAlIna
prominent_noun	viSiRta/prawiRTiwa
promotion_noun	pronnawi/paxonnawi
propagation_noun	pracAra/Age_baDZanA/saMcaraNa
proportion_noun	anupAwa
proportional_noun	AnupAwika
prospects_noun	saMBAvanAeM
protection_noun	saMrakRaNa
protective_noun	saMrakRI
protocol_noun	protokoYla
provision_noun	prAvaXAna/upabanXa
provisional_noun	ananwima
proviso_noun	paraMwuka/Sarwa
proximity_noun	sAmIpya/sAnniXya/nikatawA
pull_noun	KiMcAva/karRaNa/KIMcie
pulsation_noun	spaMxana/XadZakana
pulse_noun	spaMxana
pulverisation_noun	pisAI/pIsanA
pulverized_noun	pisA_huA/cUrNiwa
pumping_noun	paMpiMga
purifier_noun	SoXaka
push_noun	Xakelie
quadrant_noun	kvAdretaM/cawurWAMSa
quadrature_noun	samakoNIya_sWiwi
quality_noun	guNavawwA/guNawA
quantisation_noun	kvAntamIkaraNa
quantity_noun	mAwrA/parimANa/rASi
quantum_noun	kvAntama/mAwrA
quartz_noun	sPatika/kvArtja
quasistatic_noun	sWEwikakalpa
quiescent_noun	SAMwa
quotation_noun	xara/koteSana
quotient_noun	BAgaPala
r-c-coupling_noun	Ara.sI._yugmana
radar_noun	redAra
radiation_noun	redieSana/vikiraNa
radius_noun	wrijyA
rail_noun	rela/patarI
raised_noun	uwWApiwa
random_noun	yAxqcCika
rapidly_noun	wejI_se/SIGrawA_pUrvaka
rate_noun	xara
rating_noun	nirXAra
ratio_noun	anupAwa
rational_noun	parimeya/warkasaMgawa
rationalisation_noun	yukwikaraNa
re-energising_noun	punaH_Urjana
re-engineering_noun	punaH_aBikalpana/punaH_iMjIniyarI
re-examine_noun	punaH_parIkRA
reach_noun	aBigama/pahuzca
reactance_noun	prawiGAwa
reaction_noun	prawikriyA/aBikriyA
realization_noun	vasUlI/ugAhI
reamer_noun	pariveXaka/rImara
reappropriate_noun	punarviniyojana
reassessment_noun	punarnirXAraNa
rebound_noun	prawikRepa
receiver_noun	aBigrAhI/risIvara
receptor_noun	grAhI
recess_noun	JirI
reciprocal_noun	anyonya/pArasparika/paraspara
reckoning_noun	gaNanA
reclamation_noun	suXAra/BUmi_uxXAra
reclassification_noun	punarvargIkaraNa
reconcilation_noun	samAXAna
reconsideration_noun	punarvicAra
reconveyance_noun	punaH_haswAMwaraNa
rectification_noun	pariSoXana/xiRtakaraNa
rectifier_noun	xiRtakArI/pariSoXaka
rectify_noun	xiRtakaraNa/saMSoXana
recurrence_noun	punarAvqwwi
recurring_noun	AvarwI/Avarwaka
redemption_noun	vimocana
redistribution_noun	punaH_viwaraNa
redressal_noun	nivAraNa
reduction_noun	kamI/GatOwI/apacayana
redundant_noun	apekRAXika/awirikwa/anAvaSyaka
refundable_noun	prawixeya/lOtAyA_jAne_yogya
refurbishment_noun	punaruxXAra/saMpoRaNa
regeneration_noun	punaH_uwpAxana/punaryojana
region_noun	kRewra
registration_noun	paMjIkaraNa
regulation_noun	viniyama/niyamana/niyaMwraNa
regulator_noun	niyAmaka/niyaMwraka
rehabilitation_noun	punarvAsa
reimbursement_noun	prawipUrwi
reinforce_noun	suxqDZa_karanA/prabaliwa_karanA
reinforcement_noun	prabalana
reinstate_noun	bahAla_karanA/punaH_sWApiwa_karanA
rejection_noun	asvIkaraNa
relay_noun	rile/prawisAraNa
relaying_noun	punaH_biCAnA/rile_karanA/prawisAraNa
release_noun	CodZanA/mukwa_karanA/jArI_karanA/mocana/vimocana
reliability_noun	viSvasanIyawA
relocation_noun	punarsWApana
reluctance_noun	prawiRtaMBa/rilaktesaM
remittance_noun	preRaNa/Xana-preRaNa
remote_noun	xUrasWa/suxUra/rimota
renewal_noun	navIkaraNa
renovation_noun	navInIkaraNa
reorientation_noun	punarvinyAsa
repayable_noun	prawixeya
replacement_noun	prawisWApana
replenish_noun	punaHpUrwi
repugnant_noun	prawikUla/viruxXa
requisition_noun	mAMga/mAMga_pawra
reserved_noun	ArakRiwa
reservoir_noun	jalASaya
reshuffle_noun	Perabaxala
residual_noun	avaSiRta
resin_noun	rAla/rejina
resinoid_noun	rejinoYyada
resistance_noun	prawiroXa/prawiroXaka
resistant_noun	prawiroXI
resistivity_noun	prawiroXakawA
resistor_noun	prawiroXaka
resonance_noun	anunAxa
resources_noun	saMsAXana
responsiveness_noun	anukriyASIlawA
restore_noun	punaH_sWApana
resultant_noun	pariNAmI
retrenchment_noun	CaMtanI
retrieval_noun	punaH_prApwi
return_noun	vivaraNI/prawilABa/prawiPala/vApasa_karanA
revalidation_noun	punarvEXIkaraNa
revaluation_noun	punarmUlyAMkana
revenue_noun	rAjasva
revocation_noun	prawisaMharaNa
revoke_noun	prawisaMharaNa_karanA
rewind_noun	punarlapetana/punaH_kuMdalana
rewirable_noun	punaH_wAra-sWApya
rewiring_noun	punaH_wAra_sWApana
rheostat_noun	vixyuwa_XArA_niyAmaka/riyostEta
ripple_noun	UrmikA/ripala
riser_noun	uxvAhI/rAijZara
rock_noun	cattAna/SEla
rod_noun	SalAkA/roYda/CadZa
roll-up_noun	ekawra_honA
roller-bearing_noun	rolara_beyariMga
roller_noun	belana/rolara
roster_noun	rostara
rotary_noun	GUrNI/rotarI
rotate_noun	GUrNana/GumAnA
rotation_noun	GUrNana
rotor_noun	rotara/GUrNaka
routing_noun	rAUtiMga/anumArgaNa
runner_noun	ranara/patarI/vAhaka/cakrAla
rust_noun	jaMga
safety_noun	surakRA
sag_noun	Jola
sanction_noun	maMjUrI/saMsvIkqwi
sand_noun	bAlU/rewa
satellite_noun	upagraha/sEtelAita
saturation_noun	saMwqpwawA/saMwqpwi
scale_noun	mAna/swara/xarjA/pEmAnA/papadZI
scaling_noun	anumApana/papadZI_jamanA
scan_noun	bArIka_jAMca_karanA/skEna
schedule_noun	anusUcI
schematic_noun	yojanAbaxXa
scheme_noun	yojanA
scope_noun	kArya_kRewra/pariXi/viswAra/vyApwi/avasara
screening_noun	CAnabIna/CAnanA
screw_noun	pecaM
scrutiny_noun	saMvIkRA/CAnabIna
sealed_noun	mohara_baMxa
seamless_noun	jodZa_rahiwa/sIvanahIna
security_noun	surakRA/prawiBUwi
sediment_noun	avasAxa/walaCata
sedimentation_noun	avasAxana/walaCatIkaraNa
seepage_noun	risAva/risana/Ava
segment_noun	KaMda
segregation_noun	pqWakkaraNa
self-appraisal_noun	svamUlyAMkana
self-contained_noun	svawaH_pUrNa
self-explanatory_noun	svawaH_spaRta
semi-skilled_noun	arXa-kuSala
sensitive_noun	saMvexanaSIla/sugrAhI
separation_noun	pqWakkaraNa/viyojana
series_noun	kramika/SrqMKalA/SreNI
set_noun	jamAva/seta
setting_noun	jamanA/xqDZIkaraNa/vinyAsa/avasWApana
shaded_noun	CAyAMkiwa/CAyiwa/CAxiwa
shaft_noun	SoYPta/XurA/swaMBa
shear_noun	aparUpaNa
sheave_noun	GiranI/caraKI
shell_noun	Kola/kavaca/AvaraNa
shield_noun	kavaca/SIlda
shipment_noun	laxAna/Kepa
shock_noun	praGAwa
shunt_noun	pArSva_paWa
shutter_noun	kapAta/Satara
signal_noun	saMkewa/siganala
silt_noun	gAxa/silta
silting_noun	gAxana
simulation_noun	anukAra/simuleSana
simulator_noun	anukAraka/simuletara
sinking_noun	XaMsanA
site_noun	pariyojanA_sWala/kAryasWala
skew_noun	wiraCA/wiryaka
skirting_noun	kinArI
slew_noun	xruwa_GUrNana/slayU
slide_noun	slAida/sarpaka
sliding_noun	sarpaNa
slip_noun	sarpaNa/slipa/parcI
slippage_noun	visarpaNa/Pisalana
slope_noun	DalAna
sludge_noun	avapaMka
slurry_noun	Gola/gArA
socket_noun	soYketa
solid_noun	Tosa
solitium_noun	soYliSiyama
solvent_noun	vilAyaka/Golaka
specialised_noun	viSiRta
specifications_noun	vinirxeSa
speed_noun	gawi/cAla
sphere_noun	golA
spillage_noun	CalakAva
spillway_noun	spilave/aXiplava_mArga
split_noun	viBakwa/vipAtiwa
spring_noun	kamAnI/sprigaM
sprinkle_noun	CidZakAva
squeezed_noun	nipIdiwa
stability_noun	sWAyiwva
stack_noun	cimanI
stage_noun	caraNa/sWiwi
standard_noun	mAnaka
standardisation_noun	mAnakIkaraNa
standby_noun	ApAwa_upayogI
starter_noun	stArtara/pravarwaka
stator_noun	stetara
steam_noun	BApa/vARpa
stepping_noun	pEdZI_banAnA
stiffness_noun	xqDZawA/kadZApana
stimulate_noun	uxxIpwa_karanA
stimulation_noun	uxxIpana
stipulated_noun	anubaxXa/nirxiRta/nirXAriwa
storage_noun	saMgrahaNa/BaMdAraNa/saMcayana
strata_noun	saMswara
stream_noun	XArA
stress_noun	prawibala
stretch_noun	KiMcAva/PElAva
string_noun	ladZI/SrqMKalA/rajju
strip_noun	pattI/pawwI
stroke_noun	AGAwa/stroka
structure_noun	DAMcA/saMracanA
studding_noun	jadZA_huA
sturdiness_noun	SakwimawwA
sub-system_noun	upa-waMwra
submerged_noun	nimajjiwa/dUbA_huA/jalamagna/nimagna
subsidiary_noun	sahAyaka
subsidy_noun	imaxAxa/ArWika_sahAyawA
substandard_noun	avamAnaka
substitute_noun	evajI/sWAnApanna/prawisWApana
succeeding_noun	anuvarwI/uwwaravarwI
sullage_noun	avajala
sundry_noun	Putakara/viviXa
superficial_noun	UparI/bAharI/sawahI
supersession_noun	aXikramaNa
supervision_noun	paryavekRaNa/xeKareKa
supplementary_noun	pUraka/anupUraka
support_noun	Alamba/AXAra/teka
surcharge_noun	aXiBAra
surety_noun	jamAnawa/prawiBU
surface_noun	sawaha/pqRTa
surge_noun	sarja/prowkarRa
surplus_noun	aXiSeRa/awirikwa
surrounding_noun	pariveSa
survey_noun	sarvekRaNa
sustain_noun	banAe_raKanA
sustainable_noun	XAraNIya/sawawa
sustained_noun	sawawa/avirawa
sweep_noun	prasarpa/sAPa_karanA
switchyard_noun	svicayArda
symmetry_noun	samamiwi
symposium_noun	parisaMvAxa
synchronisation_noun	wulyakAlana/siMkronAijZaSane
synergy_noun	sahakriyA/sinarjI
synopsis_noun	sArAMSa/rUpareKA
synthetic_noun	kqwrima/sAMSleRika
syphon_noun	sAiPana
system_noun	praNAlI/paxXawi/waMwra
systematic_noun	kramabaxXa/vyavasWiwa
t-beam_noun	j-Xarana
taper-bearing_noun	tepara_beyariMga
target_noun	lakRya
technical_noun	wakanIkI/prAviXika
technology_noun	prOxyogikI
tele-communication_noun	xUra-saMcAra
temperature_noun	wApa/wApamAna
tendency_noun	pravqwwi
tender_noun	nivixA/tedaraM
tensile_noun	wanana
tension_noun	wanAva
tensioned_noun	waniwa
tentative_noun	anaMwima
tenure_noun	kAla-avaXi
term_noun	miyAxa/avaXi
terminal_noun	tarminala/anwasWa/anwima
terrace_noun	bArajA/Cawa
tetrode_noun	tetroda
texture_noun	gaTana/banAvata
theoretical_noun	sExXAMwika
thermal_noun	wApIya
thermodynamics_noun	URmAgawikI/URmAgawi_vijFAna
thermometer_noun	wApamApI/WarmAmItara
thickness_noun	motAI/sWUlawA
throttle_noun	uparoXa
thrust_noun	praNoxa
thyristor_noun	WAiristara
tightness_noun	kasAva
tool_noun	OjAra
torque_noun	balAGUrNa
toxic_noun	viRAkwa
tracing_noun	anureKaNa/pawA_lagAnA
transaction_noun	lena-xena
transducer_noun	trAMsadyUsara
transformer_noun	trAMsaPArmara/pariNAmiwra/tAMsaPoYrmara
transistor_noun	trAMjistara
translucent_noun	pAraBAsI
transmission_noun	pAreRaNa/saMcaraNa
transmit_noun	BejanA/preRiwa_karanA/saMcAriwa_karanA
transmitter_noun	trAMsamitara/preRiwra
transparent_noun	pAraxarSI
transponder_noun	trAMsapodara/preM_RAnukara
transportation_noun	parivahana/aBigamana/DulAI
transreceiver_noun	aBigrAhI/trAMsarisIvara
transverse_noun	anuprasWa/AdZA
trap_noun	jAla/PaMsanA/pASa
treatment_noun	upacAra
trench_noun	KAI
trend_noun	pravqwwi/JukAva/ruJAna
trespass_noun	anaXikAra_praveSa
trial_noun	parIkRaNa
tributary_noun	sahAyaka_naxI
trim_noun	katAI-CatAI
trip_noun	tripa/vimocana
tuning_noun	samasvaraNa/tyUniMga
tunnel_noun	suraMga/tanala
turbine_noun	tarabAina
turnkey_noun	tarnakI/AxyopAMwa
turnover_noun	kArobAra/tarnaovara
twisting_noun	ETana/maroM_dZanA
ultimately_noun	aMwawaH
unaudited_noun	anaMkekRiwa/aleKAparIkRiwa
underground_noun	BUmigawa
undertaking_noun	upakrama/vacanapawra
unearthed_noun	BUsaMparka_rahiwa
unelecrified_noun	avixyuwIkqwa
uneven_noun	asama/viRama/asamawala
unified_noun	ekIkqwa
uniform_noun	ekasamAna/varxI
unilateral_noun	ekapakRIya
uninterrupted_noun	nirbAXa/sawawa/avirawa
unique_noun	axviwIya
unit_noun	ikAI/ekaka/ekAMka
unlawful_noun	viXiviruxXa/gEra-kAnUnI
unqualified_noun	ayogya/anarhaka
unsaturated_noun	asaMwqpwa
unskilled_noun	akuSala
updation_noun	axyawanIkaraNa
uplift_noun	uwWAna
uprating_noun	unnayana/aparetiMga
upstream_noun	uparipravAha/apastrIma
upward_noun	UrXvamuKI
utilities_noun	yUtilitIja
utilization_noun	upayoga
v-belt_noun	ta-belta
v-curve_noun	ta-vakra
v-notch_noun	ta-noYca
vacuum_noun	nirvAwa/SUnya
valid_noun	viXimAnya/vEXa
validity_noun	vEXawA/viXi_mAnyawA
valuation_noun	mUlyAMkana
value_noun	mUlya/mAna
valve_noun	vAlva
vane_noun	vena/PalikA
vapour_noun	vARpa
vapourisation_noun	vARpana
variability_noun	parivarwanIyawA
variable_noun	parivarwanaSIla/parivarwI
velocity_noun	vega
ventilation_noun	saMvAwana
verification_noun	sawyApana/sAkRyAMkana
vertex_noun	SIrRa
vertical_noun	UrXvAXara
vetting_noun	punarIkRaNa
viability_noun	vyavahAryawA
vibrant_noun	kaMpAyamAna/spaMxanaSIla
vibration_noun	kaMpana
vibrator_noun	vAibretara/kaMpiwra
vigorous_noun	prabala
violation_noun	ullaMGana
viscosity_noun	SyAnawA/gADZApana
vision_noun	vijana
void_noun	rikwi/ranXra/SUnya_(viXi)
volt_noun	volta
voltage_noun	voltawA/viBava
voltmeter_noun	voltamApI/voltamItara
volume_noun	Ayawana/KaMda/mAwrA
wastage_noun	CIjana/apavyaya
watt-hour_noun	vAta-oYvara/vAta-GantA
watt_noun	vAta
wattmeter_noun	vAtamApI/vAtamItara
wave_noun	waraMga
wavelength_noun	waraMgaxErGya
weightage_noun	mahawva/bala/BAra
weir_noun	viyara
winch_noun	vinca/carKI
winding_noun	vAiMdiMga/kuMdalI
wire_noun	wAra
wireless_noun	bewAra/vAyaralesa
wiring_noun	wAra_lagAnA/vAyariMga
wrench_noun	riMca
xyloid_noun	kARTIya
xyster_noun	KuracanI
yardstick_noun	mAnaxaMda
yield_noun	labXi/upaja/pExAvAra
zenith_noun	caramasImA
zinc_noun	jaswA
