#it dictionary extracted by Monika Sharma. Formatted by Roja (26-01-2016)
#Changes:: 1) Separated single word and multi words into separate dictionaries
#          2) English words are converted to lower case
#          3) Added category as 'noun' by default
###############################################################################
a-transducer_noun	e_trAMsdyUsara
abacus_noun	ebekasa/ginawArA
abandon_noun	pariwyAga
abnormal_noun	apasAmAnya
abort_noun	viPalana
absolute_noun	nirapekRa
abstract_noun	amUrwa
abstraction_noun	amUrwana
accent_noun	svarAGAwa/balAGAwa
accept_noun	sxyAIkAra
access_noun	aBigama
accessory_noun	sahayaMwra
account_noun	leKA
accounting_noun	leKA_kArya/leKAMkana
accumulator_noun	saMcAyaka
accuracy_noun	pariSuxXawA/yaWArWawA
acm_noun	e_sI_ema
acronym_noun	parivaNIr_Sabxa/saMkRipwa_rUpa/laGu_rUpa
action_noun	kriyA
activation_noun	sakriyaNa
activator_noun	sakriyaka
active_noun	sakriya
activity_noun	sakriyawA
actuator_noun	pravarwaka
acyclic_noun	acakrIya
adaptability_noun	anukUlanIyawA
adapter_noun	anukUlaka/anukUliwra
adaptive_noun	anukUlaka
addend_noun	yojya
adder_noun	yojaka
addition_noun	yoga/saMkalana
address_noun	pawA/saMboXana
addressability_noun	pawAyogyawA/saMboXanIyawA
addressable_noun	pawAyogya
addressing_noun	pawABigamana/(pawA_aBigamana)
addressless_noun	pawArahiwa
adj_noun	e_dI_je
adjacency_noun	saMlagnawA/AsannawA
adjoint_noun	saMlagna
adjudication_noun	aXinirNayana
adjust_noun	samAyojana
admin_noun	praSAsana
administrative_noun	praSAsanika
administrator_noun	prabaMXaka
adopter_noun	anukUlaka
adp_noun	e_dI_pI
advantage_noun	lABa
advertising_noun	vijFApana
aerial_noun	eriyala
agent_noun	karmaka
aggregate_noun	samuccaya
aggregation_noun	samuccayana
alarm_noun	sacewaka
alert_noun	sacewa
algol_noun	ElgoYla
algorithm_noun	algorixma/kalana_viXi
alias_noun	eliAsa/upanAma/urPa
aliasing_noun	eliAsana
alignment_noun	sareKaNa
aliweb_noun	Eliveba
allies_noun	sahayogI
allocate_noun	niyawana
allocation_noun	AvaMtana/niyawana
alpha_noun	ElPA
alphabet_noun	vaNArkRara/akRara
alphabetic_noun	akRarAwmaka/vaNArnukrima
alphabetization_noun	vaNArnukramaNa
alphageometrics_noun	vaNArjyAmiwikI/akRarajyAmiwikI
alphamosaic_noun	alPAmojZeka
alphanumeric_noun	akRarAMkIya
alt_noun	Alta
altavista_noun	EltAvistA
altering_noun	parivarwana
alternation_noun	prawyAvarwana
alternet_noun	Eltaraneta
ambiguity_noun	saMxigXawA
amiga_noun	emigA
amoeba_noun	amIbA
ampersand_noun	emparaseMda
amplitude_noun	AyAma
analog_noun	anurUpa/enAloYga
analogous_noun	anurUpa
analysis_noun	viSleRaNa
analyst_noun	viSleRaka
analytic_noun	viSleRaNAwmaka
anarchy_noun	arAjakawA
anchor_noun	laMgara/eMkara
and_noun	eNda
angle_noun	koNa
angstrom_noun	EgstrAma
animation_noun	enImeSana
annotation_noun	tippaNa
annoybot_noun	enoYyaboYta
annunciator_noun	AKyApiwra/AKyApaka
anomalies_noun	asaMgawi
anonymity_noun	anAmikawA_gumanAmI
ansi_noun	e._ena._esa._AI._(amarIkI_rARtrIya_mAnaka_saMsWA)_ena_sI
antecedent_noun	pUrvavarwI
antenna_noun	EntenA
anti-glare_noun	prawi_cOMXa
anticedent_noun	pUrvavarwI
aol_noun	e_o_ela
apl_noun	e_pI_ela
append_noun	jodZanA
apple_noun	epala
applet_noun	epaleta_anuprayogikA
application_noun	anuprayoga
applique_noun	aXiropaNa
arbitration_noun	maXyasWawA
arc_noun	Arka
archie_noun	ArcI
architecture_noun	vAswukalA/sWApawyakalA
archive_noun	purAleKa
archiving_noun	purAleKaNa
area_noun	kRewraPala/kRewra
arena_noun	kRewraka/erenA
argument_noun	prAcara
aris_noun	Erisa
armm_noun	e_Ara_ema_ema
arpanet_noun	arapAneta
array_noun	sAraNI
article_noun	leKa/vaswu
artifact_noun	virUpaNa_sAkRya
artificial_noun	kqwrima
asbestos_noun	ebestoYsa
ascender_noun	Arohaka
ascending_noun	ArohI
ascii_noun	AskI
ascription_noun	Aropana
askeric_noun	wAraka
aspect_noun	aBimuKawA
aspi_noun	EspI
asseble_noun	smarAMwaraka
assemble_noun	kodAMwaraNa/kodAMwara_karanA
assembler_noun	smarAMwaraka/kodAMwaraka
assembling_noun	kodAMwaraNa
assembly_noun	kodAMwaraNa
assertion_noun	niScayana
assignment_noun	nirxiRtIkaraNa
association_noun	saMGaTana/sAhacarya
associativity_noun	sahacAriwA
assumption_noun	kalpanA/grahana/anumAna
asymmetry_noun	asamamiwi
asynchronous_noun	awulyakAlika/awulyakAlI
athene_noun	eWena
atom_noun	paramANu
atomic_noun	kRawipUrNa
attachment_noun	saMlagnaka
attennation_noun	kRINana
attenuation_noun	kRINana
attenuator_noun	kRINakArI
attribute_noun	guNa
attribution_noun	guNa
attributor_noun	guNaxAyaka
audio_noun	Sravya
auditions_noun	SravaNa
augment_noun	saMvarXa
augmentation_noun	saMvarXana
augmenter_noun	saMvarXaka
author_noun	saMleKaka
authoring_noun	saMleKana
authority_noun	prAXikAra
authorization_noun	prAXikaraNa
autoalising_noun	raciwa_svawa:_eliyAsIkaraNa
autoflow_noun	svawa:_pravAha
automata_noun	oYtometA
automatic_noun	svacAliwa/sva/svawa:
automatically_noun	svawa:
automation_noun	svacAlana
automatisation_noun	svacAlanIkaraNa
automoniter_noun	svamoYnitara
autoplay_noun	oYtople
autoplotter_noun	svawa:AleKaka/svawa:ploYtara
autosave_noun	svarakRaNa
autoselect_noun	svawa:_cayana/svacayana
autotrace_noun	svawa:_anureKA/svawa:_anureKa
aux_noun	e_yU_eksa
auxiliary_noun	sahAyaka
availability_noun	upalabXawA
average_noun	Osawa
awk_noun	oYka
b-tree_noun	bI_vqkRa/bI_warU
back_noun	paSca
background_noun	pqRtaBUmi
backgrounding_noun	pqRtaBUmikaraNa
backspace_noun	paScIyana/bEkaspesa
backspacing_noun	paScIyana
backtracking_noun	paScaanumArgaNa
backup_noun	bEka-apa/pUrwikara
balance_noun	saMwulana/SeRa/wulana
balanced_noun	saMwuliwa
balloon_noun	bElUna
band_noun	pattI/bEMda
bar_noun	bAra/reKikA
base_noun	AXAra
basic_noun	besika
batch_noun	pracaya/bEca/samUha
batching_noun	pracayana
baud_noun	boYda
bcc_noun	bI_sI_sI
bcnf_noun	bI_sI_ena_ePa
beam_noun	kiraNa_puMja
begin_noun	prAraMBana
behavior_noun	vyavahAra
benchmark_noun	nirxeSamAnaka/vEMcamArka
bibliography_noun	graMWa_sUcI
bijection_noun	xviaMwa:kRepaNa
binder_noun	bAMXane_vAlA/baMXaka
binding_noun	bAMXanA/baMXana
bios_noun	boYyasa
bisynchronous_noun	xviwulyakAlika
bit_noun	xvayaMka/bita
blinking_noun	timatimAnA
block_noun	blAka/avaroXI
bmp_noun	bI_ema_pI
board_noun	borda
bomb_noun	bama
book_noun	kiwAba/puswaka
bookmark_noun	pqRTa_smqwi
boolean_noun	bUliyana
bounded_noun	paribaxXa/paribaMXiwa
box_noun	boYMksa/petI
bridge_noun	sewu/brija
bridges_noun	sewu
brightness_noun	xyuwi
broadcast_noun	prasAraNa
browse_noun	svaxeSa_vicaraNa/pqRTa_palatanA
browser_noun	vicaraka
bucket_noun	bAltI
budgets_noun	bajata
buffer_noun	baPara
bug_noun	xoRa
bulletproof_noun	buletaprUPa
bus_noun	basa
business_noun	vyavasAya
byte_noun	aRta-xvayaMka/bAita
c++_noun	sI_plasa_plasa
c_noun	sI
cable_noun	kebala
cache_noun	kESa/xruwikA
calculation_noun	parikalana
calculator_noun	kElakuletara/parikalaka
call_noun	AhvAna
cancel_noun	niraswa_karanA/raxxa_karanA
canonical_noun	vihiwa/kanonikala
capability_noun	kRamawA
capacitor_noun	saMXAriwra
capacity_noun	kRamawA/XAriwA
capital_noun	pUzjI/mUlaXana
card_noun	kArda/pawraka
cardinality_noun	pramuKawA
carrier_noun	vAhaka
carry_noun	hAsila
cascade_noun	kAskeda/sopAnI
case_noun	kesa
cassette_noun	kEseta
catalogue_noun	sUcI
catenation_noun	SrqMKalana
cell_noun	koSikA/sela
cfg_noun	sI_ePa_jI
chain_noun	SrqMKalA
chaining_noun	SrqMKalana
channel_noun	praNAla/cEnala
character_noun	saMprawIka
characteristic_noun	aBilAkRaNika
chart_noun	saMciwra
chassis_noun	nyAXAra_samanvAyojana
chip_noun	cipa
chmod_noun	sI.eca_modraparivarwanavixyA
choice_noun	vikalpa
choose_noun	cayana
chromatically_noun	vArNika_rUpa_se
chromaticity_noun	vArNikawa:
cipher_noun	sAiPara
ciphertest_noun	kUtrakuta_parIkRaNa
circuit_noun	paripaWa
circulators_noun	parisaMcAraka
cirus_noun	sAyarasa
cisc_noun	siska
citation_noun	ulleKa
claims_noun	xAvA
class_noun	SreNI/varga
classification_noun	vargIkaraNa
clear_noun	apamArjana
click_noun	klika
client_noun	grAhaka
clipper_noun	klipara
clipping_noun	karwana
clique_noun	guta
clock_noun	GadZI/kAlaxa
clocking_noun	kAla_saMkajana
clone_noun	klona
close_noun	banxa
closed_noun	saMvqwa
closure_noun	saMvaraNa
cluster_noun	gucCa
clustering_noun	gucCana
co-scheduling_noun	saha_anusUcana
coax_noun	samAkRa
coaxial_noun	samAkRIya
cobol_noun	kobola
codasyl_noun	kodAsila
code_noun	kUta/koda
coder_noun	kodaka
coefficient_noun	guNAMka
coherence_noun	saMsajana
collaboration_noun	sahayoga
collaboratory_noun	sahayogI
collapse_noun	nipAwa
collision_noun	takkara
colon_noun	kolana
colour_noun	varNa/raMga
column_noun	swaMBa
com_noun	koma/vyavasAyika_sWala
combination_noun	saMyojana
combinatorics_noun	sAhacarya
comma_noun	kOmA/alpavirAma
command_noun	samAxeSa/kamAMda
comment_noun	tippaNI
commitment_noun	vacana_baxXawA/prawibaxXawA
commodity_noun	vaswu
compaction_noun	saMhanana/saMGanana
companding_noun	saMpIda_prasAraNa
compandor_noun	saMpIda_prasAriwra
compatibility_noun	susaMgawi/saMgawawA
compatible_noun	susaMgawa
compilation_noun	saMkalana
compile_noun	saMkalana_karanA
compiler-compiler_noun	saMkalana_saMkalana
compiler_noun	saMkalaka/kramAxeSa_amwaraka
compilor_noun	kramAxeSa_aMwaraka
complement-on-nine_noun	nO_pUraka
complement-on-one_noun	eka_pUraka
complement-on-ten_noun	xasa-pUraka
complement-on-two_noun	xo_pUraka
complement_noun	pUraka
complementary_noun	pUraka
complementer_noun	pUraka
complementing_noun	pUrakIkaraNa
complex_noun	jatila
component_noun	Gataka
composite_noun	saMyukwa
composition_noun	saMyojana
computer-dependent-language_noun	kaMpyUtara_AXAriwa_BARA
computer_noun	kaMpyUtara
computerability_noun	kaMpyUtara_nIyawA
computerist_noun	kaMpyUtaravixa
computerization_noun	kaMpyUtarIkaraNa
computerize_noun	kaMpyUtarIkaraNa_karanA
concalivation_noun	saMGatta_viBexana
concatenation_noun	SrqMKalAbaMXana/saMyojana
concentration_noun	saMkenxraNa
concept_noun	saMkalpanA
concordance_noun	susaMgawawA
concordant_noun	susaMgawa
concurrency_noun	samarUpawA/sahasaMgawA/saMgamana
concurrent_noun	saMgAmI/samarUpI
conductor_noun	cAlaka
conferencing_noun	xUra_sammelana
confidentiality_noun	gopanIyawA
configuration_noun	vinyAsa
confirmation_noun	saMpuRti
congestion_noun	saMkulana
conjecture_noun	anumAna/kalpanA
conjunction_noun	saMyojana
connected_noun	saMbaMXiwa
connection_noun	saMbaMXa
connectivity_noun	saMyojakawA
connector_noun	saMbaMXaka/yojaka
consecutive_noun	kramAgawa
consequent_noun	anuvarwI
consistency_noun	susaMgawi
console_noun	kansola
consolidation_noun	samekana
consolidator_noun	samekaka
constant_noun	niyawAMka/sWirAMka
constraint_noun	prawibaMXiwa
constructor_noun	saMracaka
consummable_noun	upaBogya_sAmagrI
container_noun	pAwra
content_noun	aMwarvaswu/aMSa
contention_noun	prayoga_prawisparXA
context-sensitive_noun	saMxarBa_sugrAhI
context_noun	saMxarBa
contingency_noun	Akasmika/AkasmikawA
contraction_noun	saMkucana
contradiction_noun	visaMgawi/viroXa
contrast_noun	viparyAsa_vyawireka
contribution_noun	aMSaxAna
control_noun	niyaMwraNa
convergence_noun	aBisAriwA
conversation_noun	saMvAxa
conversational_noun	saMvAxI
converse_noun	uwkrama/viloma
conversion_noun	rUpAMwaraNa
converter_noun	parivarwaka
coprocessor_noun	saha-prakramaka
copy_noun	prawilipi
copyright_noun	sarvAXikAra
cord_noun	koYrda
corelated_noun	sahasambaxXa
corollary_noun	upaprameya
correction_noun	saMSoXana
corrupted_noun	anupayogI/BqRta
coset_noun	sahasamuccaya
costs_noun	lAgawa
count_noun	gaNanA
countable_noun	gaNanIya
counter_noun	gaNiwra
covariance_noun	sahaprasaraNa
cover_noun	AvaraNa/AcCAxana
coverage_noun	vyApwi_kRewra/praRAraNa
covering_noun	AvaraNa/AcCAxana/parASa
cpm_noun	sI._ema._ema._(krAMwika_paWa_viXi)
crash_noun	XvaMsa
create_noun	racanA/sqjana
credit_noun	jamA/sAKa/uXAra
cropping_noun	xqSyAMSana
crt_noun	sIAratI
cryptographic_noun	gUDZAleKI
cryptography_noun	gUDZaleKana/gUDaleKikI/kriptogrAPika
cursor_noun	karsara
curve_noun	vakra
cyber_noun	sAibara
cybernatics_noun	sAibaranetiksa
cybernation_noun	sAibaraneSana
cycle_noun	cakra
cyclic_noun	cakrIya
daemon_noun	demoYna
database_noun	detAbesa
datagram_noun	AMkadZAreKa
datum_noun	detama/AMkadZA
deadlock_noun	gawiroXa
debenture_noun	qNapawra
debt_noun	nAme/debita
debtors_noun	qNI/xenaxAra/karjaxAra
debug_noun	xoRamArjana
decoder_noun	kUtavAcaka/vikodaka
decrypt_noun	vigUDZa/vikoda
decryption_noun	vikodana
definition_noun	pariBARA
defragmentation_noun	ekIkaraNa
delay_noun	vilaMba
delete_noun	mitAnA/hatAnA
delimiter_noun	apasImaka/parisImaka
delta_noun	deltA
demand_noun	mAMga
demo_noun	praxarSana
demodulation_noun	vimoYdulana
demodulator_noun	vimoYdulaka
demount_noun	vyAropaNa
demultiplexer_noun	vibahusaMkewaka
demultiplexing_noun	vibahusaMkewana
denormalization_noun	asamAnyIkaraNa
density_noun	Ganawva/saGanawA
dependency_noun	ASriwA/nirBarawA
deprecate_noun	viroXa_karanA
depreciation_noun	avamUlyana
deproceduring_noun	apa_prakriyana
depth_noun	gaharAI
dequeue_noun	vipaMkwi
dereferencing_noun	apanirxeSana/apasaMxarBana
derivation_noun	vyuwpawwi
derived_noun	vyuwpanna
descendant_noun	avarohI
descriptor_noun	vivarNaka/varNanakarwA
design_noun	aBikalpa
desktop_noun	deskatoYpa
despatch_noun	preRaNa
despatcher_noun	preRaka
destination_noun	gaMwavya
destructor_noun	vinASaka
detail_noun	viswAra
deterministic_noun	nirXAraNAwmaka/niScayAwmaka
detraction_noun	apakarRaNa
developer_noun	vikAsaka
device_noun	yukwi
dfa_noun	dI_ePa_e
diagnosis_noun	nixAna
diagnostics_noun	nixAna/nixAnikI
diagonalization_noun	vikarNana
diagram_noun	AreKa
dial-up_noun	dAyalana
dial_noun	dAyala
dialog_noun	saMvAxa/vArwAlApa
dictionary_noun	SabxakoSa
difference_noun	Bexa/aMwara
differentiation_noun	avakalana
differentiator_noun	avakalaka
digit_noun	aMka
digital_noun	aMkIya
digitization_noun	aMkarUpaNa
digitize_noun	aMkIkaraNa
digitizer_noun	aMkarUpaka
digraphs_noun	xvi_AleKa/xvi_leKAciwra
dimension_noun	vimA
dimensionality_noun	vimIyawA
diodes_noun	dAyod
direct-access_noun	prawyakRa_aBigama
direct_noun	prawyakRa
directive_noun	nixeSa
director_noun	nixeSaka
directory_noun	nixeSaka
disable_noun	asamarWa
disassembler_noun	vikoMdAwaraka
disconnect_noun	asaMbaMXana/visaMbaMXana
discrete_noun	asaMwawa/asawawa/vikkwi
disjoint_noun	asaMyukwa/asaMXi
disjunction_noun	aMsaMyojana/viyojana
disk_noun	cakrikA/diska
diskette_noun	disketracakrie
disposal_noun	nipatAna
distance_noun	xUrI
distortion_noun	virUpaNa
distributed_noun	viwariwa
distribution_noun	viwaraNa
distributive_noun	viwaraka
divisor_noun	BAjaka
dml_noun	dI_ema_ela
document_noun	praleKa
documentation_noun	praleKana
domain_noun	domena/prakRewra
donominator_noun	hara
dos_noun	doYsa
down_noun	aXo/nIce
downloading_noun	aXIBAraNa
dragging_noun	karRaNa
dram_noun	dI_rEma
drift_noun	aPavAha
driver_noun	cAlaka
drop_noun	pAwa
dual_noun	xvEXa/xvi
dump_noun	sannikRepa
duplexing_noun	xvEXIkaraNa
dynamic_noun	gawika
dynamics_noun	gawivijFAna/gawikI
e-business_noun	IvyavasAya
e-commerce_noun	IkAmarsa/IvANijya
e-mail_noun	ilektroYnika_mela
ebcdic_noun	ibIsIdIAIsI
echo_noun	prawiXvani
echoing_noun	gUMja/anugUMjana/prawiXvaniyana
edge_noun	kora
edit_noun	saMpAxana
editor_noun	saMpAxaka
eeprom_noun	iipI_roYma
electronics_noun	ilektroYnikI
element_noun	wawva/avayava
elements_noun	avayava
embedded_noun	aMwa:sWApiwa
emulation_noun	yaMwrAnukaraNa/yaMwrAnukAraka
encapsulation_noun	kEpsUlana/kEpsUlIkaraNa
encipher_noun	kUtaleKana
encode_noun	kUtaleKana
encoder_noun	kUtaleKaka/kodaka
encoding_noun	kUtaleKana
encryption_noun	gopana
endmarker_noun	aMwya_cinhka
enter_noun	praveSa
entity_noun	sajFalwava
enumerable_noun	gaNanIya
environment_noun	pariveSa
eprom_noun	I-proYma
equalizer_noun	wulyakAraka
equipment_noun	upaskara
erase_noun	vyAmArjana/mitAna
erd_noun	I_Ara_dI
event_noun	GatanA
exception_noun	apavAxa
exclusion_noun	apavarjana
exclusive-or_noun	ananya_aWavA
execute_noun	niRpAxana
exist_noun	vixyamAna
exit_noun	nirgama
explicit_noun	suspaRta
explore_noun	anveRaNa_karo
expression_noun	aBivyakwa
extension_noun	viswAra
extent_noun	sImA/viswAra
extermination_noun	unmUlana
external_noun	bAhya
extract_noun	niRkarRa
extraction_noun	niRkarRaNa
facility_noun	suviXA
facsimile_noun	prawikqwi
factor_noun	kAraka
fan-in_noun	niveSAMka
fan-out_noun	nirgawAMka
feasible_noun	sAXya
feature_noun	lakRaNa
feflesive_noun	aprawibarwI
fetch_noun	Anayana
field_noun	kRewra
file_noun	saMcikA
filter_noun	Piltara/nispaMxaka
filtering_noun	nispaMxana/Piltarana
find_noun	anveRaNa/Koja
firmware_noun	Parma_veara
flag_noun	pawAkA/cinhana
flowchart_noun	pravAha_saMciwra
flowcharting_noun	pravAha_saMciwraNa
fluctuation_noun	uccAvacana
flush_noun	sapAta/praXAvana
flyback_noun	prawiXAvana/prawiXAva
focussing_noun	keMxrIyaNa
folder_noun	Poldara
folding_noun	valana
font_noun	PAMEYnta
foot_noun	pAxa/Puta
footer_noun	paxAMwa
footprint_noun	pAxa_muxraNa
forest_noun	vana
forgery_noun	XoKA_XadZI
fork_noun	viSAKa
form_noun	rUpa/pqRTa
format_noun	PEYArameta/saMrUpa/PoYmerta
formatting_noun	saMrUpaNa
fortran_noun	PoratroYna
fractal_noun	AMSika
fragment_noun	KaMda
fragmentation_noun	viKaMdana/KaMdana
frame_noun	Prema
framing_noun	Premana/swaMBa_sarjana
fredmail_noun	Predamela
free-net_noun	mukwa_neta
freeware_noun	PrIveyara
frequency_noun	Avqwi/bAraMbArawA
function_noun	prakArya/Palana
garbage_noun	kacarA
gate_noun	xvAra
gateway_noun	xvAra
generalization_noun	vyApakIkaraNa
get_noun	gEta
glitch_noun	glica/vyavaXAna
global_noun	sArvawrika/viSvIya
gnu_noun	jI_ena_yU
go_noun	jAnA
gopher_noun	goPara
grammar_noun	vyAkaraNa
graph_noun	grAPa
graphics_noun	AleKI
grep_noun	grepa
grid_noun	grida
group_noun	samUha
groupware_noun	samUha_veyara
growth_noun	vqixxa
guard_noun	rakRaka/gArda
gunzip_noun	ganajipa
hack_noun	anAXikArI_praveSa
hacker_noun	GusapETiyA
half-adder_noun	arXa_yojaka
half-substracter_noun	arXa_vyavakalaka
half-word_noun	arXa_Sabxa
hand_noun	haswa
handle_noun	mUTa/hEMdala/hawWA
hang_noun	nilaMbana
hard-wired_noun	yaMwrasWa
hash_noun	xruwAnveRaNa
hat_noun	topI
having_noun	raKanA
header_noun	hEdara/praveSikA
heap_noun	puMja/Dera
height_noun	UMcAI
hello_noun	helo
help_noun	sahAyawA
hertz_noun	hartajZa
heterogeneity_noun	viRamAMgawA
heterogeneous_noun	viviXa/viRamAMgI
heuristic_noun	anumAnI
hexadecimal_noun	RodaSa_AXArI
hightness_noun	MUEYMcAI/uccawA
hit_noun	prApwi_samBAvanA
homogeneous_noun	samAMgI
homomorphism_noun	samarUpawA
hop_noun	hoYpa
horn_noun	hoYrna
host_noun	poRaka
hotbot_noun	hoYtavAta
hypercube_noun	awivima
hypothesis_noun	parikalpanA
identical_noun	samarUpa/waxrUpa
identifier_noun	parijFApaka
identity_noun	wawsamaka/vyaRtiwva/sarvasamikA
image_noun	prawibiMba
impedence_noun	prawibAXA
in-fix_noun	awa:_lagna
inclusion_noun	aMwaverSana
inconsistency_noun	asNaMwawA
increment_noun	vqxXi
indent_noun	inateMda
index_noun	sUcaka
informatics_noun	sUcanA_vijFAna
information_noun	sUcanA
inheritance_noun	vaMSAnukrama/vaMSAnugawawA/vaMSAgawi
initial_noun	AraMBika/prAWamika/Axima
initialization_noun	AraMBIkaraNa/prAAraMMBikIkaraNa
innumerable_noun	asaMKya
insert_noun	niveSa/niveSana
instance_noun	xqRtAMwa
instruction_noun	anuxeSa
integrator_noun	samakalaka/samAkalaka
integrity_noun	sawyaniRTA/aKaMdawA
interaction_noun	anayonyakriyA
interface_noun	aMwarAPalaka
interleave_noun	anwa:pawraNa_karo
interleaving_noun	aMwagraMWana/aMwa:pawraNa
internet-draft_noun	iMtaraneta_drAPta
internet_noun	aMwarAjAla/iMtaraneta
internetworking_noun	parisaMcAlana
interpolation_noun	anwaverSana
interpret_noun	vivecaka
interpretability_noun	vivecanIyawA
interpretation_noun	vivecanA
interpreter_noun	anuxeSAMwaraka
interpretor_noun	smarakaaMwara
interprocedural_noun	aMwara_prakriyAwmaka
interrupt_noun	anwarAyaka
interruption_noun	anwarAyana
intersect_noun	prawicCexa
intersection_noun	prawicCexana/aMwa:prawicCexana
intractability_noun	xu:sAXyawA
intractable_noun	xu:sAXya
intranet_noun	aMwa:jAla/iMtrAneta
invariant_noun	aparivarwanIya
inverter_noun	aMrwavarwaka
investigation_noun	joYMca
investors_noun	niveSaka
invoke_noun	AhvAna
ionosphere_noun	AyanosPeyara
irreflexive_noun	asvawulya
irrelevance_noun	asaMgawi
isdn_noun	AI_esa_dI_ena
iso_noun	AI_esa_o
isolators_noun	vilagaka
isomorphism_noun	samAkAriwA
item_noun	maxa
iteration_noun	punarAvarwana
iterator_noun	punarAvarwaka
java_noun	jAvA
job_noun	kArya/joYba
join_noun	sammilana
journal_noun	pawrikA
jpg_noun	jepIjI_(PotogrAPI_grupa)
judgement_noun	Akalana/nirNaya
jump_noun	jampa
jumper_noun	jampara
junctions_noun	saMgama
junk_noun	kabAdZa
jupiter_noun	jupItara/bqhaspawi
justification_noun	Ociwya
k_noun	kebI
kb_noun	ke_bI
kbytes_noun	kilobAIta
key-driven_noun	kuMjI_caliwa
key_noun	kuMjI
keyboard_noun	kuMjIpatala/kIborda
kick_noun	kika/Tokara
kill_noun	haMwa
kilo_noun	kilo
kilobit_noun	kilo_bita
kilobyte_noun	kilobAita
kiosk_noun	kyoska/KokA
knots_noun	goYMTa
knowledge_noun	jFAna
language_noun	BARA
laptop_noun	lEpatoYpa
lasers_noun	lejZara
latch_noun	sitakinI
latency_noun	prasupwi/vilaMbawA
lattice_noun	jAlaka
layer_noun	parawa
layout_noun	KZAkA
lcon_noun	AikoYna
leadership_noun	newqwva
leaf_noun	parNa
learning_noun	aXigama
led_noun	ela_I_dI
left-factoring_noun	vAma_guNana
lemma_noun	premayikA_lemA
lens_noun	leMsa
letter_noun	akRara
level_noun	swara
levity_noun	laGuwA/halkApana
lexeme_noun	Saibxama
lexicographic_noun	Sabxa_koSa_sambaXI/koRagawa
lexicon_noun	Sabxa_koSa
liberalization_noun	uxArIkaraNa
librarian_noun	lAibreriyana
library_noun	lAibrerI_saMgraha
lightness_noun	halkApana
limiter_noun	sImaka
linearity_noun	rEKikawA
link_noun	kadZI
linker_noun	saMyojaka/SrqMKalaka
linux_noun	linaksa
lisp_noun	lispa
list_noun	sUcI
literal_noun	AkRara/SAibxaka
load_noun	BAra/BaraNa
loading_noun	BAraNa/BaraNa
local_noun	sWAnIya
locate_noun	sWAna_nirXAraNa
lock_noun	pASa/loYka
locking_noun	pASana
logging_noun	pracAleKana
logical_noun	wArkika
loop_noun	lUpa/pASa
looping_noun	pASana/lUpiMga
lsb_noun	ela_esa_bI
lsi_noun	ela_esa_AI
machine_noun	yaMwra/maSIna
macroargument_noun	sWUla_prAcara
macrocall_noun	sWUla_AhvAna
macrocoding_noun	sWUla_kUtaleKana/sWUla_kodana
macroelement_noun	sWUla_avayava
macroexerciser_noun	sWUla_aBAsI/sWUla_parIkRaka
macroexpansion_noun	sWUla_prasAra
macroflowchart_noun	sWUla_pravAha_saMciwra
macrogeneration_noun	sWUla_janana
macroparameter_noun	sWUla_prAcala
macroprogramming_noun	sWUla_progrAmana
macroprototype_noun	sWUla_AxiprarUpa
macrotrace_noun	sWUla_anureKa
macsyma_noun	mEkasAimA
madcap_noun	mEdakEpa
mag_noun	mEga
magnetostriction_noun	cuMbakIya_virUpaNa
mainframe_noun	mena_Prema
majority_noun	bahusaMKya
man_noun	mEna
management_noun	prabaMXana
manifolding_noun	bahuvalana
mapping_noun	prawiciwraNa
margin_noun	upAMwa
mark_noun	cihna
marker_noun	cinhaka
marking_noun	cihnana
maser_noun	mesara
mask_noun	AcCaxa
masking_noun	pracCAxana/AcCaxana
massaging_noun	parimArjana
master_noun	praXAna
match_noun	mela/melana
matching_noun	milAna
matrix_noun	mEtriksa/AvyUha
maxicomputers_noun	mEksI_kaMpyUtara
mean_noun	maXyamAna
mechanism_noun	yaMwrAvalI
median_noun	maiXyakA
medium_noun	maXyama/mAXyama/mAXya
meet_noun	milana
mega_noun	megA
megabit_noun	megAbita
megabyte_noun	megAbAita
megacycle_noun	megAsAikila
meme_noun	mema
memory_noun	smqwi/mEmorI
menu_noun	menU
merge_noun	anwaranihiwa/vilaya
merging_noun	saMvilaya
message_noun	saMMMxeSa
messaging_noun	saMxeSana
metaclass_noun	metAvarga
metanetwork_noun	metAjAlakArya
metapost_noun	metAposta
metasystem_noun	aXiwaMwra
method_noun	viXi
micr_noun	ema_AI_sI_Ara
micro_noun	sUkRma
microchip_noun	mAikro_cipa
microcobol_noun	mAikro_kobola
microcycle_noun	mAikro_cakra
microfiche_noun	sUikRmakA/mAikroPiSa/sUkRma_saMcikA
microfilm_noun	mAikroPilma
microfloppy_noun	mAikro_niyaMwraka/mAikro_PloYpI
microflowchart_noun	mAikropravAha_saMciwra
microframe_noun	mAikro_Prema
micrographics_noun	mAikrogrAPiksa
microimage_noun	mAikro_prawibiMba
micromainframe_noun	mAikro_aXisaMsAXiwra/mAikromenaPrema
microminiaturization_noun	mAikro_laGurUpaNa
microorder_noun	sUkRmakrama
microphone_noun	mAikroPona/sUkRma_rUpa
microphotograph_noun	mAikro_PotogrAPa
microprocessor_noun	mAikroprosesara
microprogram_noun	mAikro_kramAxeSa/mAikro_progrAma
microsecond_noun	mAikrosEkeNda
microsequence_noun	mAikro_anukrama
microsoft_noun	mAIkrosoYPta
microwave_noun	mAikro_waMraga
middleware_noun	midla_veyara
midicomputer_noun	midI_kaMpyUtara
midpoint_noun	maXya_binxu
midterm_noun	maXyapaxa
migration_noun	pravAsana
millisecond_noun	milI_sEkenda
mime_noun	mAima
minicomputer_noun	laGu_kaMpyUtara
minidiskette_noun	laGu_disketa
minterm_noun	guNAxa/guNaxa/guNanayogapaxa
mips_noun	ema_AI_pI_esa
mirror_noun	xarpaNa
mis_noun	ema.AI.esa.(prabaMXana_sUcanA_sevA)
mistake_noun	BUla/wruti
mixer_noun	miSraka
mixing_noun	miSraNa
mnemonic_noun	smaraka
mnemonics_noun	smaraNokArI
mobile_noun	cala/mobAJla
model_noun	moYdala/nixarSa
modelling_noun	moYdalana/nixarSana
modem_noun	moYdama
modemmodulator-demodulator_)_noun	moYdama
moderate_noun	sAXAraNa_mAXya
moderator_noun	viBaMxaka
modification_noun	Aparivarwana/ASoXana
modifier_noun	Aparivarwaka
modify_noun	Aparivarwana
modular_noun	moYdayUlara/anuKaMdIya
modularity_noun	prawirUpakawA
modulation_noun	moYdayUlana
module_noun	moYdayUla/anuKaMda
modules_noun	anuKaMda
monarchy_noun	rAjaSAhI
monitor_noun	moYnitara
monostable_noun	eka_sWiwika
monotonicity_noun	eka_xiRtawA
morph_noun	rUpa
morpheme_noun	rUpima
morphism_noun	AkAriwA
mortgages_noun	giravI/baMXaka/rahana
mosaic_noun	mojE.ka
mosfet_noun	mosaPeta
motherboard_noun	uxgama_patala/maxara_bArda
mount_noun	Aroha
mouse_noun	mURaka/mAusa
move_noun	cAla/visWApana
mput_noun	ema_puta
ms-dos_noun	ema_esa_doYsa
ms-windows_noun	ema_esa_vindojZa
msi_noun	ema_esa_AI
multi_noun	bahu
multiaspect_noun	bahu_aBimuKawA
multibus_noun	bahu_basa
multicast_noun	bahurupIya
multicasting_noun	bahurUpana/bahu_prasAraNa
multichip_noun	bahu_patalikA
multics_noun	mailtaksa
multimedia_noun	bahumaXyama/maltImIdiyA
multinational_noun	bahurARtrIya
multiple_noun	bahu
multiplex_noun	maltIpaleksa/bahusaMkewa
multiplexer_noun	bahusaMkewaka
multiplexing_noun	bahusaMkewana/bahuBAjana
multipoint_noun	bahu_binxu
multipriority_noun	bahu_prAWamikawA
multiprocessing_noun	bahu_prakramaNa
multiprocessor_noun	bahu_prakramaka
multiprogramming_noun	bahu_kramAxeSana
multischedule_noun	bahuniyojana
multistation_noun	bahu_kenxra
multitasking_noun	bahukAryana
multithreading_noun	bahu_sUwraNa
multivibrator_noun	bahukaMpaka
mutex_noun	myuteksa
name_noun	nAma
nand_noun	nEda
nano_noun	nEno
navigate_noun	saMcAlana_karanA
navigation_noun	saMcAlana
navigator_noun	saMcAlaka
net_noun	jAla
nfa_noun	ena_ePa_e
nibble_noun	cawuRxvayaMka/cawu:bita/nibala
nip_noun	nipa
no-operation_noun	asaMkriyA_anuxeSa
node_noun	niRpaMxa/AsaMXi
noise_noun	rava
non-determinism_noun	aniyawawA
non-interactive_noun	anyonyakriyAhIna
nondistributive_noun	aviwaraka
nor-operation_noun	noYra_saMkriyA
nor_noun	ena.o.Ara.
normal_noun	samAnya/sarala
normalization_noun	prasAmAnya_karaNa
normalize_noun	prasAmAnyIkaraNa
normalizer_noun	prasAmAnyaka
not-and_noun	noYta-eMda
not-if-then=exclusion_)_noun	noYta-iPa-xena
not-or_noun	noYta-Ora
not_noun	noYta
notation_noun	aMkana/saMkewana
object_noun	vaswu/uxxeSya
off-line_noun	lAina_-viyukwa/oYPa-lAIna
offset_noun	oYPaseta
operand_noun	saMkArya
operation_noun	saMkriyA/pracAlana
operator_noun	pracAlaka/saMkAraka/saMkriyaka
optimization_noun	iRtawamIkaraNa
option_noun	vikalpa
optional_noun	EcCika/vEkailpaka
optoelectronics_noun	oYpto_ilektronikI
optoisolator_noun	prakASIya_pqWakkAraka
or_noun	oYra
overflow_noun	awipravAha
overlay_noun	upariSAyI
overload_noun	aXiBAra
overloading_noun	aBiXAraNa
overprinting_noun	aXimuxraNa
owner_noun	svAmI
ownership_noun	svAmiwva
pacing_noun	paxAniyamana
pack_noun	saMkula
package_noun	pEkeja/saMkula
packet_noun	pEketa
packing_noun	saMkulana
pad_noun	pEda
padding_noun	pEdana
page_noun	pqRTa
paging_noun	pqRTana/pqRTIkaraNa
panel_noun	pEnala
paragraph_noun	pErAgrAPa/anucCexa
parametron_noun	pErAmetroEYna
parent_noun	mUla/janaka
parser_noun	paxa_vyAKyAyiwra
parsing_noun	paxa_vicCexana
partition_noun	viBAjana
partitioning_noun	viBAjana
pascal-plus_noun	pAskala-plasa
password_noun	pASavarda/pAraNa_Sabxa
path_noun	paWa
peer_noun	miwra_samUha
pentium_noun	peMtiyama
peon_noun	caparAsI
percent_noun	prawiSawa
percolation_noun	anwa:_swravaNa
performability_noun	niRpAxanIyawA
performance_noun	niRpAxana
periodic_noun	AvaXika/AvarwI
peripheral_noun	pariXIya
perl_noun	parla
permission_noun	anumawi
permutation_noun	kramacaya
persistence_noun	sAwawya
persistent_noun	sawawa
pert_noun	parta/pI.I.Ara.tI.(progrAma_mUlyAMkana_samIkRA_wakanIka)
phantom_noun	PEMtama/aBAsI
phase_noun	prAvasWA
phoneme_noun	svanima
physical_noun	BOwika/bAhya
pico_noun	pIko
picosecond_noun	pIkosEkanda
pictorial_noun	ciwrIya
pile-on_noun	puMjana
pilferage_noun	laGucorI
pin_noun	pina_(ni._pa._sa0)
pine_noun	cIdZa
ping_noun	Xvani_spaMxa/piMga
pipe_noun	nalikA/pAipa
pipeline_noun	pAipalAina
pipelining_noun	anuprakramaNa
piracy_noun	apaharaNa/nakala
pitch_noun	aMwarAla
pixelization_noun	ciwra_avyavIkaraNa
place_noun	sWAna
plan_noun	yojanA
planning_noun	Ayojana
platform_noun	maMca/pletaPArma
plotter_noun	AleKaka
plotting_noun	AleKana
plugboard_noun	plagaborda
pocket_noun	jeba/pAketa
point-of-saleposterminal_noun	vikraya_biMxu_tarminala
point_noun	biMxu
pointer_noun	sUcaka
polarization_noun	XuvIkaraNa
polling_noun	cayana
polygon_noun	bahuBuja
polymorphism_noun	bahurUpawA
polynomial_noun	bahupaxIya
pop_noun	saMkarRa/wvariwa/prakatana/nikAlanA
port_noun	saMparka_sWala/xvAraka
portability_noun	suvAhyawA
portfolio_noun	portaPoliyo
portrait_noun	ciwra
poster_noun	postara
postfix_noun	anulagna
postmaster_noun	postamoYstara
pradicate_noun	nirXAraNa
pre-fix_noun	pUrvalagna
precondition_noun	pUrvasWiwi
predicate_noun	nirXAraka
prepayments_noun	agrima_BugawAna/pUrvaBugawAna
preprocessing_noun	pUrvaprakramaNa
preprocessor_noun	pUrvuprakramaka
prespecification_noun	pUrvavinirxeSa
prime_noun	aBAjya/muKya
printer_noun	muxraka/priMtara
printing_noun	muxraNa
priority_noun	varIyawA
privacy_noun	gopanIyawA
privileged_noun	viSeRAXikqwa
probabilistic_noun	prasamBAvyAwmaka/saMBAbaya
probablistic_noun	saMBAvya
procedural_noun	prakriyAwmaka
procedure_noun	prakriyA
processing_noun	prakramaNa
processor_noun	prakramaka
production_noun	uwpAxana
program_noun	kramAxeSa
programmer_noun	kramAxeSaka
prom_noun	pIroYma
propagation_noun	saMcaraNa/pravarXaka
proposition_noun	sAXya
protection_noun	rakRaNa/saMrakRaNa
pulse_noun	spaMxa
punctuation_noun	virAma_cinhana
push_noun	saMBara/xAba
qualification_noun	aharwAeEYM
quantifier_noun	parimANaka
quantize_noun	kvAMMtIkqwa_karanA
quantizer_noun	kvAMMtIkAraka
quantum_noun	kvAMtama
query_noun	pUCawACa/pqcCA
queue_noun	paMkwi
quotient_noun	BAgaPala
raster_noun	rEstara/reKApuMja
re-entrant_noun	puna:praveSI
re-writeable_noun	puna:_leKanIya/puna:_leKanayogya
reachability_noun	aBigamyawA/gamyawA
read-out_noun	rIda_AUta
read_noun	paTana
reader-copier_noun	pATakaprawilipika/rIdarakApiyara
reader_noun	pATaka
reading_noun	paTana
receiver_noun	aBigrAhI
recompile_noun	puna:_kramAxeSa_aMwaraNa/puna:awaMraka
record_noun	aBileKa
recovery_noun	vasUlI
recursiveness_noun	punarAvarwiwA
redundancy_noun	awirekawA
reengineering_noun	punaraBiyAMwrIkaraNa
reenlargement_noun	punarvarXana
reference_noun	saMxarBa
reflection_noun	parAvarwana
reflectivity_noun	parAvarwawA
refraction_noun	apavarwana
refresh_noun	punaScaryA
regeneration_noun	punarjanana
relation_noun	sambaMXa
relative_noun	sApekRa
relay_noun	prasAraNa/rile/rile_prawisAraNa
release_noun	vimocana
reliable_noun	viSvasanIya
remote_noun	suxUra
rename_noun	puna:nAmakaraNa
rendering_noun	prawipAxana/samarpaNa
repeater_noun	punarAvarwaka
reply_noun	uwwara
repost_noun	punaprareSana
request_noun	anuroXa/nivexana
research_noun	anusaMXAna
resident_noun	smqwivAsI
resolution_noun	viBexana
resources_noun	saMsAXana
responsibility_noun	ujFalwa;AraxAyiwva
retailing_noun	Putakara
retrace_noun	puna:_anureKa
retransmission_noun	puna:_preRaNa/puna:_saMcAra
retry_noun	puna:_prayAsa
return_noun	prawigama
rfc_noun	Ara_ePa_sI/rediyo_Avqwa_cEnala
robot_noun	robo
robotics_noun	robotiksa
robust_noun	Tosa/majabUwa
role_noun	BUmikA
rom_noun	roma(kevala_paTanIya_smqwi)
root_noun	mUla
rounding_noun	pUrNana
route_noun	mArga
router_noun	rAUtara/anurmAgaNa
routing_noun	mAgArBigamana/anumArgaNa
rs-232c_noun	Ara_esa_232_sI
rtc_noun	Ara_tI_sI_(vAswavika_kAla_GadZI)
run_noun	XAva
satellite_noun	upagraha
satisfiability_noun	saMwoRanIyawA
saturation_noun	saMwqpwi
save_noun	surakRiwa_karo/bacAva_karo
scalability_noun	mApanIyawA/mApakramaNIyawA
scalar_noun	axiRta/axiSa
scanning_noun	kramavIkRaNa
scenario_noun	parixqSya
scheduler_noun	anusUcaka
script_noun	lipi
scrolling_noun	kuMdalana/skroYlana
search_noun	Koja
searchable_noun	KojanIya
searching_noun	anveRaNa/KojanA
secondary_noun	xviwIyaka
sector_noun	sektara/KaMda
segment_noun	anuBAga/KaMda
select_noun	cayana
selection_noun	cayana
selectivity_noun	cayanAwmakawA
selector_noun	cayaka/varaka
semantics_noun	sImeintakI/arWa_vijFAna
semaphore_noun	sImePora
semiconductor_noun	arXacAlaka
sequence_noun	anukrama
sequencer_noun	anukramraka
sequencing_noun	anukramaNa
serial_noun	kramika
serialability_noun	kramikawA
serializability_noun	kramaNIyawA
serializer_noun	kramaka
server_noun	parisevaka/sevaka
service_noun	sevA
session_noun	sawra
set_noun	samuccaya
setext_noun	setektasta
setup_noun	vyavasWA
shade_noun	CAyA
shading_noun	CAyAMkana
shadow_noun	prawiCAyA
shannor_noun	SOnana
share_noun	Seyara
shared_noun	sahaBAjIwa
shares_noun	Seyara
sharing_noun	sahaBAjana
shear_noun	aparUpaNa
sheet_noun	parNa
shell_noun	koRTaka/kavaca/SOla/koSikA
shift_noun	visWApana
sibling_noun	sahoxara
siblings_noun	sahoxara/samABAsI
side_noun	pASrva
sign_noun	cinha
signal_noun	saMkewa
signaling_noun	saMkewana
signature_noun	haswAkRara
silicon_noun	silIkoYna
similar_noun	samarUpa
simplex_noun	simpaleksa
simulation_noun	sawawa_waMwra/anukaraNa
simulator_noun	anukArI
singleton_noun	ekala
site_noun	sWala
size_noun	sAhaja/AmApa
sizing_noun	AmApAna
sketching_noun	reKAMkana/reKAciwraNa
skip_noun	pluwi
skipping_noun	pluwi/pluwikaraNa
slash_noun	wiryaka
slip_noun	cUka/sarpaNa
slot_noun	KAMcA
slotting_noun	KAMcAkaraNa
smalltalk_noun	laGu_vArwA
smart_noun	smArta
smiley_noun	smiwiyukwa/muskurAhatayukwa
smurf_noun	smarPa
snail_noun	SaMbuka/GoMGA
snapshot_noun	ASuciwra
sneakernet_noun	snIkaraneta
snobol_noun	snoboYla
socket_noun	soYketa/garwikA
softfill_noun	sugama_BaraNa
some_noun	kiMciwa/kuCa
sort_noun	CAMtanA
sources_noun	swrowa
spacewar_noun	aMwarikRa_yuxva
spectacular_noun	Bavya
spectrum_noun	spektrama
spiral_noun	peMcaxAra/sarpila
spreadsheet_noun	viswqwa_spredaSIta
sprintnet_noun	XAvaka_neta/spintaneta
standard_noun	mAnaka
standardization_noun	mAnakIkaraNa
starvation_noun	aprApwi
state_noun	avasWA
station_noun	kenxra
storability_noun	BaMdAraNIyawA
storage_noun	BaMdAraNa
store_noun	BaMdAra
sub-directory_noun	upa-nixeSikA
subclass_noun	upavarga/upaEoNI
submit_noun	upasWiwa_karanA/praswuwa_karanA
subnet_noun	upajAla
subsemigroup_noun	upArXa_samUha
subtree_noun	upavqkRa
successes_noun	saPalawAeEYM
successor_noun	uwwarAXikArI
suite_noun	sarvAMga
summarization_noun	saMkRepaNa
summarize_noun	saMkRepa_karanA
summary_noun	sArAMSa
summer_noun	saMkaliwra
superblock_noun	aXiKaMdaka
superuser_noun	sarvocca_prayokwA
supervisor_noun	paryavekRaka
surf_noun	sarPa
surface_noun	pqRTa/sawaha
surfing_noun	saPirMga/sarPana
swap_noun	gamAgama
swapper_noun	gamAgamaka
swapping_noun	gamAgamana
switch_noun	svica
switches_noun	svica
switching_noun	svicana
sx_noun	esa_eksa
sybase_noun	sAibesa
synchronization_noun	varNanAwmakawA/wulyakAlana
synchronizer_noun	wulyakAlana_saMkrAmaka
synchronous_noun	wulyakAlika
synergic_noun	samanviwa
synergistic_noun	sahakriyASIla
table_noun	saraNI
tablet_noun	patalikA
talk_noun	vArwA
tar_noun	tAra
target_noun	lakRya
tariff_noun	xara_sUcI/Sulka_sUcI
task_noun	kArya
technocratic_noun	wakanIkajFa
teco_noun	teko
telecom_noun	xUrasaMcAra
telecommunication_noun	xUrasaMcAra
telecommunications_noun	xUrasaMcAra
telecommuting_noun	xUraparivarwI
teleconference_noun	xUra_saMvAxa
teleconferencing_noun	xUra_sammelana
telegraphy_noun	wArapreRaNa
telemetry_noun	xUramApI
telenation_noun	xUrarARtra
telephone_noun	xUraBARa
telephony_noun	xUraBARI
teleprinter_noun	xUramuxraka/telI_priMtara
teleprocessing_noun	xUraprakriyaNa
television_noun	xUraxarSana/telIvijana
telex_noun	teleksa
telnet_noun	xUra_jAla/telaneta
temperature_noun	wApa/wApamAna
template_noun	AkAra_patta/ParmA/tempaleta/rUpaxA
temporary_noun	asWAyI
term_noun	paxa/saMbaMXa
termination_noun	samApana
terminator_noun	samApaka
test_noun	parIkRaNa
text_noun	tEksatrapATya/sAmagrI
theorem_noun	prameya
thrashing_noun	gAhanA/WrESiMga
thread_noun	sUwra
threading_noun	sUwraNa
throughput_noun	pravAha_kRamawA
thumbwheels_noun	aMguRTa_cakra
tia_noun	tI_AI_e
tidy_noun	svacCa
time_noun	kAla/samaya
timeframe_noun	samaya_sImA
timeout_noun	kAla_samApana
timer_noun	kAla_samaMjaka
timesharing_noun	samaya_sahaBAjana
tin_noun	tina
tint_noun	varNaka
tla_noun	tI_ela_e
toggle_noun	toYgala
token_noun	prawIka/tokena
tone_noun	svara/Xvani
tool_noun	upakaraNa
topology_noun	sAMsWiwi
toy_noun	KilOnA
trace_noun	cihna/niSAna/anureKa
tracing_noun	anureKaNa
track_noun	paWa
tracking_noun	mArgana
tracks_noun	paWa_mArga/lIka
trading_noun	vyApAra
traffic_noun	yAwAyAwa
trailer_noun	anuyAna/Jalaka
training_noun	praSikRaNa
trajectory_noun	prakRepa_paWa
transaction_noun	kArya_saMpAxana/sOxA
transceiver_noun	saMpresI-aBigrAhI/troYMsarisivara
transcribe_noun	prawileKana/lipyaMwaraNa_karanA
transducer_noun	trAMnsadyUsara
transformation_noun	rUpAMwaraNa
transistor_noun	trAMjistara
transition_noun	saMkramaNa/saMkrAMwi
transitional_noun	saMkrAwika
transitive_noun	saMkrAmaka
transitivity_noun	saMkrAmiwA
translation_noun	anuvAxa
translator_noun	anuBARaka/amwaraka
transmission_noun	preRaka/prasAraNa
transmitter_noun	trAMsamItara
transparency_noun	pAraxarSIwA
transparent_noun	pAraxarSI
transponder_noun	trAMsapoMdara
transport_noun	parivahana
transportation_noun	parivahana
trapping_noun	PAMsanA/pakadanA/prapASana
traverse_noun	caMMkramaNa
tree_noun	vqkRa
triad_noun	wraya
tribits_noun	wri_bita
tristate_noun	wri_avasWA
trn_noun	tI_Ara_ena
truncate_noun	Cinnanu/rUMdana
tuners_noun	tyUnara/samaMjaka
tuning_noun	samaMjana/samasvaraNa/tyUniMga
tunnel_noun	suraMga/tanela
tunneling_noun	suraMgana/tanelana
tuple_noun	tapala
type_noun	prakAra
typeface_noun	akRarAkqwi/tAIpa_Pesa
typing_noun	taMkaNa
uid_noun	yU_AI_dI
ulsi_noun	yU_ela_esa_AI
uncertainty_noun	aniSciwawA
uncompression_noun	asaMpIdZina
uncountable_noun	agaNanIya
uncover_noun	anAvaraNa
undecidable_noun	anirNanIya
undefined_noun	apariBARiwa
undelete_noun	avilopa
underscore_noun	aXodEsa/aXoyojaka
unicasting_noun	samaciwraNa
unicode_noun	ekala_kUta/yUnIkoda
uniprocessing_noun	eka_prakramaNa
unique_noun	axviwIya
unit_noun	ekaka/ikAI
uniterm_noun	exa_paxa
unix_noun	yUniksa
unlock_noun	vipASa
unsubscribe_noun	grAhakI_baMxa_karanA
untar_noun	anatAra
updating_noun	axyawIkaraNa
upgrade_noun	unnayana
uplink_noun	apaliMka
upload_noun	BAra_dAlanA/BAra_baDAnA
uploading_noun	ucca_BAraNa/uxaBAraNa
upstream_noun	ujAna_XArA/prawikUla
uptime_noun	uparikAla
upward_noun	uXrva/uparI/uXrvagAmI
use_noun	upayoga
usenet_noun	upayoga_jAla/upayoga_netrayUjanEta
user_noun	upayogakarwA_prayokwA
userfriendly_noun	mEwripUrNa_prayokwA
username_noun	prayokwA_nAma
utility_noun	upayogiwA
vacation_noun	avakASa
vaccine_noun	tIkA
valid_noun	vEXa/mAnya
validation_noun	vEXIkaraNa
value_noun	mAna
vanilla_noun	vEnilA
vapourware_noun	veparaveyara
variable_noun	cara
variance_noun	prasaraNa
vector_noun	saxiSa
vertex_noun	SIrRa
videoconference_noun	vIdiyo_sammelana
videoserver_noun	vIdiyo_parisevaka
view_noun	xqSya
viewport_noun	xqSyaxvAra
vine_noun	vAina
virtual_noun	ABAsI
virus_noun	vAyarasa/viRANu
visibility_noun	xqSyawA
vision_noun	xqRti
vlsi_noun	vI_ela_esa_AI
vm_noun	vI_ema
vms_noun	vI_ema_esa
voice-net_noun	vAk_jAla/vAk_neta
voice_noun	vAk/vANI
vrml_noun	vI_Ara_ema_ela
wan_noun	vEna
wav_noun	dablyU_e_vI
weather_noun	mOsama
web_noun	veba
wetware_noun	AxrarpAwra/vetaveyara
whatis_noun	kyA_hE
wheel_noun	cakra
whois_noun	kOna_hE
wimp_noun	viMpa
window_noun	gavAkRa/KidZakI/viMdo
windowing_noun	gavAkRana
windows_noun	viMdojZa
winkey_noun	vina_kuMjI
winsock_noun	vinasoYka
wizard_noun	vijZArda
word_noun	bahuxvayaMka/Sabxa
workgroup_noun	kAryasamUha
workshop_noun	kAryaSAlA
workstation_noun	kAryasWala/varkasteSana
world_noun	viSva
worm_noun	varma
write_noun	leKana
writeable_noun	lEKanIya/leKanayona
wysiwyg_noun	visIviga
x-12_noun	eksa_12
xenix_noun	jeniksa
xetext_noun	eksateksata
xmodem_noun	eksa_moYdama
xon/xoff_noun	eksa_oYna/eksa_aEYAPa
xor_noun	eksa_oYra
xwindow_noun	eksa_viMdo
yoke_noun	yoka
zip_noun	saMkuciwa
zone_noun	aMcala/kRewra
zoom_noun	jUma
zooming_noun	jUmakaraNa
zterm_noun	jeda_paxa
