#telecommunication dictionary extracted by Monika Sharma. Formatted by Roja (26-01-2016)
#Changes:: 1) Separated single word and multi words into separate dictionaries
#          2) English words are converted to lower case
#          3) Added category as 'noun' by default
#########################################################################################
acceleration_noun	wvaraNa
accelerometer_noun	wvaraNa_mApaka
accident_noun	xurGatanA
accommodate_noun	samaMjana
accomodating_noun	samaMjaka
acting_noun	kAryakArI
adaptor_noun	anukUlaka
aerial_noun	vAyavIya/eriyala
alighnment_noun	saMreKaNa
ampere_noun	empIyara
amplification_noun	pravarXana
amplifier_noun	pravarXaka
amplitude_noun	AyAma
annode_noun	enoda
annular_noun	valayakAra
annunciator_noun	sAMkewika_suI
antenna_noun	eMtenA
apparatus_noun	upakaraNa
appliances_noun	sAXana
arc_noun	cApa/Arka
arm_noun	BujA
armature_noun	Armecara
attenuation_noun	kRINana/kRINawA
audiable_noun	SrAvya
audio_noun	Sravya
automotic_noun	svacala/svacAliwa
axle_noun	XurA
bass_noun	maMxra
battery_noun	bEtarI
beam_noun	bIma/kiraNa
beat_noun	spaMxana/vispaMxana
bell_noun	GaMtI
berm_noun	upawata
binary_noun	xviaMkI/xviAXArI
bipolar_noun	xviGruvIya
bistable_noun	xvisWiwika
block_noun	bloYka/KaMda/avaroXa
board_noun	Palaka/borda/patta
bond_noun	baMXa/baMXaka
cabin_noun	kEbina
cable_noun	kebala
cancellation_noun	nirasana/raxxa_karanA
capacitor_noun	saMXAriwra
capping_noun	UparI_pattI
carrier_noun	XAraka/vAhaka
catalyst_noun	uwpreraka
centrifugal_noun	upakeMxrIya
centripetal_noun	aBikeMxrIya
charactercomputer_)_noun	akRara_(kaMpyUtara)
circuit_noun	paripaWa
circulating_noun	parisaMcArI
circulation_noun	parisaMcaraNa
clamp_noun	klEMpa
classification_noun	vargIkaraNa
code_noun	kUta
coding_noun	saMkewana
coefficent_noun	guNAMka
coil_noun	kuMdalI
communication_noun	saMcAra
compensator_noun	kRawipUraka
computer_noun	kaMpyUtara
concave_noun	avawala
conductivity_noun	saMvAhakawA
conductor_noun	saMvAhaka
conduit_noun	vAhaka_nalI
conical_noun	SaMkurupa
contact_noun	saMparka
convertor_noun	saMparivarwaka
convex_noun	uwwala
counter_noun	gaNaka/kAuMtara
crank_noun	krEMka
creep_noun	sapaMNa
cummutator_noun	xikpiravarwaka
current_noun	XArA/bijalI/kareMta
curvature_noun	vakrawA
curve_noun	vakra
dead_noun	niRkriya
demodulation_noun	dimoYdUlana
density_noun	Ganawva
depolarisation_noun	niXruvaNa
derailer_noun	direlara
derailment_noun	patarI_se_uwaranA
design_noun	aBikalpa
detection_noun	paricAyana
detector_noun	paricAyaka
detonator_noun	PatAKe
digit_noun	aMka
disc_noun	cakawI
disengager_noun	viyojaka
diverging_noun	vigamana/apasArI
e-mail_noun	I-mela
earthing_noun	BUyojana
echo_noun	gUMja/prawiXvani
elevation_noun	uwWAna
elliptical_noun	xIrGa_vqwwAkAra
emersion_noun	unmIlana/uxaHgaRtimana
energise_noun	Urjana
equaction_noun	samIkaraNa
equalisation_noun	samakaraNa
equipment_noun	upaskara
exchange_noun	keMxra/AxAna-praxAna
expander_noun	viswAraka
explosives_noun	visPotaka
failure_noun	KarAba/xoRa
feed_noun	BaraNa/saMBaraNa
feeder_noun	saMBaraka
filament_noun	waMwu
filter_noun	CannI
flag_noun	JaMdI
flap_noun	pallA/pallexAra
flasher_noun	kOMXaka
focus_noun	nABI
force_noun	bala
frequency_noun	Avqwwi
fuse_noun	PyUja
galvanised_noun	gElvanIkqwa
galvanometer_noun	gElvanomItara
gantry_noun	gaMwrI
generator_noun	janiwra
gong_noun	GaMtI
graph_noun	leKA_ciwra
gravitational_noun	guruwvAkarRaNa
gravity_noun	guruwva
holder_noun	XAraka
hollow_noun	KoKalA
ignition_noun	prajvalana
illumination_noun	praxIpwi/prakASa_vyavasWA
impedence_noun	avabAXA
impulse_noun	Avega
incapacitation_noun	asAmaWrya
indication_noun	saMkewa
indicator_noun	saMkewaka/sUcaka
inductance_noun	prerakawA
induction_noun	preraNa
infringement_noun	awilaMGana
input_noun	aMwargAmI
insertion_noun	sinnaveSa
installation_noun	saMsWApana
instantaneous_noun	wAwkRaNika
instrument_noun	upakaraNa
insulation_noun	vixyuwaroXana/visaMvAhana
insulator_noun	vixyuwaroXaka
integrated_noun	samAkaliwa
integration_noun	samAkalana
intensity_noun	wIvrawA
interlocking_noun	aMwarpASana
intermittent_noun	savirAma/aMwarAyika
internet_noun	iMtaraneta
interpolation_noun	aMwarveSana
interruption_noun	aMwarAyaNa/avaroXa
inverter_noun	inavartara
ionisation_noun	AyanIkaraNa
ionosphere_noun	Ayana_maMdala
isolation_noun	pqWakkaraNa/viyojana
joint_noun	joda
jumper_noun	jaMpara
key_noun	kuMjI/cAbI
keying_noun	kuMjIyana
kinks_noun	eeMTana
knob_noun	GuMdI
layout_noun	vinyAsa
leakage_noun	kRaraNa/risAva
leakproof_noun	risAva_saha
level_noun	samawala
limiter_noun	sImiwra
link_noun	kadZI
loop_noun	lUpa
loudness_noun	prabalawA
lubrication_noun	snehana
magnetism_noun	cuMbakawva
magnetron_noun	mEganetrona
maintenance_noun	anurakRaNa
mesh_noun	jAlI
microphone_noun	Xvani_varXaka/mAikroPona
microphony_noun	mAikroPonI
microwave_noun	sUkRma_waraMga
miniature_noun	laGu/CotA
modem_noun	modama
modulator_noun	aXimiSraka
monitoring_noun	anuSravaNa
muting_noun	mUkana
mutual_noun	ApasI/pArasparika
mux_noun	maksa
negative_noun	QNAwmaka
network_noun	waMwra
neutral_noun	watasWa
neutralisation_noun	watasWIkaraNa
normal_noun	sAmAnya
notch_noun	KAMcA/noYca
observation_noun	prekRaNa/avalokana
obsolete_noun	apracaliwa
obstruction_noun	avaroXa
off_noun	APa
on_noun	oYna
operating_noun	paricAlana
operational_noun	pracAlana
oscillator_noun	xolaka
pairing_noun	yugmana
parallel_noun	samAnAMwara
parasite_noun	parASrayI/parAjIvI
pentode_noun	paMcAgra
permeability_noun	pAragamyawA
permitivity_noun	pAragamyawA
phase_noun	caraNa/kalA
pigment_noun	varNaka
pitch_noun	wArawva
plate_noun	patatI
point_noun	kAMtA
pointer_noun	sUcaka
polar_noun	XqvIya
polarisation_noun	XruvaNa/XqvIkaraNa
pole_noun	Xruva
porclain_noun	cInI_mittI
portable_noun	suvAhya
position_noun	avasWA/sWiwi
positive_noun	GanAwmaka
post_noun	KaMBA
potential_noun	vixyuwa_xAba/viBava
potentiometer_noun	vixyuwaxAba_mApI
primary_noun	prAWamika
principle_noun	sixXAMwa
proceed_noun	Age_baDZo
propagation_noun	saMcaraNa
protector_noun	rakRaka
psophometer_noun	soPomItara
radiation_noun	vikiraNa
radiator_noun	vikiraka
ratio_noun	anupAwa
reactance_noun	prawikAryawA
reactor_noun	aBikriyaka
reception_noun	saMgrahaNa/aBigrahaNa/Agamana
rectifier_noun	ekaxiSakArI/pariSoXaka
reflector_noun	parAvarwaka
regeneration_noun	punaryojana
relay_noun	prasAraNa/rile
release_noun	nirmukwi
renewal_noun	navIkaraNa
repeater_noun	punarAvarwaka
repulsive_noun	prawikarRI
resistance_noun	prawiroXa
resistivity_noun	prawiroXiwA
resistor_noun	prawiroXaka
resonance_noun	anunAxa/saMspaMxana
retentivity_noun	XAraNa_kRamawA
revolution_noun	parikramaNa
ripple_noun	lahara/waraMga
rodding_noun	CadZa_vyavasWA
rotary_noun	GUrNI
routiner_noun	nemaka
routing_noun	paWa_nirXAraNa
safe_noun	surakRiwa
safety_noun	saMrakRA
sag_noun	Jola
saturated_noun	saMwqpwa
scaling_noun	anumApana
scanning_noun	aMSekRaNa
scintillation_noun	sPUraNa
secondary_noun	saMcAyaka/gONa
selectivity_noun	cayanAwmakawA
selector_noun	saMvaraka
sensitivity_noun	sugrAhiwA
sequence_noun	anukrama
series_noun	SreNI
shackle_noun	SEkala
shaft_noun	SAPta
sheath_noun	SIWa
sheet_noun	cAxara/parwa
shield_noun	DAla
shunting_noun	SatiMga
siding_noun	sAidiMga
signs_noun	cihma
site_noun	sWAna
size_noun	AkAra/mApa
sketch_noun	reKAciwra
slide_noun	slAida
slot_noun	KAMcA
sound_noun	Xvani
sounder_noun	Xvaniwra
specification_noun	viSiRti
spilliting_noun	vipAtana
spiral_noun	sarpila
spool_noun	caKa
sprag_noun	guttI/roka
spring_noun	kamAnI
stability_noun	sWirawA
standard_noun	mAnaka
steam_noun	BApa
steel_noun	ispAwa
stop_noun	roka
strap_noun	pattaka
stress_noun	prawibala
stylus_noun	kaMtikA/anI
sub_noun	upa/apa
subsidiary_noun	sahAyaka
super_noun	awi/supara
supersonic_noun	karwAwIwa/parAXvanika
supply_noun	saplAI
support_noun	AXAra
surface_noun	sawaha
switch_noun	svica
synchronism_noun	samakramikawA
system_noun	praNAlI/paxXawi
tablet_noun	tikkI
tangible_noun	mUrwa
telecommunication_noun	xUrasaMcAra
telegraph_noun	wAra
telegraphy_noun	wAra
telephone_noun	telIPona
teleprinter_noun	telIpriMtara
television_noun	xUraxarSana/telIvijana
temporary_noun	asWAyI
terminal_noun	tarminala
theoritical_noun	sExXAMwika
theory_noun	sixXAMwa
thermal_noun	uRmIya
thimble_noun	CallA
tip_noun	sirA
token_noun	tokana
tokenless_noun	tokana_rahiwa
tone_noun	svara
tracing_noun	anureKaNa
tracking_noun	paWana
traction_noun	karRaNa
transconductance_noun	pAracAlawA
transformer_noun	trAMsaPArmara
transistor_noun	trAMsistara
transmission_noun	preRaNa/saMcAraNa
transmitter_noun	preRiwra
trigger_noun	trigara
trimmer_noun	karwaka
trunking_noun	traMkiMga
tubular_noun	nAlikAkAra
tune_noun	svara
tuning_noun	tyUniMga
twisted_noun	varwiwa
unidirectional_noun	ekaxiSIya
uniform_noun	samAna
uniselector_noun	ekala_saMvaraka
unit_noun	ikAI
unmanned_noun	cOkIxAra_rahiwa
unusual_noun	asAXAraNa
vaccum_noun	nirvAwa
valid_noun	vEXa/viXimAnya
value_noun	mUlya
valve_noun	vAlva
variable_noun	parivarwI
vehicle_noun	vAhana
velocity_noun	vega
vibration_noun	kaMpana
vibrator_noun	kaMpaka/kaMpiwra
visibility_noun	xqSyawA
visual_noun	xqSya
voltage_noun	voltawA
volume_noun	mAwrA/rASi/prabalawA/Ayawana
warning_noun	cewAvanI
washer_noun	vASara
wave_noun	waraMga
web_noun	veba
welding_noun	JalAI
whistle_noun	sItI
winding_noun	lapeta
wiring_noun	wAra_sWApana/wAra_lagAnA
yard_noun	yArda
yoke_noun	yoka
