#account multi dictionary extracted by Smriti Paliwal. Formatted by Roja (14-03-2016)
#Changes:: 1) Separated single word and multi words into separate dictionaries
#	   2) English words are converted to lower case
#	   3) Added category as 'noun' by default
#	   4) If last word is not punctuation then treated last word as head
#             or else treated last but one word as head
####################################################################################
ab_initio	nae_sire_se/AraMBa_se/SurU_se#nae_sire_se/AraMBa_se/SurU_se#noun#2#RM
abeyance_,_held_in	roka_raKI_gaI/AsWagiwa_raKI_gaI#roka_raKI_gaI/AsWagiwa_raKI_gaI#noun#4#RM
above_board	saMxeha_se_fGare/nicCala/niRkapata#saMxeha_se_fGare/nicCala/niRkapata#noun#2#RM
abundant_caution	pUrNa_sAvaXAnI#pUrNa_sAvaXAnI#noun#2#RM
accelerated_progress	wejI_se_pragawi#wejI_se_pragawi#noun#2#RM
acceleration_of_precis	kImawoM_kA_baDZanA#kImawoM_kA_baDZanA#noun#3#RM
accident_,_by	saMyoga_se#saMyoga_se#noun#3#RM
accompanied_,_by	ke_sAWa/sahiwa#ke_sAWa/sahiwa#noun#3#RM
accompanying_letter	saha_pawra/sAWa_kA_pawra#saha_pawra/sAWa_kA_pawra#noun#2#RM
according_to_law	viXi_ke_anusAra#viXi_ke_anusAra#noun#3#RM
account_,_take_into	hisAba_meM_lenA#hisAba_meM_lenA#noun#4#RM
account_current_section	cAlU_leKA_anuBAga#cAlU_leKA_anuBAga#noun#3#RM
account_for_the_proceeds	AgamoM_kA_leKA_joKA_(raKanA)#AgamoM_kA_leKA_joKA_(raKanA)#noun#4#RM
accountable_for	uwwaraxAyI_honA#uwwaraxAyI_honA#noun#2#RM
accountant_,_senior	variRTa_leKAkAra#variRTa_leKAkAra#noun#3#RM
accountant_general	mahAleKAkAra#mahAleKAkAra#noun#2#RM
accountant_general_(_a&e_)	mahAleKAkAra_(leKA_evaM_hakaxArI)#mahAleKAkAra_(leKA_evaM_hakaxArI)#noun#4#RM
accountant_general_(_audit_)	mahAleKAkAra_(leKAparIkRA)#mahAleKAkAra_(leKAparIkRA)#noun#4#RM
accountant_on_probation	parivIkRA_para_aXInasWa_leKA_sevA_leKAkAra#parivIkRA_para_aXInasWa_leKA_sevA_leKAkAra#noun#3#RM
accountants_officer	leKA_aXikArI#leKA_aXikArI#noun#2#RM
accounts_section	leKA_anuBAga#leKA_anuBAga#noun#2#RM
acknowledge_with_thanks_for_the_contribution	yogaxAna_ke_lie_XanyavAxa_xewe_hEM#yogaxAna_ke_lie_XanyavAxa_xewe_hEM#noun#6#RM
acquired_in_satisfaction_of_cl	xAvoM_kI_pUrwi_meM_prApwa#xAvoM_kI_pUrwi_meM_prApwa#noun#5#RM
acquisition_of_land	BUmi-arjana/BUmi_aXigrahaNa#BUmi-arjana/BUmi_aXigrahaNa#noun#3#RM
act_in_good_faith	saxBAvapUrvaka_kArya_karanA#saxBAvapUrvaka_kArya_karanA#noun#4#RM
acting_in_his_discretion	sva-viveka_se_kArya_karawe_hue#sva-viveka_se_kArya_karawe_hue#noun#4#RM
acting_in_official_capacity	aXikArika_hEsiyawa/rUpa_se_kArya_karawe_hue#aXikArika_hEsiyawa/rUpa_se_kArya_karawe_hue#noun#4#RM
action_,_line_of	kArya_xiSA#kArya_xiSA#noun#4#RM
active_capital	sakriya_pUMjI#sakriya_pUMjI#noun#2#RM
actually_due_payable	vaswuwa:_SoXya_Ora_xeya#vaswuwa:_SoXya_Ora_xeya#noun#3#RM
actuals_there_against	usakI_wulanA_meM_vAswavika_AMkadZe#usakI_wulanA_meM_vAswavika_AMkadZe#noun#3#RM
additional_demand	awiriwa_mAMga#awiriwa_mAMga#noun#2#RM
additional_expenditure	awiriwa_vyaya#awiriwa_vyaya#noun#2#RM
addl._accountant_general	apara_mahAleKAkAra#apara_mahAleKAkAra#noun#3#RM
addl._dy._comproller_auditor_general_(_h_)	apara_upa-niyaMwraka-mahA-leKAparIkRaka_(muKyAlaya)#apara_upa-niyaMwraka-mahA-leKAparIkRaka_(muKyAlaya)#noun#7#RM
addl._dy._comptroller_and_auditor_general_(_report	para_upaniyaMwraka-mahA_leKAparIkRaka_(prawivexana_kenxrIya)#para_upaniyaMwraka-mahA_leKAparIkRaka_(prawivexana_kenxrIya)#noun#8#RM
addl._dy._comptroller_auditor_general_(_report_sta	apara_upa-niyaMwraka-mahA-leKAparIkRaka_(prawivexana_rAjya)#apara_upa-niyaMwraka-mahA-leKAparIkRaka_(prawivexana_rAjya)#noun#8#RM
addl._dy._comptroller_auditor_general_(_rly_)	apara_upa-niyaMwraka-mahA-leKAparIkRaka_(relave)#apara_upa-niyaMwraka-mahA-leKAparIkRaka_(relave)#noun#7#RM
administration_section	praSAsana_anuBAga#praSAsana_anuBAga#noun#2#RM
administrative_officer	praSAsana_aXikArI#praSAsana_aXikArI#noun#2#RM
administrative_section	praSAsana_anuBAga#praSAsana_anuBAga#noun#2#RM
adoption_of_incorrect_rate	galawa_xara_kI_apanAnA#galawa_xara_kI_apanAnA#noun#4#RM
advances_section	uXAra_anuBAga#uXAra_anuBAga#noun#2#RM
after_consultation_with	se_parAmarSa_karake#se_parAmarSa_karake#noun#3#RM
after_making_allowance	moka_xene_ke_paScAw#moka_xene_ke_paScAw#noun#3#RM
after_taking_into_account_the_result_of_discussions_held_with_the_represent	maMwrAlaya_ke_prawiniXi_ke_sAWa_hue_vicAra-vimarSa_ke_pariNAmI_ko_XyAna_meM_raKakara#maMwrAlaya_ke_prawiniXi_ke_sAWa_hue_vicAra-vimarSa_ke_pariNAmI_ko_XyAna_meM_raKakara#noun#12#RM
again_and_again	bAra-bAra/bArambAra#bAra-bAra/bArambAra#noun#3#RM
alike_,_proposals_are	praswAva_samAna_hE/praswAva_eka_jEse_hEM#praswAva_samAna_hE/praswAva_eka_jEse_hEM#noun#4#RM
all_other_goods_not_elsewhere_specified	anyawra_vinixiZRta_kie_gae_saBI_anya_mAla#anyawra_vinixiZRta_kie_gae_saBI_anya_mAla#noun#6#RM
anticipated_increase	prawyASiwa_vqfxXa#prawyASiwa_vqfxXa#noun#2#RM
anticipating_economy	bacawa_kI_prawyASA_karawe_hue#bacawa_kI_prawyASA_karawe_hue#noun#2#RM
apex_bank	SIrRa_bEMka#SIrRa_bEMka#noun#2#RM
appellate_orders	apIlIya_AxeSa#apIlIya_AxeSa#noun#2#RM
appropriation_accounts_section	viniyoga_leKA_anuBAga#viniyoga_leKA_anuBAga#noun#3#RM
arising_out_of	se_uxBuwa/uwpanYna#se_uxBuwa/uwpanYna#noun#3#RM
as_against	kI_apekRA/kI_wulanA_meM#kI_apekRA/kI_wulanA_meM#noun#2#RM
as_arrear_of_land_revenue	BU-rAjasva_ke_bakAyA_ke_wOra_para#BU-rAjasva_ke_bakAyA_ke_wOra_para#noun#5#RM
as_brought_out_in_the_succeeding_paragraphs	jinakA_ulleKa_anuvarwI_pErAgrAPoM_meM_kiyA_gayA_hEê#jinakA_ulleKa_anuvarwI_pErAgrAPoM_meM_kiyA_gayA_hEê#noun#7#RM
as_coincidence	saMyogavaSa#saMyogavaSa#noun#2#RM
as_compared_to	kI_wulanA_meM#kI_wulanA_meM#noun#3#RM
as_compromise	samaJOwe_ke_rUpa_meM#samaJOwe_ke_rUpa_meM#noun#2#RM
as_defined	yaWA_pariBARiwa#yaWA_pariBARiwa#noun#2#RM
as_desired_by	kI_icCAnusAra/nixeSAnusAra#kI_icCAnusAra/nixeSAnusAra#noun#3#RM
as_envisaged_in_the_project	jEsA_ki_pariyojanA_meM_afBakalpiwa_kiyA_gayA_WA#jEsA_ki_pariyojanA_meM_afBakalpiwa_kiyA_gayA_WA#noun#5#RM
as_expedtiously_as_possible	yaWAsaMBava_SIGrawA_ke_sAWa#yaWAsaMBava_SIGrawA_ke_sAWa#noun#4#RM
as_far_as	jahAM_waka#jahAM_waka#noun#3#RM
as_far_as_possible	yaWA_saMBava/jahAM_waka_saMBava_ho_sake#yaWA_saMBava/jahAM_waka_saMBava_ho_sake#noun#4#RM
as_far_as_practicable	jahAM_waka_vyavahArWa_ho#jahAM_waka_vyavahArWa_ho#noun#4#RM
as_fixed_by_the_company	kampanI_xvArA_yaWA_nirXAriwa#kampanI_xvArA_yaWA_nirXAriwa#noun#5#RM
as_herein_after_provided	jEsA_nIce_liKA_hE/isake_Age_xie_anusAra#jEsA_nIce_liKA_hE/isake_Age_xie_anusAra#noun#4#RM
as_if	mAno#mAno#noun#2#RM
as_is_where_is	jEsA_hE_jahAM_hE#jEsA_hE_jahAM_hE#noun#4#RM
as_it_stands	jEsA_hE#jEsA_hE#noun#3#RM
as_laid_down_in	meM_yaWAnirXAriwa#meM_yaWAnirXAriwa#noun#4#RM
as_last_resort	aMwima_upAya_ke_rUpa_meM#aMwima_upAya_ke_rUpa_meM#noun#3#RM
as_major_constraint	muKya_bAXA_ke_rUpa_meM#muKya_bAXA_ke_rUpa_meM#noun#3#RM
as_matter_of_fact	yaWArWawa:_vaswuwa:/vAswava_meM#yaWArWawa:_vaswuwa:/vAswava_meM#noun#4#RM
as_regards	ke_bAre/saMbaMXa/viRaya_meM#ke_bAre/saMbaMXa/viRaya_meM#noun#2#RM
as_required	AvaSyakawAnusAra/yaWA_apekRiwa/jEsA_jarUrI_ho#AvaSyakawAnusAra/yaWA_apekRiwa/jEsA_jarUrI_ho#noun#2#RM
as_result_of	ke_parimA_svarU#ke_parimA_svarU#noun#3#RM
as_revealed_in_test_audit	jEsA_namUnA_leKAparIkRA_meM_pawA_lagA#jEsA_namUnA_leKAparIkRA_meM_pawA_lagA#noun#5#RM
as_revised	yaWA_saMSoXiwa/punarIkRiwa/pariSoXiwa#yaWA_saMSoXiwa/punarIkRiwa/pariSoXiwa#noun#2#RM
as_soon_as	yaWASIGra#yaWASIGra#noun#3#RM
as_stipulated_in_the_contract	Teke_meM_yaWAanubaMXiwa#Teke_meM_yaWAanubaMXiwa#noun#5#RM
as_stood_on	jEsA---(wArIKa)_ko_WA#jEsA---(wArIKa)_ko_WA#noun#3#RM
as_the_cause_may_be	yaWA_sWiwa/jEsI_bAwa_ho_yaWA_prasaMga/yaWA_avasWA#yaWA_sWiwa/jEsI_bAwa_ho_yaWA_prasaMga/yaWA_avasWA#noun#5#RM
as_unwrought_copper	anagaDZe_wAMbe_ke_rUpa_meM#anagaDZe_wAMbe_ke_rUpa_meM#noun#3#RM
as_whole	samagra/sArA_kA_sArA#samagra/sArA_kA_sArA#noun#2#RM
asstt._accountant_general	sahAyaka_mahAleKAkAra#sahAyaka_mahAleKAkAra#noun#3#RM
asstt._accountant_general_(_on_probation_)	sahAyaka_mahAleKAkAra_(parivIkRa-para)#sahAyaka_mahAleKAkAra_(parivIkRa-para)#noun#6#RM
asstt._administrative_officer	sahAyaka_praSAsana_aXikArI#sahAyaka_praSAsana_aXikArI#noun#3#RM
asstt._audit_officer	sahAyaka_leKAparIkRaka_aXikArI#sahAyaka_leKAparIkRaka_aXikArI#noun#3#RM
asstt._cashier	sahAyaka_rokadafZyA#sahAyaka_rokadafZyA#noun#2#RM
asstt._chief_auditor_(_rlys_)	sahAyaka_muKya_leKAparIkRaka_(relave)#sahAyaka_muKya_leKAparIkRaka_(relave)#noun#5#RM
asstt._chief_auditor_commercial_accountants	sahAyaka_muKya_leKAparIkRaka_vAffjyaka_leKe#sahAyaka_muKya_leKAparIkRaka_vAffjyaka_leKe#noun#5#RM
asstt._comptroller_auditor_general	sahAyaka_niyaMwraka-mahAleKAparIkRaka#sahAyaka_niyaMwraka-mahAleKAparIkRaka#noun#4#RM
asstt._director	sahAyaka_nixeSaka#sahAyaka_nixeSaka#noun#2#RM
asstt._director_of_audit_(_defence_services_)	sahAyaka_nixeSaka-leKAparIkRA_rakRA_sevAeM#sahAyaka_nixeSaka-leKAparIkRA_rakRA_sevAeM#noun#7#RM
asstt._director_of_audit_accounts_(_p&t_)	sahAyaka_nixeSaka_leKA_waWA_leKAparIkRA_(dAka-wAra)#sahAyaka_nixeSaka_leKA_waWA_leKAparIkRA_(dAka-wAra)#noun#7#RM
asstt._librarian	sahAyaka_lAibreriyana_(puswakAXyakRa)#sahAyaka_lAibreriyana_(puswakAXyakRa)#noun#2#RM
asstt._private_secy._(_to_the	sahAyaka_nijI_saciva_(ni-ma-pa-)#sahAyaka_nijI_saciva_(ni-ma-pa-)#noun#6#RM
at_all	pUrNawayA/bilkula#pUrNawayA/bilkula#noun#2#RM
at_all_events	hara_hAlawa_meM#hara_hAlawa_meM#noun#3#RM
at_an_early_date	SIGra/jalxI#SIGra/jalxI#noun#4#RM
at_any_cost	kisI_BI_kImawa_para#kisI_BI_kImawa_para#noun#3#RM
at_any_rate	kisI_BI_xaSA_meM#kisI_BI_xaSA_meM#noun#3#RM
at_call	mAnana_para#mAnana_para#noun#2#RM
at_least	kama_se_kama#kama_se_kama#noun#2#RM
at_once	wawkAla_wuranwa#wawkAla_wuranwa#noun#2#RM
at_random	yacCa/yacCayA/yohIM#yacCa/yacCayA/yohIM#noun#2#RM
at_the_instance_of	kI_preraNA_se/ke_lahaje_meM_ke_anuboXa_se#kI_preraNA_se/ke_lahaje_meM_ke_anuboXa_se#noun#4#RM
at_the_request_of	ke_anuroXa_para#ke_anuroXa_para#noun#4#RM
at_the_stage_of	ke_samaya#ke_samaya#noun#4#RM
audit_officer	leKAparIkRA_aXikArI#leKAparIkRA_aXikArI#noun#2#RM
audit_section	leKAparIkRA_anuBAga#leKAparIkRA_anuBAga#noun#2#RM
auditor_,_sr.	leKAparIkRaka/variRTa#leKAparIkRaka/variRTa#noun#3#RM
auxiliary_capital	sahAyaka_pUMjI/awiriwa_pUMjI#sahAyaka_pUMjI/awiriwa_pUMjI#noun#2#RM
avoidable_interest	parihArya_byAja#parihArya_byAja#noun#2#RM
avoidable_payment	parihArya_BugawAna/axAyagI#parihArya_BugawAna/axAyagI#noun#2#RM
back_out	mukara_jAnA/nata_jAnA/pICe_hata_jAnA#mukara_jAnA/nata_jAnA/pICe_hata_jAnA#noun#2#RM
back_to_back_contract	anyonya_TekA#anyonya_TekA#noun#4#RM
back_up	samarWana/RaRTa_poRa#samarWana/RaRTa_poRa#noun#2#RM
bag_and_baggage	boriyA-biswara#boriyA-biswara#noun#3#RM
bank_section	bEMka_anuBAga#bEMka_anuBAga#noun#2#RM
banking_prudence	bEMka_kArya_saMbaMXI_vyavahAra_kuSalawA#bEMka_kArya_saMbaMXI_vyavahAra_kuSalawA#noun#2#RM
barred_by_limitation	kAlAwIwa#kAlAwIwa#noun#3#RM
base_station	AXAra_steSana#AXAra_steSana#noun#2#RM
because_of	ke_kAraNa#ke_kAraNa#noun#2#RM
before_long	SIGra#SIGra#noun#2#RM
belated_decision	vilamba_se_kiyA_gayA_nirNaya#vilamba_se_kiyA_gayA_nirNaya#noun#2#RM
best_judgement_basis	savoZwwawama_nirNayaNa_ke_AXAra_para#savoZwwawama_nirNayaNa_ke_AXAra_para#noun#3#RM
beyond_of_scope_of	kI_pariXi_ke_bAhara#kI_pariXi_ke_bAhara#noun#4#RM
beyond_the_said_period	uwa_avaXi_ke_bAxa#uwa_avaXi_ke_bAxa#noun#4#RM
bi_des_eye_view	sarakArI_nigAha/vihaMgama_Rti#sarakArI_nigAha/vihaMgama_Rti#noun#4#RM
bill_encashed_on	ko_bila_BunAyA_gayA#ko_bila_BunAyA_gayA#noun#3#RM
billets_blooms	bileta_evaM_blUma#bileta_evaM_blUma#noun#2#RM
black_and_white_in	liKiwa_meM#liKiwa_meM#noun#4#RM
board_sheet_objection	brAdaSIta_Ora_Apawwawi_puswakeM#brAdaSIta_Ora_Apawwawi_puswakeM#noun#3#RM
body_of_individuals	vyaRtiyoM_kA_nikAya#vyaRtiyoM_kA_nikAya#noun#3#RM
bone_of_contention	JagadZe_kA_kAraNa_PasAxa_kI_jadZa#JagadZe_kA_kAraNa_PasAxa_kI_jadZa#noun#3#RM
book_section	anuBAga#anuBAga#noun#2#RM
book_section_deposit_section	leKA_samekana_puswikAeM_anuBAga_Ora_jamA_anUBAga#leKA_samekana_puswikAeM_anuBAga_Ora_jamA_anUBAga#noun#4#RM
bottle_neck	rukAvata/adZacana/bAXA#rukAvata/adZacana/bAXA#noun#2#RM
box_balance	galle_kI_rokadZa_bAkI/petI_SeRa#galle_kI_rokadZa_bAkI/petI_SeRa#noun#2#RM
branching_out_the_activities	gawiviXiyoM_kA_prasAra_karanA#gawiviXiyoM_kA_prasAra_karanA#noun#4#RM
breach_of_agreement	karAra_BaMga#karAra_BaMga#noun#3#RM
breach_of_terms	nibaMXanoM_kA_BaMga#nibaMXanoM_kA_BaMga#noun#3#RM
break-up_of_the_assesses	nirXAriwiyoM_kA_byOrA#nirXAriwiyoM_kA_byOrA#noun#4#RM
break-up_of_total_collection	kula_saMgrahaNa_ke_byOre#kula_saMgrahaNa_ke_byOre#noun#4#RM
break_down	Tappa_ho_jAnA/KarAba_honA/KarAbI#Tappa_ho_jAnA/KarAba_honA/KarAbI#noun#2#RM
bring_forward	praswuwa_karanA/peSa_karanA#praswuwa_karanA/peSa_karanA#noun#2#RM
broad_perspective	sWUla_pariprekRya#sWUla_pariprekRya#noun#2#RM
broadly_speaking	mote_wOra_se#mote_wOra_se#noun#2#RM
broadsheet_section	brAdaSIta_anuBAga#brAdaSIta_anuBAga#noun#2#RM
budget_research_statistics_secti	bamata/anusaMXAna_wawA_sAMfKyakI_anuBAga#bamata/anusaMXAna_wawA_sAMfKyakI_anuBAga#noun#4#RM
busy_season	aXika_kAmakAja_ke_xina#aXika_kAmakAja_ke_xina#noun#2#RM
but_not_exceeding_in_any_case	lekina_kisI_hAlawa_meM--_se_jyAxA_nahIM#lekina_kisI_hAlawa_meM--_se_jyAxA_nahIM#noun#6#RM
by_and_by	kramaSa:/XIre-XIre/#kramaSa:/XIre-XIre/#noun#3#RM
by_and_large	sAmAnyawa:_kula_milAkara#sAmAnyawa:_kula_milAkara#noun#3#RM
by_authority_of	ke_prAXikAra_se#ke_prAXikAra_se#noun#3#RM
by_certain_date	kisI_niyawa_wArIKa_waka#kisI_niyawa_wArIKa_waka#noun#3#RM
by_command_of	ke_samAxeSa_se#ke_samAxeSa_se#noun#3#RM
by_due_date	niyawa_wArIKa_waka#niyawa_wArIKa_waka#noun#3#RM
by_far	kahIM_aXika#kahIM_aXika#noun#2#RM
by_hand	xaswI#xaswI#noun#2#RM
by_leaps_and_bounds	xina_xunI_rAwa_cOgunI#xina_xunI_rAwa_cOgunI#noun#4#RM
by_mates_and_bounds	mApa_Ora_sImAMkana_karake#mApa_Ora_sImAMkana_karake#noun#4#RM
by_means_of	ke_xvArA#ke_xvArA#noun#3#RM
by_mutual_agreement	paraspara_samaJOwe_xvArA#paraspara_samaJOwe_xvArA#noun#3#RM
by_no_means	kisI_BI_waraha_se_nahIM#kisI_BI_waraha_se_nahIM#noun#3#RM
by_pass_lines	upamArga_lAineM#upamArga_lAineM#noun#3#RM
by_reason	ke_kAraNa#ke_kAraNa#noun#2#RM
by_the_order_of	ke_AxeSa_se#ke_AxeSa_se#noun#4#RM
by_the_way	prasaMgavaSa#prasaMgavaSa#noun#3#RM
by_turn	bArI-bArI_se#bArI-bArI_se#noun#2#RM
by_virtue_of	ke_nAwe/kI_hEsiyawa_se/ke_AXAra_para#ke_nAwe/kI_hEsiyawa_se/ke_AXAra_para#noun#3#RM
by_way_of	ke_rUpa_meM#ke_rUpa_meM#noun#3#RM
call_for	maMgavAnA/bulavAnA#maMgavAnA/bulavAnA#noun#2#RM
call_on_,_call_upon	apIla_karanA/(kisI_ke_Gara)_jAnA/BeMta_karanA#apIla_karanA/(kisI_ke_Gara)_jAnA/BeMta_karanA#noun#5#RM
can_not_be_over_emphasised	isake_mahawva_ke_bAre_meM_aXika_kahane_kI_AvaSyakawA_nahIM#isake_mahawva_ke_bAre_meM_aXika_kahane_kI_AvaSyakawA_nahIM#noun#5#RM
capital-locked_up	avaruxXa_pUMjI#avaruxXa_pUMjI#noun#2#RM
capital_employed	niyojiwa_pUMjI#niyojiwa_pUMjI#noun#2#RM
carry_on	jArI_raKanA#jArI_raKanA#noun#2#RM
carry_ones_point	apanI_bAwa_sixXa_karanA#apanI_bAwa_sixXa_karanA#noun#3#RM
carry_out	pAlana_karanA/kAryAfnvawa_karanA#pAlana_karanA/kAryAfnvawa_karanA#noun#2#RM
carry_out_obligation	xAyiwva_kA_niBAnA#xAyiwva_kA_niBAnA#noun#3#RM
carry_over	agranayana/Age_le_jAnA#agranayana/Age_le_jAnA#noun#2#RM
cases_were_reported	mAmale_sUciwa_kie_gae/mAmale_kI_sUcanA_xI_gaI#mAmale_sUciwa_kie_gae/mAmale_kI_sUcanA_xI_gaI#noun#3#RM
cash_section	rokadZa_anuBAga#rokadZa_anuBAga#noun#2#RM
catering_audit_section	KAnapAna-vyavasWA-leKA_parIkRA_anuBAga#KAnapAna-vyavasWA-leKA_parIkRA_anuBAga#noun#3#RM
central_audit_party	kenxrIya_leKAparIkRA_pArtI/xala#kenxrIya_leKAparIkRA_pArtI/xala#noun#3#RM
central_audit_support_section	kenxrIya_leKAparIkRA_sahAyawA_anuBAga#kenxrIya_leKAparIkRA_sahAyawA_anuBAga#noun#4#RM
central_board_of_direct_taxes	kenxrIya_prawyakRa_kara_borda#kenxrIya_prawyakRa_kara_borda#noun#5#RM
central_excise_revenue_audit_se	kenxrIya_uwpAxa-Sulka_rAjasva_leKAparIkRA_anuBAga#kenxrIya_uwpAxa-Sulka_rAjasva_leKAparIkRA_anuBAga#noun#5#RM
central_section	kenxrIya_anuBAga#kenxrIya_anuBAga#noun#2#RM
central_treasury_section	kenxrIya_KajAnA_anuBAga#kenxrIya_KajAnA_anuBAga#noun#3#RM
chairman_audit_board_and_ex-officio_addltional_de	aXyakRa_leKAparIkRA_baGrda_evaM_paxena_apara_upa-niyaMwraka-_ma#aXyakRa_leKAparIkRA_baGrda_evaM_paxena_apara_upa-niyaMwraka-_ma#noun#7#RM
cheque_section	cEka_anuBAga#cEka_anuBAga#noun#2#RM
chief_auditor	muKya_leKAparIkRaka#muKya_leKAparIkRaka#noun#2#RM
chief_auditor_(_commercial_accounts_)	muKya_leKAparIkRaka_(vANifjyaka_leKe#muKya_leKAparIkRaka_(vANifjyaka_leKe#noun#5#RM
co-ordination_section	samanvaya_anuBAga#samanvaya_anuBAga#noun#2#RM
code_section	saMhiwA_anuBAga#saMhiwA_anuBAga#noun#2#RM
coincidence_,_as	saMyoga_se#saMyoga_se#noun#3#RM
collaboration_with_,_in	ke_sahayoga_se#ke_sahayoga_se#noun#4#RM
come_to_light	nA/Bexa_KulanA#nA/Bexa_KulanA#noun#3#RM
commercial_audit_wing	vANifjyaka_leKAparIkRA_kakRA#vANifjyaka_leKAparIkRA_kakRA#noun#3#RM
commissioning_of_project	pariyojanA_kA_cAlU_kiyA_jAnA#pariyojanA_kA_cAlU_kiyA_jAnA#noun#3#RM
compensations_for_premature_termination_of_contract	samaya_se_pahale_TekA_samApwa#samaya_se_pahale_TekA_samApwa#noun#6#RM
compilation_section	saMkalana_anuBAga#saMkalana_anuBAga#noun#2#RM
comptroller_auditor_general	niyaMwraka-mahAleKAparIkRaka#niyaMwraka-mahAleKAparIkRaka#noun#3#RM
concurrent_audit_section	saMvarwI_leKAparIkRA_anuBAga#saMvarwI_leKAparIkRA_anuBAga#noun#3#RM
confer_on	ko_praxAna_karanA#ko_praxAna_karanA#noun#2#RM
confirming_to_specifications	viSiRtiyoM_ke_anurUpa#viSiRtiyoM_ke_anurUpa#noun#3#RM
conscious_decision	sacewana_nirNaya#sacewana_nirNaya#noun#2#RM
conservative_rates	saMrakRI_xareM#saMrakRI_xareM#noun#2#RM
consideration_,_under	vicArAXIna#vicArAXIna#noun#3#RM
consisted_of_the_following_members	meM_nimnaliKiwa_saxasya_SAmila_We#meM_nimnaliKiwa_saxasya_SAmila_We#noun#5#RM
construed_,_it_shall_be	yaha_samaJA_jAegA#yaha_samaJA_jAegA#noun#5#RM
contention_does_not_seem_to_be_correct	yaha_warka_sahI_nahIM_mAlUma_padZawA#yaha_warka_sahI_nahIM_mAlUma_padZawA#noun#7#RM
contractual_drilling	TekAgawa_veXana#TekAgawa_veXana#noun#2#RM
contractual_portion	TekAgawa_BAga#TekAgawa_BAga#noun#2#RM
control_accounts	niyaMwraNa_leKe#niyaMwraNa_leKe#noun#2#RM
control_section	niyaMwraNa_anuBAga#niyaMwraNa_anuBAga#noun#2#RM
controller_general_of_accounts	mahAleKA-niyaMwraka#mahAleKA-niyaMwraka#noun#4#RM
controller_of_accounts	leKA-niyaMwraka#leKA-niyaMwraka#noun#3#RM
conventional_wagons	pAramparika_vEgana#pAramparika_vEgana#noun#2#RM
correspondence_section	pawra-vyavahAra_anuBAga#pawra-vyavahAra_anuBAga#noun#2#RM
cost_benefit_study	lAgawa_hiwalABa_aXyayana#lAgawa_hiwalABa_aXyayana#noun#3#RM
cost_ledger_balances	lAgawa_KAwA_SeRa#lAgawa_KAwA_SeRa#noun#3#RM
credit_control	kredLta_niyaMwraNa/uXAra_niyaMwraNa#kredLta_niyaMwraNa/uXAra_niyaMwraNa#noun#2#RM
crossing_of_efficiency_bar	xakRawAroXa_ko_pAra_karanA#xakRawAroXa_ko_pAra_karanA#noun#4#RM
crucial_condition_of_aggregation	kula_yoga_saMgaTiwa_kie_jAne_kI_mahawvapUrNa_SarweM#kula_yoga_saMgaTiwa_kie_jAne_kI_mahawvapUrNa_SarweM#noun#4#RM
customs_revenue_audit_section	sImA-Sulka_rAjasva_leKAparIkRA_anuBAga#sImA-Sulka_rAjasva_leKAparIkRA_anuBAga#noun#4#RM
cut_motion	katOwI_praswAva#katOwI_praswAva#noun#2#RM
dae_to_non-observance_of_prescribed_rules	nirXAriwa_niyamoM_kA_pAlana_kie_jAne_ke_kAraNa#nirXAriwa_niyamoM_kA_pAlana_kie_jAne_ke_kAraNa#noun#6#RM
daring_audit_was_noticed	leKA_parIkRA_ke_xOrAna_yaha_xeKane_meM_AyA#leKA_parIkRA_ke_xOrAna_yaha_xeKane_meM_AyA#noun#4#RM
date_,_upto	axyawana/Aja_waka_kA#axyawana/Aja_waka_kA#noun#3#RM
dead_freight	nirarWaka_BAdZA/viPala_BAdZA/aprayuwa_sWAna#nirarWaka_BAdZA/viPala_BAdZA/aprayuwa_sWAna#noun#2#RM
deadling_with	se_sambanXiwa#se_sambanXiwa#noun#2#RM
debt_head_section	viBAgIya_leKAparIkRA_anuBAga#viBAgIya_leKAparIkRA_anuBAga#noun#3#RM
deep_sea_ship_repairs	gahare_samuxra_meM_jahAja_kI_marammawa#gahare_samuxra_meM_jahAja_kI_marammawa#noun#4#RM
defiance_of_,_in	kI_avajFA_karawe_hue#kI_avajFA_karawe_hue#noun#4#RM
delay_also_resulted_in_esealation_in	vilamba_ke_kAraNa_lAgawa_meM_vqfxXa#vilamba_ke_kAraNa_lAgawa_meM_vqfxXa#noun#6#RM
delay_in_finalising_the_tender_resulted_in_extra_avoidable_expenditure	nivixA_ko_afnwama_rUpa_xene_meM_hue_vilaMba_ke_PalasvarUpa_awiriwa_parihArya_vyaya_huA#nivixA_ko_afnwama_rUpa_xene_meM_hue_vilaMba_ke_PalasvarUpa_awiriwa_parihArya_vyaya_huA#noun#10#RM
delay_in_installation	prawiRTApana_meM_vilamba#prawiRTApana_meM_vilamba#noun#3#RM
departmental_compilation_sectio	viBAgIya_saMkalana_anuBAga#viBAgIya_saMkalana_anuBAga#noun#3#RM
depending_on_the_amount_of_work_involved	anwagraZswa_kArya_kI_mAwrA_para_niBaZra#anwagraZswa_kArya_kI_mAwrA_para_niBaZra#noun#7#RM
deposit_section	jamA_anuBAga#jamA_anuBAga#noun#2#RM
deputy_accountant_general	upa-mahAleKAkAra#upa-mahAleKAkAra#noun#3#RM
deputy_chief_auditor_(_commercial_accounts_)	upa-muKya_leKAparIkRaka_(vANifjyaka_leKe)#upa-muKya_leKAparIkRaka_(vANifjyaka_leKe)#noun#6#RM
deputy_chief_auditor_(_rlys_)	upa-muKya_leKAparIkRaka_(relave)#upa-muKya_leKAparIkRaka_(relave)#noun#5#RM
deputy_comptroller_auditor_general	upa-niyaMwraka_mahAleKAparIkRaka#upa-niyaMwraka_mahAleKAparIkRaka#noun#4#RM
deputy_controller_of_deputy_director	leKA_upa-niyaMwraka_upa_nixeSaka#leKA_upa-niyaMwraka_upa_nixeSaka#noun#5#RM
deputy_director_commercial_audit	upa-nixeSaka/vANifjyaka_leKAparIkRA#upa-nixeSaka/vANifjyaka_leKAparIkRA#noun#4#RM
deputy_director_of_audit_(_defence_services_)	upa-nixeSaka_leKAparIkRA_(rakRA_sevAeM)#upa-nixeSaka_leKAparIkRA_(rakRA_sevAeM)#noun#7#RM
deputy_director_of_audit_(_p&t_)	upa_nixeSaka/leKAparIkRA_(dAka-wAra)#upa_nixeSaka/leKAparIkRA_(dAka-wAra)#noun#6#RM
despatch_rider	savAra_harakArA#savAra_harakArA#noun#2#RM
devoid_of	se_rahiwa/ke_binA#se_rahiwa/ke_binA#noun#2#RM
difference_of_opinion	mawaBexa#mawaBexa#noun#3#RM
director_of_audit	nixeSaka/leKA_waWA_leKAparIkRA#nixeSaka/leKA_waWA_leKAparIkRA#noun#3#RM
director_of_audit_(_defence_services_)	nixeSaka_leKAparIkRA_(rakRA_sevAeM)#nixeSaka_leKAparIkRA_(rakRA_sevAeM)#noun#6#RM
director_of_audit_(_indian_accounts_in	nixeSaka/leKAparIkRA_(amerikA_meM_BArawIya_leKa)#nixeSaka/leKAparIkRA_(amerikA_meM_BArawIya_leKa)#noun#7#RM
director_of_audit_(_indian_in	nixeSaka/leKAparIkRA_(yUnAiteda_kiMgadama_meM_GarawIya#nixeSaka/leKAparIkRA_(yUnAiteda_kiMgadama_meM_GarawIya#noun#6#RM
director_of_audit_(_p&t_)	nixeSaka/leKAparIkRA_(dAka-wAra)#nixeSaka/leKAparIkRA_(dAka-wAra)#noun#5#RM
director_of_audit_(_railway_)	nixeSaka/leKAparIkRA_(relave)#nixeSaka/leKAparIkRA_(relave)#noun#5#RM
director_of_audit_,_central	nixeSaka/leKAparIkRA_kenxrIya#nixeSaka/leKAparIkRA_kenxrIya#noun#5#RM
director_of_audit_,_central_revenue	nixeSaka/leKAparIkRA_kenxrIya_rAjasva#nixeSaka/leKAparIkRA_kenxrIya_rAjasva#noun#6#RM
director_of_audit_,_commerce_,_works_minscellaneous	nixeSaka_leKAparIkRA/vANijya/nirmANa_evaM_viviXa#nixeSaka_leKAparIkRA/vANijya/nirmANa_evaM_viviXa#noun#8#RM
director_of_audit_,_scientific_commercial_departme	nixeSaka/leKAparIkRA_vEjFAnika_Ora_vANifjyaka_viBAga#nixeSaka/leKAparIkRA_vEjFAnika_Ora_vANifjyaka_viBAga#noun#7#RM
director_of_audit_ii_(_defence_services_)_(_air_forc	nixeSaka/leKAparIkRaka_(rakRa_sevAeM)_(vAyu_senA_aGra#nixeSaka/leKAparIkRaka_(rakRa_sevAeM)_(vAyu_senA_aGra#noun#11#RM
director_of_commercial_audit	nixeSaka/vAffjyaka_leKAparIkRA#nixeSaka/vAffjyaka_leKAparIkRA#noun#4#RM
director_of_coordination_secretary_to_the_comptro	samanvaya_nixeSaka_waWA_niyaMwraka-mahAleKAparIkRaka_kA_saciva#samanvaya_nixeSaka_waWA_niyaMwraka-mahAleKAparIkRaka_kA_saciva#noun#7#RM
director_of_inspection	nirIkRaka-nixeSaka#nirIkRaka-nixeSaka#noun#3#RM
director_of_receipt_audit	nixeSaka/prApwi_leKAparIkRA#nixeSaka/prApwi_leKAparIkRA#noun#4#RM
discharge_of_export_obligation	niryAwa_xAyiwva_kA_nirvAha#niryAwa_xAyiwva_kA_nirvAha#noun#4#RM
discussion_,_during	carcA_ke_xOrAna#carcA_ke_xOrAna#noun#3#RM
disproportionate_to_the_work_load	kArya_BAra_ke_anupAwa_se_nahIM#kArya_BAra_ke_anupAwa_se_nahIM#noun#5#RM
divisional_accountant	maMdala_leKAkAra#maMdala_leKAkAra#noun#2#RM
documentary_proof	liKiwa_pramANa/xaswAvejI/kAgajI_sabUwa#liKiwa_pramANa/xaswAvejI/kAgajI_sabUwa#noun#2#RM
due_date_,_on	niyawa_wArIKa_ko#niyawa_wArIKa_ko#noun#4#RM
due_to_lack_of_co-ordination	samanvaya_ke_aBAva_ke_kAraNa#samanvaya_ke_aBAva_ke_kAraNa#noun#5#RM
during_this_period	isa_avaXi_ke_xOrAna#isa_avaXi_ke_xOrAna#noun#3#RM
earlier_,_whichever_is	jo_BI_pahale_ho#jo_BI_pahale_ho#noun#4#RM
efficiency-cum-performance_audi	xakRawA_niRpAxana_leKAparIkRA_anuBAga#xakRawA_niRpAxana_leKAparIkRA_anuBAga#noun#2#RM
efficiency-cum-propriety_audit	xakRawA_Ociwya_leKAparIkRA_anuBAga#xakRawA_Ociwya_leKAparIkRA_anuBAga#noun#2#RM
electricity_concurrent_audit_se	vixyuwa_saMvarwI_leKAparIkRA_anuBAga#vixyuwa_saMvarwI_leKAparIkRA_anuBAga#noun#4#RM
embassy_audit_section	rAjaxUwAvAsa_leKAparIkRA_anuBAga#rAjaxUwAvAsa_leKAparIkRA_anuBAga#noun#3#RM
embassy_compilation_section	rAjaxUwAvAsa_saMkalana_anuBAga#rAjaxUwAvAsa_saMkalana_anuBAga#noun#3#RM
emd_ise_condition	afnwama_upayoga_kI_Sarwa#afnwama_upayoga_kI_Sarwa#noun#3#RM
en_bloc	eka_sAWa/sAmUhika_rUpa_se#eka_sAWa/sAmUhika_rUpa_se#noun#2#RM
engineering_section	iMjIniyarI_anuBAga#iMjIniyarI_anuBAga#noun#2#RM
enter_into_bond	bAMda_liKa_xenA#bAMda_liKa_xenA#noun#3#RM
enter_into_contract	saMvixA_karanA/TekA_karanA/anubanXa_karanA#saMvixA_karanA/TekA_karanA/anubanXa_karanA#noun#3#RM
entitlement_section	hakaxArI_anuBAga#hakaxArI_anuBAga#noun#2#RM
equipped_capacity_was_under-utilise	sajjiwa_kRamawA_kA_nyUnopayoga_huA_WA#sajjiwa_kRamawA_kA_nyUnopayoga_huA_WA#noun#4#RM
escalator_clause	svawa:_samAyojana_XArA#svawa:_samAyojana_XArA#noun#2#RM
essential_input_for_industry	uxyoga_ke_lie_anivArya_niviRti#uxyoga_ke_lie_anivArya_niviRti#noun#4#RM
establishment_audit_section	sWApanA_leKAparIkRA_anuBAga#sWApanA_leKAparIkRA_anuBAga#noun#3#RM
establishment_cost	sWApanA_lAgawa#sWApanA_lAgawa#noun#2#RM
every_now_and_then	samaya-samaya_para/bAra-bAra#samaya-samaya_para/bAra-bAra#noun#4#RM
evident_,_it_is_quite	yaha_bilkula_spaRta_hE#yaha_bilkula_spaRta_hE#noun#5#RM
exact_line_of_demarcation_between	ke_bIca_vAswavika_viBAjana_reKA#ke_bIca_vAswavika_viBAjana_reKA#noun#5#RM
examination_section	parIkRA_anuBAga#parIkRA_anuBAga#noun#2#RM
examiner_,_local_fund_accounts	parIkRaka/sWAnIya_niXi_leKA#parIkRaka/sWAnIya_niXi_leKA#noun#5#RM
excess_carry_forward_of_unabsorbed_investment_allowance_payment_due_but_not	anavaSoRiwa_niveSa_CUta_kA_aXika_agreRa#anavaSoRiwa_niveSa_CUta_kA_aXika_agreRa#noun#11#RM
excess_levy_of_duties_and_payment_due_but_not_made	aXika_Sulka_lagAe_jAne_Ora_xeya_rASiyoM_kA_BugawAna#aXika_Sulka_lagAe_jAne_Ora_xeya_rASiyoM_kA_BugawAna#noun#10#RM
excess_refund	aXika_prawixAya/vApasI#aXika_prawixAya/vApasI#noun#2#RM
excessive_created_capacity	PAlawU_sqjiwa_kRamawA#PAlawU_sqjiwa_kRamawA#noun#3#RM
exist_in_formal_way	OpacArika_rUpa_se_vixyamAna#OpacArika_rUpa_se_vixyamAna#noun#4#RM
expenditure_audit_section	vyaya_leKAparIkRA_anuBAga#vyaya_leKAparIkRA_anuBAga#noun#3#RM
expressed_inability_to_supply_additional_equipment_under_repeat_order_claus	Avarwaka_AxeSa_KaNda_ke_aXIna_awiriwa_upaskara_kI_ApUrwi_karane_meM_asamarWawA_vyawa_kI#Avarwaka_AxeSa_KaNda_ke_aXIna_awiriwa_upaskara_kI_ApUrwi_karane_meM_asamarWawA_vyawa_kI#noun#10#RM
extant_rules_and_orders	varwamAna_niyama_Ora_AxeSa#varwamAna_niyama_Ora_AxeSa#noun#4#RM
extra_expenditure_of_rs.could_have_been_avoided	ru-_ke_awiriwa_vyaya_se_becA_jA_sakawA_WA#ru-_ke_awiriwa_vyaya_se_becA_jA_sakawA_WA#noun#7#RM
extra_financial_liability	awiriwa_viwwIya_xeyawA#awiriwa_viwwIya_xeyawA#noun#3#RM
extra_shift_allowance	awiriwa_pArI_CUta#awiriwa_pArI_CUta#noun#3#RM
face_to_face	Amane-sAmane#Amane-sAmane#noun#3#RM
facilities_,_reasonable	uciwa_suviXAeM#uciwa_suviXAeM#noun#3#RM
fact_,_in	vAswava_meM/vaswuwa:#vAswava_meM/vaswuwa:#noun#3#RM
fact_,_question_of	waWya_saMbaMXI_praSna#waWya_saMbaMXI_praSna#noun#4#RM
factors_contributing_to_undue_time_lag_between	ke_bIca_anuciwa_samaya_aMwarAla_ke_lie_uwwaraxAyI#ke_bIca_anuciwa_samaya_aMwarAla_ke_lie_uwwaraxAyI#noun#7#RM
failing_which	jisake_hone_para#jisake_hone_para#noun#2#RM
failure_to_levy_the_countervailing_duty_resulted_in_short_levy_of_duty	prawikArI_Sulka_lagAe_jAne_ke_pariNAmasvarUpa_Sulka_kama_lagAyA#prawikArI_Sulka_lagAe_jAne_ke_pariNAmasvarUpa_Sulka_kama_lagAyA#noun#12#RM
fall_back_wages	nivarwana_majaxUrI#nivarwana_majaxUrI#noun#3#RM
fall_short_of	kama_honA#kama_honA#noun#3#RM
fall_through	niRPala_honA#niRPala_honA#noun#2#RM
feed_back_information	prawipuRti_sUcanA#prawipuRti_sUcanA#noun#3#RM
final_decision	aMwima_nirNaya#aMwima_nirNaya#noun#2#RM
final_outcome	afnwama_pariNAma#afnwama_pariNAma#noun#2#RM
finance_accounts_section	viwwawa_leKA_anuBAga#viwwawa_leKA_anuBAga#noun#3#RM
finance_compilation_section	viwwawa_saMkalana_anuBAga#viwwawa_saMkalana_anuBAga#noun#3#RM
financial_concurrence	viwwIya_sahamawi#viwwIya_sahamawi#noun#2#RM
financially_liable	viwwIya_Rti_se_sakRama/vyavahArya#viwwIya_Rti_se_sakRama/vyavahArya#noun#2#RM
following_factors_contributed_to_insatisfactory_working	asaMwoRajanaka_kAryacAlana_meM_nimnaliKiwa_kAraNoM_kA_yoga_WA#asaMwoRajanaka_kAryacAlana_meM_nimnaliKiwa_kAraNoM_kA_yoga_WA#noun#6#RM
for_and_on_behalf_of	ke_lie_Ora_unakI_ora_se#ke_lie_Ora_unakI_ora_se#noun#5#RM
for_appraisal_by_audit_board	leKAparIkRA_borda_xvArA_mUlyAMkana_ke_lie#leKAparIkRA_borda_xvArA_mUlyAMkana_ke_lie#noun#5#RM
for_arrival_at_mutually_acceptable_solution	paraspara_svIkArya_samAXAna_waka_pahuMcane_ke_lie#paraspara_svIkArya_samAXAna_waka_pahuMcane_ke_lie#noun#6#RM
for_good_(_and_all_)	saxA_ke_lie/hameSA_ke_lie#saxA_ke_lie/hameSA_ke_lie#noun#5#RM
for_the_time_being	samprawi/PilahAla#samprawi/PilahAla#noun#4#RM
for_want_of	ke_aBAva_meM/ke_hone_para#ke_aBAva_meM/ke_hone_para#noun#3#RM
forbidden_by_law	viXi_xvArA_niRixXa#viXi_xvArA_niRixXa#noun#3#RM
foreign_claims_section	vixeSa-xAvA_anuBAga#vixeSa-xAvA_anuBAga#noun#3#RM
foreign_service_section	bAhZaya-viBAga_sevA_anuBAga#bAhZaya-viBAga_sevA_anuBAga#noun#3#RM
forest_miscellaeous_section	vana_viviXa_anuBAga#vana_viviXa_anuBAga#noun#3#RM
forest_section	vana_anuBAga#vana_anuBAga#noun#2#RM
fraudulent_refund_vouchers	jAlI_prawixAya_vAucara#jAlI_prawixAya_vAucara#noun#3#RM
free_convertibility	nibAZXa_parivarwanIyawA#nibAZXa_parivarwanIyawA#noun#2#RM
free_of_tax	karamuwa#karamuwa#noun#3#RM
from_time_to_time	samaya-samaya_para#samaya-samaya_para#noun#4#RM
fully_negotiable_credit_instru	pUrNa_parakrAmya_sAKa_pawra#pUrNa_parakrAmya_sAKa_pawra#noun#4#RM
functional_buildings	kAryAlayIna_imAraweM/Bavana#kAryAlayIna_imAraweM/Bavana#noun#2#RM
fund_section	niXi_anuBAga#niXi_anuBAga#noun#2#RM
future_,_in_the_near	nikata_BaviRya_meM#nikata_BaviRya_meM#noun#5#RM
future_goods	agAU_mAla/BAvI_paxArWa/BAvI_vaswueM#agAU_mAla/BAvI_paxArWa/BAvI_vaswueM#noun#2#RM
gang_conversion	lAina_parivarwana#lAina_parivarwana#noun#2#RM
gazetted_audit_section	rAjapawriwa_leKAparIkRA_anuBAga#rAjapawriwa_leKAparIkRA_anuBAga#noun#3#RM
gazetted_entitlement_section	rAjapawriwa_hakaxArI_anuBAga#rAjapawriwa_hakaxArI_anuBAga#noun#3#RM
gazetted_miscellancous_section	rAjapawriwa_viviXa_anuBAga#rAjapawriwa_viviXa_anuBAga#noun#3#RM
gear_up	weja_karanA/kasanA#weja_karanA/kasanA#noun#2#RM
general_provident_fund_section	sAmAnya_BaviRya_niXi_anuBAga#sAmAnya_BaviRya_niXi_anuBAga#noun#4#RM
general_record_section	sAmAnya_afBaleKa_anuBAga#sAmAnya_afBaleKa_anuBAga#noun#3#RM
general_section	sAmAnya_anuBAga#sAmAnya_anuBAga#noun#2#RM
general_treasury_section	sAmAnya_KajAnA_anuBAga#sAmAnya_KajAnA_anuBAga#noun#3#RM
glut_of_capital	pUMjI_kA_aXikya/pUMjI_kI_BaramAra#pUMjI_kA_aXikya/pUMjI_kI_BaramAra#noun#3#RM
go_on	jArI_raKanA/Age_baDZanA#jArI_raKanA/Age_baDZanA#noun#2#RM
go_over	CAnabIna_karanA/smara_karanA/xuharAnA#CAnabIna_karanA/smara_karanA/xuharAnA#noun#2#RM
going_rate	cAlU_xara#cAlU_xara#noun#2#RM
good_faith	saxBAva#saxBAva#noun#2#RM
goods_consumed_captively	Anwarika_rUpa_se_upayuwa_vaswueM#Anwarika_rUpa_se_upayuwa_vaswueM#noun#3#RM
grainshop_and_catering_audit_sec	grenaSApa_waWA_KAnapAna_vyavasWA_leKAparIkRA_anu#grenaSApa_waWA_KAnapAna_vyavasWA_leKAparIkRA_anu#noun#5#RM
grant_of_ad_hoc_exemption_with_retrospective_effect_was_untenable_in_law	pUrvavyApI_praBAva_se_waxarWa_CUta_xenA_viXi_ke_anusAra_amAnya_WA#pUrvavyApI_praBAva_se_waxarWa_CUta_xenA_viXi_ke_anusAra_amAnya_WA#noun#12#RM
grant_of_extensions_to_con-tractors	TekexAroM_kI_(kArya_pUrA_karane_kI)_avaXi_baDZAI_gaI#TekexAroM_kI_(kArya_pUrA_karane_kI)_avaXi_baDZAI_gaI#noun#5#RM
graph_assistant	leKAciwra-sahAyaka#leKAciwra-sahAyaka#noun#2#RM
grounds_of_,_on_the	ke_AXAra_para#ke_AXAra_para#noun#5#RM
had_the_total_requirements_been_property_assessed	yaxi_kula_AvaSyakawA_samuciwa_rUpa_se_AMkI_gaI_howI#yaxi_kula_AvaSyakawA_samuciwa_rUpa_se_AMkI_gaI_howI#noun#7#RM
hand_in_hand	sAWa-sAWa#sAWa-sAWa#noun#3#RM
hard_and_fast_rules	kadZe_niyama#kadZe_niyama#noun#4#RM
hargeable_profits	praBArya_lABa#praBArya_lABa#noun#2#RM
held_,_it_was	yaha_nirNaya_kiyA_gayA/yaha_aBI_nirXAriwa_kiyA_gayA#yaha_nirNaya_kiyA_gayA/yaha_aBI_nirXAriwa_kiyA_gayA#noun#4#RM
held_in_abeyance	roka_raKI_gaI/AsWagiwa_raKI_gaI#roka_raKI_gaI/AsWagiwa_raKI_gaI#noun#3#RM
here_to_fore	isase_pUrva/aba_waka#isase_pUrva/aba_waka#noun#3#RM
higher_audit_section	uccawara_leKAparIkRA_anuBAga#uccawara_leKAparIkRA_anuBAga#noun#3#RM
higher_weighted_deduction	uccawara_BAriwa_katOwI#uccawara_BAriwa_katOwI#noun#3#RM
hindi_cell	hinxI_kakRa#hinxI_kakRa#noun#2#RM
hold_good	lAgU_rahanA#lAgU_rahanA#noun#2#RM
hold_meeting	bETaka_karanA#bETaka_karanA#noun#2#RM
home_consumption	xeSIya_Kapawa#xeSIya_Kapawa#noun#2#RM
honourably_acquitted	sasammAna_barI_kara_xiyA_gayA#sasammAna_barI_kara_xiyA_gayA#noun#2#RM
idle_investment	nifRkraya_niveSa#nifRkraya_niveSa#noun#2#RM
idle_time	nifRkraya_samaya#nifRkraya_samaya#noun#2#RM
if_it_is_satisfied_that_its_is_necessary_in_the_public_interest_so_to_do	yaxi_isa_bAwa_kI_saMwuRti_ho_jAwI_hE_ki_esA_karanA_lokahiwa_meM_AvaSyaka_hE#yaxi_isa_bAwa_kI_saMwuRti_ho_jAwI_hE_ki_esA_karanA_lokahiwa_meM_AvaSyaka_hE#noun#15#RM
immediate_action	wawkAla_kAraZvAI/wuranwa_kAryavAI#wawkAla_kAraZvAI/wuranwa_kAryavAI#noun#2#RM
impulse_test_certificate	Avega_parIkRa/pramANa_pawra#Avega_parIkRa/pramANa_pawra#noun#3#RM
in_accordance_with	ke_anusAra#ke_anusAra#noun#3#RM
in_addition_to	ke_awiriwa#ke_awiriwa#noun#3#RM
in_advance	pahale_se/agi_rama#pahale_se/agi_rama#noun#2#RM
in_aid_of	kI_sahAyawA_meM#kI_sahAyawA_meM#noun#3#RM
in_anticipation_of_your_approv	Apake_anumoxana_kI_prawyASA_meM#Apake_anumoxana_kI_prawyASA_meM#noun#5#RM
in_any_case	hara_hAlawa_meM#hara_hAlawa_meM#noun#3#RM
in_any_form	kisI_BI_warIke_se#kisI_BI_warIke_se#noun#3#RM
in_camera	banxa_kamare_meM/gupwa/gupwa_bETaka#banxa_kamare_meM/gupwa/gupwa_bETaka#noun#2#RM
in_case_of	kI_xaSA_meM/kI_avasWA_meM#kI_xaSA_meM/kI_avasWA_meM#noun#3#RM
in_collaboration_with	ke_sahayoga_se#ke_sahayoga_se#noun#3#RM
in_compliance_with	kA_pAlana_karawe_hue/anupAlana_meM#kA_pAlana_karawe_hue/anupAlana_meM#noun#3#RM
in_confirmation_of	kI_puRti_meM#kI_puRti_meM#noun#3#RM
in_conformity_with	ke_anurUpa#ke_anurUpa#noun#3#RM
in_connection_with	ke_saMbaMXa_meM#ke_saMbaMXa_meM#noun#3#RM
in_consequence_of	ke_pariNAmasvarUpa#ke_pariNAmasvarUpa#noun#3#RM
in_consideration_of	kA_vicAra_karawe_hue/ke_prawiPala_meM#kA_vicAra_karawe_hue/ke_prawiPala_meM#noun#3#RM
in_consonance_with_the_above_main_objections	uparowa_muKya_uxxeSyoM_ke_sAWa_hI_sAWa#uparowa_muKya_uxxeSyoM_ke_sAWa_hI_sAWa#noun#7#RM
in_consultation_with	se_parAmarSa_karake#se_parAmarSa_karake#noun#3#RM
in_contact_with	ke_saMparka_meM#ke_saMparka_meM#noun#3#RM
in_contemplation_of	ko_XyAna_meM_raKawe_hue#ko_XyAna_meM_raKawe_hue#noun#3#RM
in_content_and_converage	viRayavaswu_Ora_vyApwi_meM#viRayavaswu_Ora_vyApwi_meM#noun#4#RM
in_course_of	ke_xOrAna/ke_silasile_meM#ke_xOrAna/ke_silasile_meM#noun#3#RM
in_course_of_discussion	carcA_ke_xOrAna#carcA_ke_xOrAna#noun#4#RM
in_course_of_execution_of_work	kArya_niRpAxana_ke_xOrAna#kArya_niRpAxana_ke_xOrAna#noun#6#RM
in_due_course	yaWA_samaya#yaWA_samaya#noun#3#RM
in_excess_of_assessment_made	kie_gae_mUlyAMkana/nirXAraNa_se_aXika#kie_gae_mUlyAMkana/nirXAraNa_se_aXika#noun#5#RM
in_excess_of_requirement	AvaSyakawA_se_aXika#AvaSyakawA_se_aXika#noun#4#RM
in_exercise_of	kA_prayoga_karawe_hue#kA_prayoga_karawe_hue#noun#3#RM
in_fact	vAswava_meM/vaswuwa:#vAswava_meM/vaswuwa:#noun#2#RM
in_favour_of	ke_pakRa_meM#ke_pakRa_meM#noun#3#RM
in_harmony_with_principles	sixXAMwoM_ke_anusAra/anukUla#sixXAMwoM_ke_anusAra/anukUla#noun#4#RM
in_his_view	unake_vicAra_meM#unake_vicAra_meM#noun#3#RM
in_keeping_with	ke_anurUpa/ko_XyAna_meM_raKawe_hue#ke_anurUpa/ko_XyAna_meM_raKawe_hue#noun#3#RM
in_lieu_of	ke_baxale_meM/kI_evaja_meM#ke_baxale_meM/kI_evaja_meM#noun#3#RM
in_lump_sum	eka_muSwa_rASi_meM#eka_muSwa_rASi_meM#noun#3#RM
in_matter_of	ke_viRaya_meM/ke_mAmale_meM#ke_viRaya_meM/ke_mAmale_meM#noun#3#RM
in_order	viXivaw/sahI/vyavasWiwa#viXivaw/sahI/vyavasWiwa#noun#2#RM
in_order_of_merit	yogyawA_ke_krama_meM#yogyawA_ke_krama_meM#noun#4#RM
in_order_that	jisase_ki#jisase_ki#noun#3#RM
in_order_to	jisase_ki/ke_lie/ke_ueSya_se#jisase_ki/ke_lie/ke_ueSya_se#noun#3#RM
in_order_to_facilitate_timely_credit_of_customs_dues	sImA_Sulka_xeyoM_ke_yaWAsamaya_kredita_ko_suviXAjanaka_banAne_ke_uxxeSya_se#sImA_Sulka_xeyoM_ke_yaWAsamaya_kredita_ko_suviXAjanaka_banAne_ke_uxxeSya_se#noun#9#RM
in_other_respects	anya_bAwoM/prakara_meM#anya_bAwoM/prakara_meM#noun#3#RM
in_particular	KAsa_wOra_se/viSeRa_rUpa_se/viSeRawa:#KAsa_wOra_se/viSeRa_rUpa_se/viSeRawa:#noun#2#RM
in_perpetuity	SASZvawa/saxA_ke_lie#SASZvawa/saxA_ke_lie#noun#2#RM
in_practice	vyavahAra_meM#vyavahAra_meM#noun#2#RM
in_practice_it_results_in_short_levy_of_duty	vyavahAra_meM_isake_pariNAmasvarUpa_kama_Sulka_lagawA_hE#vyavahAra_meM_isake_pariNAmasvarUpa_kama_Sulka_lagawA_hE#noun#9#RM
in_pursuance_of	ke_anusara_meM/ke_anusAra#ke_anusara_meM/ke_anusAra#noun#3#RM
in_regard_to	ke_bAre_meM/ke_saMbaMXa_meM#ke_bAre_meM/ke_saMbaMXa_meM#noun#3#RM
in_respect_of	ke_bAre_meM/ke_sambanXa_meM#ke_bAre_meM/ke_sambanXa_meM#noun#3#RM
in_so_far_as	jahAM_waka_ki#jahAM_waka_ki#noun#4#RM
in_supersession_of	kA_aXikramaNa_karawe_hue/ke_aXikramaNa_meM_ko_niRpraBAva_karawe_hue#kA_aXikramaNa_karawe_hue/ke_aXikramaNa_meM_ko_niRpraBAva_karawe_hue#noun#3#RM
in_terms_of	ke_anusAra#ke_anusAra#noun#3#RM
in_that_respect	usa_viRaya_meM/usa_saMbaMXa_meM#usa_viRaya_meM/usa_saMbaMXa_meM#noun#3#RM
in_the_alternative	vikalpa_ke_rUpa_meM/vikalpawa:#vikalpa_ke_rUpa_meM/vikalpawa:#noun#3#RM
in_the_case_of	ke_viRaya_meM/kI_sWiwa_meM#ke_viRaya_meM/kI_sWiwa_meM#noun#4#RM
in_the_circumstances	esI_parisWiwa/hAlawa_meM#esI_parisWiwa/hAlawa_meM#noun#3#RM
in_the_context_of_aforesaid_measures	pUvoZwa_upAyoM_ke_saMxaBaZ_meM#pUvoZwa_upAyoM_ke_saMxaBaZ_meM#noun#6#RM
in_the_course_of	ke_xOrAna#ke_xOrAna#noun#4#RM
in_the_event_of	ke_hone_para/hone_kI_xaSA_meM#ke_hone_para/hone_kI_xaSA_meM#noun#4#RM
in_the_following_manner	nIce_liKe_warIke_se/nimnaliKiwa_paxXawi_se#nIce_liKe_warIke_se/nimnaliKiwa_paxXawi_se#noun#4#RM
in_the_light_of	ko_XyAna_meM_raKawe_hue/ke_pariprekRya_meM#ko_XyAna_meM_raKawe_hue/ke_pariprekRya_meM#noun#4#RM
in_the_long_run	anwawa:#anwawa:#noun#4#RM
in_the_nature_of	ke_rUpa_meM#ke_rUpa_meM#noun#4#RM
in_the_prescribed_manner	nirXAriwa_rIwi_se/vihiwa_DaMga_se#nirXAriwa_rIwi_se/vihiwa_DaMga_se#noun#4#RM
in_the_presence_of	kI_upasWiwa_meM#kI_upasWiwa_meM#noun#4#RM
in_the_same_way	usI_waraha_se#usI_waraha_se#noun#4#RM
in_theory	sixXAnwa_rUpa_meM#sixXAnwa_rUpa_meM#noun#2#RM
in_this_behalf	isa_bAre_meM/isa_saMbaMXa_meM#isa_bAre_meM/isa_saMbaMXa_meM#noun#3#RM
in_time	samaya_para#samaya_para#noun#2#RM
in_toto	pUrNawa:_pUrI_waraha#pUrNawa:_pUrI_waraha#noun#2#RM
in_view_of_the_stand_taken_by	xvArA_apanAe_gae_RtikoNa_ke_kAraNa#xvArA_apanAe_gae_RtikoNa_ke_kAraNa#noun#7#RM
inadequate_planning	aparyApwa_AyojanA#aparyApwa_AyojanA#noun#2#RM
inadmissible_expenditure	anujFeya_vyaya#anujFeya_vyaya#noun#2#RM
income-tax_revenue_audit_section	Aya-kara_rAjasva_leKAparIkRA_anuBAga#Aya-kara_rAjasva_leKAparIkRA_anuBAga#noun#4#RM
incorporation_of_vague_and_indefinite_clause	aspaRta_Ora_aniSciwa_XArA_kA_SAmila_kiyA_jAnA#aspaRta_Ora_aniSciwa_XArA_kA_SAmila_kiyA_jAnA#noun#6#RM
incorrect_application	galawa_lAgU_kiyA_jAnA/prayuwi#galawa_lAgU_kiyA_jAnA/prayuwi#noun#2#RM
incorrect_deduction	galawa_katOwI#galawa_katOwI#noun#2#RM
incorrect_practice_resulted	galawa_praWA_ke_pariNAmasvarUpa#galawa_praWA_ke_pariNAmasvarUpa#noun#3#RM
indian_audit_accounts_services_probationer	GarawIya_leKA_waWA_leKAparIkRA_sevA_parivIkRAXIna#GarawIya_leKA_waWA_leKAparIkRA_sevA_parivIkRAXIna#noun#5#RM
indigenous_availability	xeSIya_prApyawA/xeSaja_upalabXawA#xeSIya_prApyawA/xeSaja_upalabXawA#noun#2#RM
individual_running_ledger_accout	vyawigawa_cAlU_KAwA_leKA_anuBAga#vyawigawa_cAlU_KAwA_leKA_anuBAga#noun#4#RM
ineffective_planning	niRpraBAvI_AyojanA#niRpraBAvI_AyojanA#noun#2#RM
ineffective_wagons	bekAra_dibbe#bekAra_dibbe#noun#2#RM
informal_discussion	anOpacArika_-rcA#anOpacArika_-rcA#noun#2#RM
information_is_being_collected	sU-nA_ikatTI/Gapwa_kI_AmawaGra_se/sAmAnyawayA_rahI_hE_aGra_milawe_hI_G#sU-nA_ikatTI/Gapwa_kI_AmawaGra_se/sAmAnyawayA_rahI_hE_aGra_milawe_hI_G#noun#4#RM
initiate_action_,_to	kAraZvAI_AraMBa_karanA#kAraZvAI_AraMBa_karanA#noun#4#RM
inordinate_delay	awyaXika_xerI/vilamba#awyaXika_xerI/vilamba#noun#2#RM
inspection_section	nirIkRaNa_anuBAga#nirIkRaNa_anuBAga#noun#2#RM
inspite_of_the_stipulation_in_govt._order	sarakArI_AxeSa_meM_isa_anubaMXa_ke_hone_para_BI#sarakArI_AxeSa_meM_isa_anubaMXa_ke_hone_para_BI#noun#7#RM
instance_,_for	jEse/uxAharaNArWa/uxAharaNa_svarUpa#jEse/uxAharaNArWa/uxAharaNa_svarUpa#noun#3#RM
instance_,_in_the_first	praWamawa:_pahale_wo#praWamawa:_pahale_wo#noun#5#RM
instance_,_in_this	isa_viRaya_meM#isa_viRaya_meM#noun#4#RM
instead_of	ke_sWAna_para/kI_bajAya#ke_sWAna_para/kI_bajAya#noun#2#RM
intake_certificates	anwagraZhaNa_pramANa_pawra#anwagraZhaNa_pramANa_pawra#noun#2#RM
intensive_utilisation	gahana_upayoga#gahana_upayoga#noun#2#RM
interest_,_in_public	sArvajanika_hiwa_meM/loka_hiwa_meM#sArvajanika_hiwa_meM/loka_hiwa_meM#noun#4#RM
internal_arrangement	AMwarika_vyavasWA#AMwarika_vyavasWA#noun#2#RM
internal_audit_deptt.	AMwarika_leKAparIkRA_viBAga#AMwarika_leKAparIkRA_viBAga#noun#3#RM
internal_test_audit_section	AMwarika_namUnA_leKAparIkRA_anuBAga#AMwarika_namUnA_leKAparIkRA_anuBAga#noun#4#RM
intervening_period	maXyavarwI_avaXi#maXyavarwI_avaXi#noun#2#RM
intimation_timely	samaya_para_sUcanA/sAmayika_sUcanA#samaya_para_sUcanA/sAmayika_sUcanA#noun#2#RM
intimation_to_us_,_under	hameM_sUciwa_karawe_hue#hameM_sUciwa_karawe_hue#noun#5#RM
intrinsic_value	asalI_kImawa/vAswavika_mUlya/Anwarika_mUlya#asalI_kImawa/vAswavika_mUlya/Anwarika_mUlya#noun#2#RM
inventory_control	stAka_sUcI_niyaMwraNa#stAka_sUcI_niyaMwraNa#noun#2#RM
inventory_of_furniture	ParnIcara_kI_sUcI#ParnIcara_kI_sUcI#noun#3#RM
inview_of	ko_XyAna_meM_raKawe_hue#ko_XyAna_meM_raKawe_hue#noun#2#RM
inviting_reference_to	kA_havAlA_xewe_hue#kA_havAlA_xewe_hue#noun#3#RM
inviting_your_attention_to	kI_ora_ApakA_XyAna_AkafrRawa_karawe_hue#kI_ora_ApakA_XyAna_AkafrRawa_karawe_hue#noun#4#RM
involving_question_of_policy	nIwi_kA_praSna_aMwagraZswa_hE#nIwi_kA_praSna_aMwagraZswa_hE#noun#4#RM
irregular_refund	aniyamiwa_prawixAya/Xana_vApasI#aniyamiwa_prawixAya/Xana_vApasI#noun#2#RM
is_confined_to	waka_sImiwa_hE#waka_sImiwa_hE#noun#3#RM
issue_of_law	viXi_vivAxyaka/kAnUnI_muA_mue#viXi_vivAxyaka/kAnUnI_muA_mue#noun#3#RM
it_may_,_however_,_be	waWApi_yaha_ulleKanIya_hE#waWApi_yaha_ulleKanIya_hE#noun#6#RM
joint_director	saMyuwa_nixeSaka#saMyuwa_nixeSaka#noun#2#RM
junior_gestetner_operator	kaniRTa_gastetanara_pracAlaka#kaniRTa_gastetanara_pracAlaka#noun#3#RM
just_and_fair_terms	nyAyapUrNa_Ora_uciwa_SarweM#nyAyapUrNa_Ora_uciwa_SarweM#noun#4#RM
keep_dowon	xabAe_raKanA#xabAe_raKanA#noun#2#RM
keep_on	jArI_raKanA#jArI_raKanA#noun#2#RM
keeping_in_view_the_financial	viwwawIya_aBAva_ko_XyAna_meM_raKawe_hue#viwwawIya_aBAva_ko_XyAna_meM_raKawe_hue#noun#5#RM
keeping_with_,_in	ke_anurUpa#ke_anurUpa#noun#4#RM
kept_in_abeyance	AsWagiwa_raKA_gayA#AsWagiwa_raKA_gayA#noun#3#RM
kept_pending	nilaMbiwa_raKA_gayA/laMbiwa_raKA_gayA#nilaMbiwa_raKA_gayA/laMbiwa_raKA_gayA#noun#2#RM
key_plan	mUla_yojanA/AXAra_yojanA#mUla_yojanA/AXAra_yojanA#noun#2#RM
key_raw_material	AXAraBUwa_kaccA_mAla#AXAraBUwa_kaccA_mAla#noun#3#RM
lack_of_total_view_of_perspectives_and_co-ordinated_planning	pariprekRyoM_Ora_samafnvawa_AyojanA_kI_samagrawA_kA_aBAva#pariprekRyoM_Ora_samafnvawa_AyojanA_kI_samagrawA_kA_aBAva#noun#9#RM
laid_down	nirXAriwa#nirXAriwa#noun#2#RM
large_variations	BArI_anwara#BArI_anwara#noun#2#RM
lay_down	arpiwa_karanA/nirXAriwa_karanA#arpiwa_karanA/nirXAriwa_karanA#noun#2#RM
lay_out	pUMjI_lagAnA/praxarSiwa_karanA/wEyAra_karanA#pUMjI_lagAnA/praxarSiwa_karanA/wEyAra_karanA#noun#2#RM
lay_waste	babAZxa_karanA#babAZxa_karanA#noun#2#RM
leading_to	ke_pariNAmasvarUpa#ke_pariNAmasvarUpa#noun#2#RM
leave_out	harA_xenA/CodZa_xenA#harA_xenA/CodZa_xenA#noun#2#RM
less_acquisition_of_fixed_assets_and_less_receipt_of_stores_than_anticipate	acala_parisampawwiyoM_kA_kama_aXigrahaNa_Ora_BaNdAroM_kI_prawyASA_se_kama_prApwi#acala_parisampawwiyoM_kA_kama_aXigrahaNa_Ora_BaNdAroM_kI_prawyASA_se_kama_prApwi#noun#12#RM
let_off	CodZa_xenA/barI_karanA#CodZa_xenA/barI_karanA#noun#2#RM
leve_,_decided_at_high	ucca_swara_para_nirNIwa#ucca_swara_para_nirNIwa#noun#5#RM
library_section	puswakAlaya_anuBAga#puswakAlaya_anuBAga#noun#2#RM
line_of_action	kArya_xiSA#kArya_xiSA#noun#3#RM
line_of_promotion	paxonYnawi_kA_krama#paxonYnawi_kA_krama#noun#3#RM
linking_up	saMbaxXa_karanA#saMbaxXa_karanA#noun#2#RM
liquidity_ratio	nakaxI_anupAwa#nakaxI_anupAwa#noun#2#RM
list_of_business	kAryasUcI#kAryasUcI#noun#3#RM
loan_advances_section	karja_waWA_uXAra_anuBAga#karja_waWA_uXAra_anuBAga#noun#3#RM
loan_section	karja_anuBAga#karja_anuBAga#noun#2#RM
local_audit_co-ordination_and_r	sWAnIya_leKAparIkRA_samanvaya_waWA_riporta_anuBAga#sWAnIya_leKAparIkRA_samanvaya_waWA_riporta_anuBAga#noun#5#RM
lock_out	wAlAbaMxI#wAlAbaMxI#noun#2#RM
london_account_current_section	laMxana_cAlU_leKA_anuBAga#laMxana_cAlU_leKA_anuBAga#noun#4#RM
long_term_basis_,_on	xIGaZkAlika_AXAra_para#xIGaZkAlika_AXAra_para#noun#5#RM
long_term_borrowing	xIGaZkAlika_uXAra#xIGaZkAlika_uXAra#noun#3#RM
long_term_capital	xIGaZkAlika_pUMjI#xIGaZkAlika_pUMjI#noun#3#RM
look_after	xeKaBAla_karanA#xeKaBAla_karanA#noun#2#RM
look_for	Koja_karanA#Koja_karanA#noun#2#RM
look_into	XyAna_se_xeKanA/jAMca_karanA/anusaMXAna_karanA#XyAna_se_xeKanA/jAMca_karanA/anusaMXAna_karanA#noun#2#RM
look_through	sarasarI_nigAha_se_xeKanA#sarasarI_nigAha_se_xeKanA#noun#2#RM
loss_of_earnings	Aya_kI_hAni#Aya_kI_hAni#noun#3#RM
low_capacity_utilisation	kRamawA_kA_kama_upayoga#kRamawA_kA_kama_upayoga#noun#3#RM
lower_division_clerk	avara_SreNI_lipika#avara_SreNI_lipika#noun#3#RM
machine_hours	maSIna_GaMte#maSIna_GaMte#noun#2#RM
maintained_,_accounts_are_being	hisAba_kiwAba_raKA_jA_rahA_hE/leKe_raKe_jA_rahe_hE_kRawipUrwi_karanA#hisAba_kiwAba_raKA_jA_rahA_hE/leKe_raKe_jA_rahe_hE_kRawipUrwi_karanA#noun#5#RM
make_out	praswuwa_karanA/samaJanA/wEyAra_karanA#praswuwa_karanA/samaJanA/wEyAra_karanA#noun#2#RM
make_up	kRawipUrwi_karanA#kRawipUrwi_karanA#noun#2#RM
make_up_ones_mind	niScaya_karanA#niScaya_karanA#noun#4#RM
manual_section	niyama-puswaka/puswikA_anuBAga#niyama-puswaka/puswikA_anuBAga#noun#2#RM
margin_,_it_leaves_on	isameM_koI_guMjAiSa_nahIM_hE#isameM_koI_guMjAiSa_nahIM_hE#noun#5#RM
marginal_note	hASie_meM_xI_gaI_tippaNI#hASie_meM_xI_gaI_tippaNI#noun#2#RM
marginal_rate	sImAnwa_xara#sImAnwa_xara#noun#2#RM
material_management	sAmagrI_prabaMXa#sAmagrI_prabaMXa#noun#2#RM
matter_is_under_consideration	viRaya_para_vicAra_ho_rahA_hE/mAmalA_vicArAXIna_hE#viRaya_para_vicAra_ho_rahA_hE/mAmalA_vicArAXIna_hE#noun#4#RM
matter_of_common_interest	samAna_hiwa_ke_mAmale#samAna_hiwa_ke_mAmale#noun#4#RM
matter_of_fact_,_as	vAswava_meM#vAswava_meM#noun#5#RM
meantime_,_in_the	isa_bIca/isI_bIca#isa_bIca/isI_bIca#noun#4#RM
member_,_audit_board_ex-officio_,_director_of_comme	saxasya/leKAparIkRA_baGrda_evaM_paxena_nixeSaka/vANifj#saxasya/leKAparIkRA_baGrda_evaM_paxena_nixeSaka/vANifj#noun#9#RM
mentioned_above	uparowa/Upara_uflliKawa#uparowa/Upara_uflliKawa#noun#2#RM
mentioned_therein	usameM_uflliKawa#usameM_uflliKawa#noun#2#RM
middle_rate_of_exchange	vinimaya_kI_maXyavarwI_xara#vinimaya_kI_maXyavarwI_xara#noun#4#RM
militia_accounts_section	miliSiyA_leKA_anuBAga#miliSiyA_leKA_anuBAga#noun#3#RM
ministry_of_finance_have_accepted_the_mistake	viwwa_maMwrAlaya_ne_BUla/galawI_svIkAra_kara_lI_hE#viwwa_maMwrAlaya_ne_BUla/galawI_svIkAra_kara_lI_hE#noun#7#RM
modification_of_,_in	meM_saMSoXana_karawe_hue#meM_saMSoXana_karawe_hue#noun#4#RM
modification_of_,_in_partial	meM_AMSika_saMSoXana_karawe_hue#meM_AMSika_saMSoXana_karawe_hue#noun#5#RM
motion_,_of_his_own	svapreraNA_se#svapreraNA_se#noun#5#RM
multiplicity_of_exchange_rates	vinimaya_xaroM_kI_viviXawA#vinimaya_xaroM_kI_viviXawA#noun#4#RM
national_defence_fund_section	rARtrIya_rakRA_niXi_anuBAga#rARtrIya_rakRA_niXi_anuBAga#noun#4#RM
natural_,_it_is	yaha_svABAvika_hE#yaha_svABAvika_hE#noun#4#RM
necessary_steps_should_be_take	AvaSyaka_kAraZvAI_kI_jAnI_cAhie#AvaSyaka_kAraZvAI_kI_jAnI_cAhie#noun#5#RM
needful_,_do_the	AvaSyaka_kAraZvAI_kareM#AvaSyaka_kAraZvAI_kareM#noun#4#RM
needs_close_supervision	bahuwa_xeKaBAla_kI_jarUrawa_hE/saGana_paryavekRaNa_kI_AvaSyakawA_hE#bahuwa_xeKaBAla_kI_jarUrawa_hE/saGana_paryavekRaNa_kI_AvaSyakawA_hE#noun#3#RM
needs_no_comments	koI_tippaNI_jarUrI_nahIM_hE#koI_tippaNI_jarUrI_nahIM_hE#noun#3#RM
negative_balances	qNa_SeRa#qNa_SeRa#noun#2#RM
negotiated_rates	bAwacIwa_xvArA_waya_kI_gaI_xareM#bAwacIwa_xvArA_waya_kI_gaI_xareM#noun#2#RM
newly_recruited_staff_was_not_geared_up_properly	nae_BarwI_kie_gae_karmacAriyoM_ko_uciwa_rUpa_meM_sakRama_nahIM_banAyA_gayA_WAê#nae_BarwI_kie_gae_karmacAriyoM_ko_uciwa_rUpa_meM_sakRama_nahIM_banAyA_gayA_WAê#noun#8#RM
nick_of_time_,_at	TIka_samaya_para#TIka_samaya_para#noun#5#RM
nill_and_void	akqwa_Ora_SUnya/praBAvahIna/vAwila_Ora_SUnya#akqwa_Ora_SUnya/praBAvahIna/vAwila_Ora_SUnya#noun#3#RM
no_reason_of_doubt	isameM_saMxeha_kA_koI_kAraNa_nahIM_hE#isameM_saMxeha_kA_koI_kAraNa_nahIM_hE#noun#4#RM
non-availability_of_requisite_funds_in_time	samaya_para_apekRiwa_XanarASi_kI_anupalabXawA#samaya_para_apekRiwa_XanarASi_kI_anupalabXawA#noun#6#RM
non-clearance_of_suspense_balances	ucanwa_SeRoM_kA_asamASoXana#ucanwa_SeRoM_kA_asamASoXana#noun#4#RM
non-gazetted_establishment_sect	arAjapawriwa_sWApanA_anuBAga#arAjapawriwa_sWApanA_anuBAga#noun#3#RM
non-levy_of_excise_duty_being_pointed_out_in_audit	leKAparIkRA_xvArA_uwpAxa_Sulka_lagAe_jAne_ke_bAre_meM_bawAe_jAne_para#leKAparIkRA_xvArA_uwpAxa_Sulka_lagAe_jAne_ke_bAre_meM_bawAe_jAne_para#noun#9#RM
non-moving_stores	prayoga_meM_Ane_vAlA_BaNdAra#prayoga_meM_Ane_vAlA_BaNdAra#noun#2#RM
non_of_the_anticipated_benefits_were_realised	kisI_BI_prawyASiwa_lABa_kI_prApwi_nahIM_huI_WI#kisI_BI_prawyASiwa_lABa_kI_prApwi_nahIM_huI_WI#noun#7#RM
normal_mode_of_transportation	parivahana_kI_sAmAnya_praNAlI#parivahana_kI_sAmAnya_praNAlI#noun#4#RM
not_exceeding	se_anaXika/se_aXika_nahIM/aXika_se_aXika---waka#se_anaXika/se_aXika_nahIM/aXika_se_aXika---waka#noun#2#RM
not_later_than	wArIKa_ke_bAxa_nahIM/wArIKa---_se_pahale#wArIKa_ke_bAxa_nahIM/wArIKa---_se_pahale#noun#3#RM
not_less_than	se_kama_nahIM#se_kama_nahIM#noun#3#RM
not_more_than	se_aXika_nahIM#se_aXika_nahIM#noun#3#RM
not_withstanding_the_provision_aforesaid	pUvoZwa_vyavasWA/prAvaXAna_ke_howe_hue_BI#pUvoZwa_vyavasWA/prAvaXAna_ke_howe_hue_BI#noun#5#RM
noted_with_displeasure	aprasanYnawA_vyawa_karawe_hue_bawAyA#aprasanYnawA_vyawa_karawe_hue_bawAyA#noun#3#RM
now_and_then	kaBI-kaBI#kaBI-kaBI#noun#3#RM
number_of_objections_raised_in_audit	leKAparIkRA_meM_uTAI_gaI_ApawwiyoM_kI_saMKyA#leKAparIkRA_meM_uTAI_gaI_ApawwiyoM_kI_saMKyA#noun#6#RM
obligatorily_returnable	anivArya/bAXyakArI_rUpa_se_vApasa_karane_yogya#anivArya/bAXyakArI_rUpa_se_vApasa_karane_yogya#noun#2#RM
obvious_,_it_is	yaha_spaRta_hE#yaha_spaRta_hE#noun#4#RM
occasion_arises_,_when	jaba_jarUrI_howA_hE#jaba_jarUrI_howA_hE#noun#4#RM
of_no_avail	vyarWa/niRPala#vyarWa/niRPala#noun#3#RM
off_day	CuttI_kA_xina/KAlI_xina#CuttI_kA_xina/KAlI_xina#noun#2#RM
off_duty	kAma_para_honA#kAma_para_honA#noun#2#RM
office_establishment_section	kAryAlaya_sWApanA_anuBAga#kAryAlaya_sWApanA_anuBAga#noun#3#RM
official_capacity_,_in	sarakArI_hEsiyawa_se#sarakArI_hEsiyawa_se#noun#4#RM
old_record_section	purAnA_afBaleKa_anuBAga#purAnA_afBaleKa_anuBAga#noun#3#RM
on_account_of	ke_kAraNa_kI_vajaha_se#ke_kAraNa_kI_vajaha_se#noun#3#RM
on_account_of_incorrec_tassessment	galawa_nirXAraNa_ke_kAraNa#galawa_nirXAraNa_ke_kAraNa#noun#5#RM
on_account_of_incorrect_charging	galawa_praBAriwa_kie_jAne_ke_kAraNa#galawa_praBAriwa_kie_jAne_ke_kAraNa#noun#5#RM
on_behalf_of	kI_ora_se#kI_ora_se#noun#3#RM
on_being_pointed_out_by	xvArA_bawAe/XyAna_xilAe_jAne_para#xvArA_bawAe/XyAna_xilAe_jAne_para#noun#5#RM
on_ground_of	ke_AXAra_para#ke_AXAra_para#noun#3#RM
on_no_account	kisI_BI_hAlawa_meM_nahIM#kisI_BI_hAlawa_meM_nahIM#noun#3#RM
on_or_after_the_days	usa_xina_yA_usake_paScAw#usa_xina_yA_usake_paScAw#noun#5#RM
on_persual	avalokana_karane_para#avalokana_karane_para#noun#2#RM
on_premotional_basis	prowsAhanAwmaka_AXAra_para#prowsAhanAwmaka_AXAra_para#noun#3#RM
on_receipt_of	ke_prApwa_hone_para#ke_prApwa_hone_para#noun#3#RM
on_the_advice_of	kI_salAha_para#kI_salAha_para#noun#4#RM
on_the_average	Osawa_rUpa_meM/Osawana#Osawa_rUpa_meM/Osawana#noun#3#RM
on_the_basis_of_total_income	kula_Aya_ke_AXAra_para#kula_Aya_ke_AXAra_para#noun#6#RM
on_the_conclusion	ke_samApana_para/kI_samApwi_para#ke_samApana_para/kI_samApwi_para#noun#3#RM
on_the_contrary	isake_viparIwa#isake_viparIwa#noun#3#RM
on_the_demands_raised_by_the_department	viBAga_xvArA_kI_gaI_mAMgoM_para#viBAga_xvArA_kI_gaI_mAMgoM_para#noun#7#RM
on_the_face_of_it	prawyakRawa:#prawyakRawa:#noun#5#RM
on_the_grounds_that	ke_AXAra_para_ki#ke_AXAra_para_ki#noun#4#RM
on_the_line_of	ke_samAna/kI_BAMwi#ke_samAna/kI_BAMwi#noun#4#RM
on_the_omission_being_pointed_out_in_audit	leKAparIkRA_meM_isa_galawI_kI_ora_XyAna_xilAe_jAne#leKAparIkRA_meM_isa_galawI_kI_ora_XyAna_xilAe_jAne#noun#8#RM
on_the_part_of	ke_haka_meM/kI_ora_se#ke_haka_meM/kI_ora_se#noun#4#RM
on_the_point_of	ke_karIba#ke_karIba#noun#4#RM
on_these_points	ina_viRayoM_para/ina_muoM_para#ina_viRayoM_para/ina_muoM_para#noun#3#RM
operational_efficiency	paricAlana_kuSalawA/xakRawA#paricAlana_kuSalawA/xakRawA#noun#2#RM
organisation_and_mothod_section	saMgaTana_Ora_paxXawi_anuBAga#saMgaTana_Ora_paxXawi_anuBAga#noun#4#RM
original_assessment	mUla_nirXAraNa#mUla_nirXAraNa#noun#2#RM
original_demand	mUla_mAMga#mUla_mAMga#noun#2#RM
originally_envisaged	prAraMBa_meM_afBakalpiwa#prAraMBa_meM_afBakalpiwa#noun#2#RM
out_and_out	pUrNawa:#pUrNawa:#noun#3#RM
out_of_stock	stAka_meM_nahIM#stAka_meM_nahIM#noun#3#RM
outside_audit_department	bAhZaya_leKA_viBAga#bAhZaya_leKA_viBAga#noun#3#RM
overaged_locomotives	gawAyu_BApa_iMjana#gawAyu_BApa_iMjana#noun#2#RM
overall_expenditure	kula_Karca_samagra_vyaya#kula_Karca_samagra_vyaya#noun#2#RM
overall_review	samagra_samIkRA/punarIkRaNa#samagra_samIkRA/punarIkRaNa#noun#2#RM
overburden_removal	UparI_saMswara_(KAna_meM_jaloDZamqxA_Axi)_kA_hatAyA_jAnA#UparI_saMswara_(KAna_meM_jaloDZamqxA_Axi)_kA_hatAyA_jAnA#noun#2#RM
overlapping_of_functions	kAyoZM_kA_paraspara_vyApana#kAyoZM_kA_paraspara_vyApana#noun#3#RM
owing_to	ke_kAraNa#ke_kAraNa#noun#2#RM
package_policy	saMputiwa_pAlisI_haka/muSwa_nIwi#saMputiwa_pAlisI_haka/muSwa_nIwi#noun#2#RM
package_programme	ika_muSwa_kAryakrama/pEkeja_kAryakrama#ika_muSwa_kAryakrama/pEkeja_kAryakrama#noun#2#RM
paper_cutter	kAgaja_katara#kAgaja_katara#noun#2#RM
parameters_of_specification	BArawIya_mAnaka_viSiRta_ke_prAcala/pErAmItara#BArawIya_mAnaka_viSiRta_ke_prAcala/pErAmItara#noun#3#RM
part_and_parcel	anivArya_aMga#anivArya_aMga#noun#3#RM
partial_modification_of_,_in	ke_AMSika_saMSoXana_meM#ke_AMSika_saMSoXana_meM#noun#5#RM
particulars_,_with_full	pUre_byOroM_ke_sAWa/pUrNa_byOroM_sahiwa#pUre_byOroM_ke_sAWa/pUrNa_byOroM_sahiwa#noun#4#RM
parts_,_in_several	kaI_BAgoM_meM#kaI_BAgoM_meM#noun#4#RM
pay_and_accounts_office_(_audit_)	rawana_Ora_leKA_kAryAlaya_(leKAparIkRA)_anuBAga#rawana_Ora_leKA_kAryAlaya_(leKAparIkRA)_anuBAga#noun#6#RM
payable_to	ko_xeya#ko_xeya#noun#2#RM
payment_in_kind	vaswu_ke_rUpa_meM_BugawAna/jisa_ke_rUpa_meM_BugawAna#vaswu_ke_rUpa_meM_BugawAna/jisa_ke_rUpa_meM_BugawAna#noun#3#RM
peak_period_of_production	uwpAxana_kA_carama_kAla#uwpAxana_kA_carama_kAla#noun#4#RM
pendency_of_income_tax_assessments	bakAyA_Aya_kara_nirXAraNa#bakAyA_Aya_kara_nirXAraNa#noun#5#RM
pending_decision_in_the_matter	mAmale_meM_nirNaya_hone_waka#mAmale_meM_nirNaya_hone_waka#noun#5#RM
pending_finalisation	afnwama_rUpa_xie_jAne_waka#afnwama_rUpa_xie_jAne_waka#noun#2#RM
pension_audit_section	peMSana_leKAparIkRA_anuBAga#peMSana_leKAparIkRA_anuBAga#noun#3#RM
pension_entitlement_section	peMSana_hakaxArI_anuBAga#peMSana_hakaxArI_anuBAga#noun#3#RM
pension_insurance_fund_section	peMSana_bImA_niXi_anuBAga#peMSana_bImA_niXi_anuBAga#noun#4#RM
pension_verification_report_sec	peMSana_sawyApana_riporta_anuBAga#peMSana_sawyApana_riporta_anuBAga#noun#4#RM
per_bearer	pawra_vAhaka_xvArA/vAhaka_xvArA#pawra_vAhaka_xvArA/vAhaka_xvArA#noun#2#RM
peripheral_device	pariXIya_yaMwra#pariXIya_yaMwra#noun#2#RM
personal_assistant_director_,_staff_college	nijI_sahAyaka_nixeSaka/GarawIya_leKA_waWA_leKA_parIkR#nijI_sahAyaka_nixeSaka/GarawIya_leKA_waWA_leKA_parIkR#noun#6#RM
perspective_,_in_proper	sahI_rUpa_meM#sahI_rUpa_meM#noun#4#RM
physical_progress	vAswavika_pragawi#vAswavika_pragawi#noun#2#RM
pick_out	CAMta_lenA/cunakara_alaga_karanA#CAMta_lenA/cunakara_alaga_karanA#noun#2#RM
pit_head	garwa_muhAnA#garwa_muhAnA#noun#2#RM
plan_,_according_to	yojanA_ke_anusAra#yojanA_ke_anusAra#noun#4#RM
planning_and_execution	Ayojana_Ora_niRpAxana#Ayojana_Ora_niRpAxana#noun#3#RM
plea_is_not_tenable	warka_svIkArya_nahIM_hE#warka_svIkArya_nahIM_hE#noun#4#RM
polyster_blended_yarn	polIyastara_mifSrawa_XAgA#polIyastara_mifSrawa_XAgA#noun#3#RM
potential_tax_effet	saMBAviwa_kara_praBAva#saMBAviwa_kara_praBAva#noun#3#RM
practice_,_in	vyavahAra_meM#vyavahAra_meM#noun#3#RM
premature_condemnation	samaya_se_pUrva_bekAra_GoRiwa_kiyA_jAnA#samaya_se_pUrva_bekAra_GoRiwa_kiyA_jAnA#noun#2#RM
presumption_is_correct	XAraNA_TIka_hE#XAraNA_TIka_hE#noun#3#RM
prevailing_rate	cAlU_xara#cAlU_xara#noun#2#RM
previous_and_later_references	piCale_Ora_bAxa_ke_saMxaBaZ/pUrva_Ora_paSca_saMxaBaZ/havAle#piCale_Ora_bAxa_ke_saMxaBaZ/pUrva_Ora_paSca_saMxaBaZ/havAle#noun#4#RM
price_variation_clause	kImawa-parivarwana_XArA#kImawa-parivarwana_XArA#noun#3#RM
principal_value	praXAna_mUlya#praXAna_mUlya#noun#2#RM
principle_,_in	sixXAnwa_ke_wOra_para_sixXAnwawa:#sixXAnwa_ke_wOra_para_sixXAnwawa:#noun#3#RM
printing_and_binding_section	CapAI_waWA_jilxasAjI_anuBAga#CapAI_waWA_jilxasAjI_anuBAga#noun#4#RM
procurement_was_excessive_resulting_in_surplus_and_idling_of_rolling_stock	aXika_aXiprApwi_ke_pariNAmasvarUpa_cala_stAka_PAlawU_Ora_nifRkraya_ho_gayA#aXika_aXiprApwi_ke_pariNAmasvarUpa_cala_stAka_PAlawU_Ora_nifRkraya_ho_gayA#noun#11#RM
product-wise_analysis	uwpAxa-vAra_niSleRaNa#uwpAxa-vAra_niSleRaNa#noun#2#RM
production_loss	uwpAxana_hAni#uwpAxana_hAni#noun#2#RM
profit_and_gains_of_business_or_profession	kArobAra_yA_vqwwi_se_lABa_Ora_afBalABa#kArobAra_yA_vqwwi_se_lABa_Ora_afBalABa#noun#7#RM
projects_resident_audit_section	pariyojanA_Ora_sWAnIya_leKA-parIkRA_anuBAga#pariyojanA_Ora_sWAnIya_leKA-parIkRA_anuBAga#noun#4#RM
pros_and_cons	pakRa_meM_vipakRa/AgA-pICA/pariNAma#pakRa_meM_vipakRa/AgA-pICA/pariNAma#noun#3#RM
prospects_of_recovery_are_brleak	vasUlI_kI_saMBAvanA_kama_hE#vasUlI_kI_saMBAvanA_kama_hE#noun#5#RM
provident_fund_section	BaviRya_niXi_anuBAga#BaviRya_niXi_anuBAga#noun#3#RM
pursuance_of_,_in	ke_anusaraNa_meM#ke_anusaraNa_meM#noun#4#RM
put_right	cAlU_hAlawa_meM_lAnA#cAlU_hAlawa_meM_lAnA#noun#2#RM
put_up	praswuwa_kiyA_gayA#praswuwa_kiyA_gayA#noun#2#RM
qualifying_expenditure	ahaZka_vyaya#ahaZka_vyaya#noun#2#RM
qualitative_requirement	guNAwmaka_AvaSyakawA#guNAwmaka_AvaSyakawA#noun#2#RM
railway_audit_section	rela_leKAparIkRA_anuBAga#rela_leKAparIkRA_anuBAga#noun#3#RM
railway_production_unit	relave_uwpAxana_yUnita#relave_uwpAxana_yUnita#noun#3#RM
raising_of_demand	mAMga_jArI_karanA#mAMga_jArI_karanA#noun#3#RM
rated_capacity	nirXAriwa_kRamawA#nirXAriwa_kRamawA#noun#2#RM
rational_choice	vivekapUrcayana/vikalpa#vivekapUrcayana/vikalpa#noun#2#RM
ready_cash	nakaxI#nakaxI#noun#2#RM
reasons_to_belive	viSZvAsa_karane_ke_kAraNa#viSZvAsa_karane_ke_kAraNa#noun#3#RM
receipt_audit_section	prApwi_leKAparIkRA_anuBAga#prApwi_leKAparIkRA_anuBAga#noun#3#RM
receipts_and_issues_section	prApwi_wawA_nirgama_anuBAga#prApwi_wawA_nirgama_anuBAga#noun#4#RM
reconsideration_,_on	puna:_vicAra_karane_para#puna:_vicAra_karane_para#noun#3#RM
record_section	afBaleKa_anuBAga#afBaleKa_anuBAga#noun#2#RM
record_sorter	rikArda_sOrtara#rikArda_sOrtara#noun#2#RM
recoveries_at_the_instance_of_audit	leKAparIkRA_xvArA_bawA_jAne_para_kI_gaI_vasUliyAM#leKAparIkRA_xvArA_bawA_jAne_para_kI_gaI_vasUliyAM#noun#6#RM
reference_is_invited	kI_ora_XyAna_AkafrRawa_kiyA_jA_rahA_hE#kI_ora_XyAna_AkafrRawa_kiyA_jA_rahA_hE#noun#3#RM
regular_assessment	niyamiwa_nirXAraNa#niyamiwa_nirXAraNa#noun#2#RM
relaxation_in_specification	viSiRtiyoM_meM_CUta#viSiRtiyoM_meM_CUta#noun#3#RM
remedial_action	upacArI_upAya#upacArI_upAya#noun#2#RM
remittance_section	preRaNa_anuBAga#preRaNa_anuBAga#noun#2#RM
remodelling_of_yard	yArda_kA_punaniZmA#yArda_kA_punaniZmA#noun#3#RM
reply_is_silent_on_the_practice_being_contrary_to_the_law_under_customs_act	isa_bAwa_kA_koI_uwwara_nahIM_xiyA_gayA_hE_ki_yaha_praWA_sImA_Sulka_aXiniyama_ke_anwargawa_kAnUna_ke_prawikUla_hE#isa_bAwa_kA_koI_uwwara_nahIM_xiyA_gayA_hE_ki_yaha_praWA_sImA_Sulka_aXiniyama_ke_anwargawa_kAnUna_ke_prawikUla_hE#noun#14#RM
reply_to_,_in	ke_uwwawara_meM#ke_uwwawara_meM#noun#4#RM
report_section	riporta_anuBAga#riporta_anuBAga#noun#2#RM
representation_received	se_milA_aByAvexana#se_milA_aByAvexana#noun#2#RM
repudiation_of_contract	saMvixA_ko_svIkAra_karanA#saMvixA_ko_svIkAra_karanA#noun#3#RM
rescing_the_contract	TekA/saMvixA_ko_niKaNdiwa_karanA/TekA_BaMga_karanA#TekA/saMvixA_ko_niKaNdiwa_karanA/TekA_BaMga_karanA#noun#3#RM
rescue_,_come_to	rakRA/maxaxa_kI#rakRA/maxaxa_kI#noun#4#RM
resident_concurrent_audit_officer	nivAsI_saMvarwI_leKAparIkRA_aXikArI#nivAsI_saMvarwI_leKAparIkRA_aXikArI#noun#4#RM
restraint_,_acted_with	saMyama_se_kAma_liyA#saMyama_se_kAma_liyA#noun#4#RM
resulted_in_extra_benefit_to_the_contractor	ke_pariNAmasvarUpa_TekexAra_ko_awiriwa_lABa_huA#ke_pariNAmasvarUpa_TekexAra_ko_awiriwa_lABa_huA#noun#7#RM
resulted_in_loss_of_potential_revenue	ke_pariNAmasvarUpa_samBAvya_rAjasva_kI_hAni_huI#ke_pariNAmasvarUpa_samBAvya_rAjasva_kI_hAni_huI#noun#6#RM
resulting_in_belying_of_expectations	jisake_pariNAmasvarUpa_apekRAeM_pUrI_nahIM_huI#jisake_pariNAmasvarUpa_apekRAeM_pUrI_nahIM_huI#noun#5#RM
retrospective_effect_,_with	piCalA_wAIKa_se/pUrvaNApI_praBAva_se#piCalA_wAIKa_se/pUrvaNApI_praBAva_se#noun#4#RM
revenue_audit_section	rAjasva_leKAparIkRA_anuBAga#rAjasva_leKAparIkRA_anuBAga#noun#3#RM
review_,_the_year_under	Alocya_varRa#Alocya_varRa#noun#5#RM
review_in_audit_desclosed	leKAparIkRA_meM_samIkRA_se_pawA_lagAnA_Revised_assessment_saMSoXiwa_nirXAraNa#leKAparIkRA_meM_samIkRA_se_pawA_lagAnA_Revised_assessment_saMSoXiwa_nirXAraNa#noun#4#RM
review_section	samIkRA_anuBAga#samIkRA_anuBAga#noun#2#RM
road_bridge	sadZaka-pula#sadZaka-pula#noun#2#RM
road_overbridge	sadZaka_uparipula#sadZaka_uparipula#noun#2#RM
road_under_bridge	sadZaka_aXomArgI_pula#sadZaka_aXomArgI_pula#noun#3#RM
routine_manner_,_in	nemI_rUpa_meM#nemI_rUpa_meM#noun#4#RM
routine_section	nemIkArya_anuBAga#nemIkArya_anuBAga#noun#2#RM
run_short	kama_ho_jAnA#kama_ho_jAnA#noun#2#RM
safe_and_sound	surakRiwa#surakRiwa#noun#3#RM
sales_realisation	bikrI_prApwi#bikrI_prApwi#noun#2#RM
satisfied_,_conditions_are	SarweM_pUrI_howI_hE#SarweM_pUrI_howI_hE#noun#4#RM
save_as_otherwise_prescribed	jEsA_anyaWA_vihiwa_hE/use_CoZdZakara#jEsA_anyaWA_vihiwa_hE/use_CoZdZakara#noun#4#RM
saving_was_mainly_due_to_restrictions_imposed_on_creation/non-filing_of_vac	bacawa_muKyawa:_paxoM_ke_sqjana/riwa_paxoM_ke_Bare_jAne_para_lage_prawibaMXo_ke_kAraNa_huI_WI#bacawa_muKyawa:_paxoM_ke_sqjana/riwa_paxoM_ke_Bare_jAne_para_lage_prawibaMXo_ke_kAraNa_huI_WI#noun#11#RM
scope_,_considerable	paryApwa_guMjAiSa#paryApwa_guMjAiSa#noun#3#RM
secretary_to_the_comptroller_auditor_general	niyaMwraka-mahAleKAparIkRaka_kA_saciva#niyaMwraka-mahAleKAparIkRaka_kA_saciva#noun#6#RM
section_officer	anuBAga_aXikArI#anuBAga_aXikArI#noun#2#RM
selection_grade_auditor	pravaraNa_SreNI_leKAparIkRaka#pravaraNa_SreNI_leKAparIkRaka#noun#3#RM
selection_grade_clerk	pravaraNa_SreNI_lipika#pravaraNa_SreNI_lipika#noun#3#RM
selection_grade_daftry	pravaraNa_SreNI_xaPwarI#pravaraNa_SreNI_xaPwarI#noun#3#RM
selection_grade_lower_division_clerk	pravaraNa_SreNI_avara_SreNI_lipika#pravaraNa_SreNI_avara_SreNI_lipika#noun#5#RM
selection_grade_sorter	pravaraNa_SreNI_sOrtara#pravaraNa_SreNI_sOrtara#noun#3#RM
senior_auditor	variRTa_leKAparIkRaka#variRTa_leKAparIkRaka#noun#2#RM
senior_deputy_accountant_general	variRTa_upa_mahAleKAkAra#variRTa_upa_mahAleKAkAra#noun#4#RM
senior_deputy_director_of_audits_(_defence_sarvice	variRTa_upa-nixeSaka_leKA-_parIkRA_(rakRA_sevAeM)#variRTa_upa-nixeSaka_leKA-_parIkRA_(rakRA_sevAeM)#noun#8#RM
senior_gestetner_operator	variRTa_gestetanara_pracAlaka#variRTa_gestetanara_pracAlaka#noun#3#RM
sensitive_goods_of_diverse_nature	viviXa_prakAra_kI_sugrAhI_vaswueM#viviXa_prakAra_kI_sugrAhI_vaswueM#noun#5#RM
set_back	XakkA/hAni#XakkA/hAni#noun#2#RM
set_out	prasWAna_karanA#prasWAna_karanA#noun#2#RM
set_up	sWApiwa_karanA/DAcA#sWApiwa_karanA/DAcA#noun#2#RM
settlement_account_section	pariSoXana_leKA_anuBAga#pariSoXana_leKA_anuBAga#noun#3#RM
severally_,_jointly_and	saMyuwa_rUpa_se_Ora_pqWaka-pqWaka#saMyuwa_rUpa_se_Ora_pqWaka-pqWaka#noun#4#RM
shelf_life	SelPa_Ayu#SelPa_Ayu#noun#2#RM
short_demand_of_tax	kara_kI_kama_mAMga#kara_kI_kama_mAMga#noun#4#RM
short_levy_of_tax	kara_kA_kama_lagAyA_jAnA#kara_kA_kama_lagAyA_jAnA#noun#4#RM
short_term_capital	alpakAlika_pUMjI#alpakAlika_pUMjI#noun#3#RM
significant_excess_accrued_in_the_following_heads_of_accounts	nimnaliKiwa_leKA_SIrRoM_meM_bahuwa_aXika_vyaya_huA#nimnaliKiwa_leKA_SIrRoM_meM_bahuwa_aXika_vyaya_huA#noun#9#RM
simultaneous_action	eka_sAWa_kAraZvAI#eka_sAWa_kAraZvAI#noun#2#RM
since_its_inception	apanI_sWApanA_ke_samaya_se#apanI_sWApanA_ke_samaya_se#noun#3#RM
since_then	waba_se#waba_se#noun#2#RM
slow_moving_stores	kama_prayoga_meM_Ane_vAlA_BaNdAra#kama_prayoga_meM_Ane_vAlA_BaNdAra#noun#3#RM
so_far_as	jahAM_waka#jahAM_waka#noun#3#RM
so_far_as_may_be	jahAM_waka_ho_sake#jahAM_waka_ho_sake#noun#5#RM
so_far_as_possible	yaWAsaMBava/jahAM_waka_saMBava_ho#yaWAsaMBava/jahAM_waka_saMBava_ho#noun#4#RM
so_far_as_practicable	yaWAsaMBava/jahAM_waka_vyavahArya_ho#yaWAsaMBava/jahAM_waka_vyavahArya_ho#noun#4#RM
so_far_as_repeated_auctions_of_the_goods_are_concerned	jahA_waka_mAla_kI_bAra-bAra_kI_nIlAmI_kA_saMbaMXa_hE#jahA_waka_mAla_kI_bAra-bAra_kI_nIlAmI_kA_saMbaMXa_hE#noun#10#RM
so_long_as	jaba_waka_ki#jaba_waka_ki#noun#3#RM
sole_consideration	eka_mAwra_AXAra#eka_mAwra_AXAra#noun#2#RM
some_instances_are_discussed_in_detail	kuCa_uxAharaNoM_para_viswAra_se_carcA_kI_gaI#kuCa_uxAharaNoM_para_viswAra_se_carcA_kI_gaI#noun#6#RM
some_of_the_factors_which_contributed_to_the_delay_as_indentified_in_the_te	jEsA_ki_namUnA_jAMca_se_jFAwa_huA/vilamba_ke_kuCa_kAraNa_nimnaliKiwa_hE#jEsA_ki_namUnA_jAMca_se_jFAwa_huA/vilamba_ke_kuCa_kAraNa_nimnaliKiwa_hE#noun#14#RM
some_of_the_important_irregularities_noticed_in_audit_are_given_in_the_foll	leKAparIkRA_meM_pAI_gaI_mahawvapUrNa_aniyamiwawAeM_nimnaliKiwa_SreNiyoM_ke_anwargawa_anuvarwI_pErAgrAPoM_meM_xI_gaI_hE#leKAparIkRA_meM_pAI_gaI_mahawvapUrNa_aniyamiwawAeM_nimnaliKiwa_SreNiyoM_ke_anwargawa_anuvarwI_pErAgrAPoM_meM_xI_gaI_hE#noun#13#RM
specific_ientification_method	viSiRta_pahacAna_viXi_paxXawi#viSiRta_pahacAna_viXi_paxXawi#noun#3#RM
specific_rate	viSiRta_xara#viSiRta_xara#noun#2#RM
speculation_loss	Batte_ke_kArabAra_kI_hAni#Batte_ke_kArabAra_kI_hAni#noun#2#RM
sphere_of_duty	kArya-kRewra#kArya-kRewra#noun#3#RM
spiral_rise	uwwawarowwawara_vqfxXa#uwwawarowwawara_vqfxXa#noun#2#RM
splitting_of_supply_orders	pUrwi_AxeSoM_kA_viBAjana#pUrwi_AxeSoM_kA_viBAjana#noun#4#RM
spot_buying_rate	hAjira_kraya_xara#hAjira_kraya_xara#noun#3#RM
spot_selling_rate	hAjira_bikrI_xara#hAjira_bikrI_xara#noun#3#RM
staff_car_driver	stAPa_kAra_drAivara#stAPa_kAra_drAivara#noun#3#RM
stand_for	prawIka_honA/samarWana_karanA/ke_lie#prawIka_honA/samarWana_karanA/ke_lie#noun#2#RM
start_with_,_to	SurU_se#SurU_se#noun#4#RM
stipulated_,_as	jEsA_socA_gayA_WA/vinixiZRta#jEsA_socA_gayA_WA/vinixiZRta#noun#3#RM
stipulated_date_of_completion	samApana/pUrA_hone_kI_anubaxXa/niyawa_wArIKa#samApana/pUrA_hone_kI_anubaxXa/niyawa_wArIKa#noun#4#RM
stipulated_in_the_schedule	kAryakrama/anusUcI_meM_vinixiZRta#kAryakrama/anusUcI_meM_vinixiZRta#noun#4#RM
stipulation_as_to_time	samaya_ke_bAre_meM_anubaMXa/Sarwa#samaya_ke_bAre_meM_anubaMXa/Sarwa#noun#4#RM
stores_audit_section	BaMdAra_leKAparIkRA_anuBAga#BaMdAra_leKAparIkRA_anuBAga#noun#3#RM
stores_holdings	BaNdAroM_kI_XAriwA/BaNdAra_sampawwi#BaNdAroM_kI_XAriwA/BaNdAra_sampawwi#noun#2#RM
subject_to_the_terms	meM_xI_gaI_SawoZM_ke_aXyaXIna#meM_xI_gaI_SawoZM_ke_aXyaXIna#noun#4#RM
subject_to_verification	sawyApana_hone_para/sawyApana_ke_maXyaXIna#sawyApana_hone_para/sawyApana_ke_maXyaXIna#noun#3#RM
subsequent_action	bAxa_kI_kAraZvAI/paravarwI_kAraZvAI#bAxa_kI_kAraZvAI/paravarwI_kAraZvAI#noun#2#RM
such_as_that	yaWA/jEse#yaWA/jEse#noun#3#RM
sufficient_cause	paryApwa_kAraNa#paryApwa_kAraNa#noun#2#RM
sufficient_ground	paryApwa_AXAra#paryApwa_AXAra#noun#2#RM
suitable_action	uciwa_kAraZvAI#uciwa_kAraZvAI#noun#2#RM
sum_and_substance	sArAMSa#sArAMSa#noun#3#RM
summarised_position_of_actual_expenditure_against_grants/appropriation	anuxAnoM/viniyogoM_kI_wulanA_meM_vAswavika_vyaya_kI_saMkRipwa_sWiwa#anuxAnoM/viniyogoM_kI_wulanA_meM_vAswavika_vyaya_kI_saMkRipwa_sWiwa#noun#7#RM
support_of_,_in	ke_samarWana_meM#ke_samarWana_meM#noun#4#RM
supression_of_,_in	kA_aXikramaNa_karawe_hue#kA_aXikramaNa_karawe_hue#noun#4#RM
surprise_inspection	akasmAwa_nirIkRaNa_Akafsmaka_nirIkRaNa#akasmAwa_nirIkRaNa_Akafsmaka_nirIkRaNa#noun#2#RM
tailor_made	waxanukUla#waxanukUla#noun#2#RM
take_effect	praBAvI_honA/lAgU_honA#praBAvI_honA/lAgU_honA#noun#2#RM
take_exception	Apawwawi_uTAnA#Apawwawi_uTAnA#noun#2#RM
take_for_granted	mAna_lenA/mAna_kara_-lanA#mAna_lenA/mAna_kara_-lanA#noun#3#RM
take_place	honA/Gatiwa_honA#honA/Gatiwa_honA#noun#2#RM
take_stock_of_the_situation	sWiwa_ko_samakRa_lenA_sWiwa_kA_jAyajA_lenA#sWiwa_ko_samakRa_lenA_sWiwa_kA_jAyajA_lenA#noun#5#RM
take_up	hAWa_meM_lenA/uTA_lenA/le_lenA/SurU_karanA#hAWa_meM_lenA/uTA_lenA/le_lenA/SurU_karanA#noun#2#RM
target_to_complete	pUrA_karane_kA_lakRya#pUrA_karane_kA_lakRya#noun#3#RM
targetted_production	lakRiwa_uwpAxana#lakRiwa_uwpAxana#noun#2#RM
tax_holiday_relief	kara-avakASa_rAhawa#kara-avakASa_rAhawa#noun#3#RM
technical_administration_sectio	wakanIkI_praSAsana_anuBAga#wakanIkI_praSAsana_anuBAga#noun#3#RM
techno-economic_study	prOfxyagikIya-ArWika_aXyayana#prOfxyagikIya-ArWika_aXyayana#noun#2#RM
telephone_operator	telIPona_pracAlaka#telIPona_pracAlaka#noun#2#RM
terminal_detentions	tarminala_para_roke_jAne_kI_avaXi#tarminala_para_roke_jAne_kI_avaXi#noun#2#RM
terms_and_conditions_stipulated_in_the_contract	Teke_meM_anubaMXiwa_nibaMXana_Ora_SarweM#Teke_meM_anubaMXiwa_nibaMXana_Ora_SarweM#noun#7#RM
test_audit_section	namUnA_leKAparIkRA_anuBAga#namUnA_leKAparIkRA_anuBAga#noun#3#RM
that_is	aWAZw#aWAZw#noun#2#RM
that_is_to_say	aWAZwa#aWAZwa#noun#4#RM
the_appraisal_undertaken_by_audit_board	leKAparIkRA_borda_xvArA_kiyA_gayA_mUlyAMkana#leKAparIkRA_borda_xvArA_kiyA_gayA_mUlyAMkana#noun#6#RM
the_following_interesting_points_have_emerged	nimnaliKiwa_rucikara_bAweM_sAmane_AI_hE#nimnaliKiwa_rucikara_bAweM_sAmane_AI_hE#noun#6#RM
the_following_points_arise_in_this_case	isa_mAmale_meM_nimnaliKiwa_muxxe_sAmane_Awe_hEM#isa_mAmale_meM_nimnaliKiwa_muxxe_sAmane_Awe_hEM#noun#7#RM
the_following_points_need_consideration	nimnaliKiwa_bAwoM_para_vicAra_kie_jAne_kI_AvaSyakawA_hE#nimnaliKiwa_bAwoM_para_vicAra_kie_jAne_kI_AvaSyakawA_hE#noun#5#RM
the_matter_has_since_been_resolved	mAmale_kA_samAXAna_ho_gayA/kara_liyA_gayA_hE#mAmale_kA_samAXAna_ho_gayA/kara_liyA_gayA_hE#noun#6#RM
the_performance_exceeded_the_target	niRpAxana_lakRya_se_aXika_hE#niRpAxana_lakRya_se_aXika_hE#noun#5#RM
the_slow_progress_of_work_was_attributed_to	kArya_kI_XImI_pragawi_ke_nimnaliKiwa_kAraNa_bawAe_gae#kArya_kI_XImI_pragawi_ke_nimnaliKiwa_kAraNa_bawAe_gae#noun#8#RM
the_trend_of_performance_so_far_indicates	aBI_waka_ke_niRpAxana_kI_pravqwwi_yaha_xarSAwI_hE#aBI_waka_ke_niRpAxana_kI_pravqwwi_yaha_xarSAwI_hE#noun#7#RM
the_work_was_released_for_execution	kArya_niRpAxana_ke_lie_xe_xiyA_gayA#kArya_niRpAxana_ke_lie_xe_xiyA_gayA#noun#6#RM
then_and_there	usI_samaya#usI_samaya#noun#3#RM
therein_,_mentioned	usameM_uflliKawa#usameM_uflliKawa#noun#3#RM
this_is_indicative_of_in-adequate_and_ineffective_planning	isase_aparyApwa_Ora_niRpraBAvI_Ayojana_kA_saMkewa_milawA_hE#isase_aparyApwa_Ora_niRpraBAvI_Ayojana_kA_saMkewa_milawA_hE#noun#8#RM
this_led_to_short_computation_of_tax	isake_pariNAmasvarUpa_kara_kI_kama_saMga_nA_huI#isake_pariNAmasvarUpa_kara_kI_kama_saMga_nA_huI#noun#7#RM
this_resulted_in_an_extra_expenditure_of	isake_pariNAmasvarUpa-ru-_kA_awiriwa_vyaya_huA#isake_pariNAmasvarUpa-ru-_kA_awiriwa_vyaya_huA#noun#7#RM
though_period_of...years_has_elapsed	yaxyapi-varRa_gujara_-cuke_hEM#yaxyapi-varRa_gujara_-cuke_hEM#noun#5#RM
till_further_orders	agalA_AxeSa_hone_waka#agalA_AxeSa_hone_waka#noun#3#RM
time_and_again	bAra-bAra#bAra-bAra#noun#3#RM
time_and_cost_over_runs	aXika_samaya_Ora_lAgawa_kA_laganA#aXika_samaya_Ora_lAgawa_kA_laganA#noun#5#RM
to_accord_priority	prAWamikawA_xenA#prAWamikawA_xenA#noun#3#RM
to_and_fro	iXara-uXara#iXara-uXara#noun#3#RM
to_conform_to_specification	BArawIya_mAnaka_viSiRtiyoM_ke_anurUpa_honA#BArawIya_mAnaka_viSiRtiyoM_ke_anurUpa_honA#noun#4#RM
to_effect_working_adversely	kAryacAlana_para_prawikUla_praBAva_dAlanA#kAryacAlana_para_prawikUla_praBAva_dAlanA#noun#4#RM
to_exercise_the_administrative_and_financial_powers	praSAsanika_Ora_viwwIya_SawiyoM_kA_prayoga_karanA#praSAsanika_Ora_viwwIya_SawiyoM_kA_prayoga_karanA#noun#7#RM
to_extent_anticipated	prawyASiwa_sImA_waka#prawyASiwa_sImA_waka#noun#3#RM
to_find_ways_and_means	upAya_nikAlanA#upAya_nikAlanA#noun#5#RM
to_foot_the_extra_cost	awiriwa_lAgawa_vahana_karanA#awiriwa_lAgawa_vahana_karanA#noun#5#RM
to_give_commercial_bias_to_mineral_exploration	Kanija_gaveRaNA_ko_vANifjyaka_rUpa_xenA#Kanija_gaveRaNA_ko_vANifjyaka_rUpa_xenA#noun#7#RM
to_have_key_role	mahawvapUrNa_BUmikA_axA_karanA#mahawvapUrNa_BUmikA_axA_karanA#noun#4#RM
to_initiate_action	kAraZvAI_AramBa_karanA#kAraZvAI_AramBa_karanA#noun#3#RM
to_observe_utmost_economy	awyaXika_kiPAyawa_barawanA#awyaXika_kiPAyawa_barawanA#noun#4#RM
to_obviate_idle_time	nifRkraya_samaya_ke_nirAkara#nifRkraya_samaya_ke_nirAkara#noun#4#RM
to_resort_to	sahArA_lenA#sahArA_lenA#noun#3#RM
to_supply_according_to_schedule	kAryakrama_ke_anusAra_ApUrwi#kAryakrama_ke_anusAra_ApUrwi#noun#5#RM
to_take_remedial_action_to_avoid_recurrence_of_such_cases	ese_mAmaloM_kI_punarAvqwwi_rokane_ke_lie_upacArI_kAraZvAI_karanA#ese_mAmaloM_kI_punarAvqwwi_rokane_ke_lie_upacArI_kAraZvAI_karanA#noun#10#RM
to_the_contrary	isake_viparIwa/viroXa_meM#isake_viparIwa/viroXa_meM#noun#3#RM
to_the_extent	sImA_waka#sImA_waka#noun#3#RM
to_the_miximum_extent_possible	samBAvya_aXikawama_sImA/mAwrA_waka#samBAvya_aXikawama_sImA/mAwrA_waka#noun#5#RM
to_the_point	saMgawa#saMgawa#noun#3#RM
to_the_prescribed_extent	vihiwa_sImA/parimANa_waka#vihiwa_sImA/parimANa_waka#noun#4#RM
total_amount_collected_during_the_years_and_the_corresponding_percentages_d	varRa_ke_xOrAna_vasUla_kI_gaI_kula_rASi_Ora_gawa_varRa_ke_xOrAna_waxanurUpI_prawiSawawA#varRa_ke_xOrAna_vasUla_kI_gaI_kula_rASi_Ora_gawa_varRa_ke_xOrAna_waxanurUpI_prawiSawawA#noun#11#RM
traffic_audit_section	yAwAyAwa_leKAparIkRA_anuBAga#yAwAyAwa_leKAparIkRA_anuBAga#noun#3#RM
training_section	praSikRaNa_anuBAga#praSikRaNa_anuBAga#noun#2#RM
transport_audit_section	parivahana_leKAparIkRA_anuBAga#parivahana_leKAparIkRA_anuBAga#noun#3#RM
treasury_accounts_section	KajAnA_leKA_anuBAga#KajAnA_leKA_anuBAga#noun#3#RM
treasury_compilation_deptt.	KajAnA_saMkalana_anuBAga#KajAnA_saMkalana_anuBAga#noun#3#RM
treasury_miscellaneous_section	KajAnA_viviXa_anuBAga#KajAnA_viviXa_anuBAga#noun#3#RM
trial_order	parIkRaNa_AxeSa#parIkRaNa_AxeSa#noun#2#RM
turn_round	PerA_samaya/virAma_kAla#PerA_samaya/virAma_kAla#noun#2#RM
turn_table	GUma_cakra#GUma_cakra#noun#2#RM
type_and_despatch_section	tAipa_waWA_nirgama_viBAga#tAipa_waWA_nirgama_viBAga#noun#4#RM
unavoidable_circumstances	aparihArya_parisWiwayAM#aparihArya_parisWiwayAM#noun#2#RM
uncalled_for	anuciwa#anuciwa#noun#2#RM
under_charge	avapraBAra#avapraBAra#noun#2#RM
under_the_style_of	ke_afBanAma_se#ke_afBanAma_se#noun#4#RM
under_utilisation_of_capacity_created_in_workshop/factory	kAryaSAlA/PEktarI_meM_sqjiwa_kRamawA_kA_pUrNa_upayoga_honA#kAryaSAlA/PEktarI_meM_sqjiwa_kRamawA_kA_pUrNa_upayoga_honA#noun#7#RM
under_utilisation_of_line_capacity	lAina_kRamawA_kA_pUrNa_upayoga_honA#lAina_kRamawA_kA_pUrNa_upayoga_honA#noun#5#RM
unintended_benefit_to_contractor	TekexAra_ko_anafBaprewa_lABa#TekexAra_ko_anafBaprewa_lABa#noun#4#RM
uninterrupted_water_supply	pAnI_kI_niranwara/lagAwAra_ApUrwi#pAnI_kI_niranwara/lagAwAra_ApUrwi#noun#3#RM
unproductive_investment	anuwpAxaka_niveSa#anuwpAxaka_niveSa#noun#2#RM
unsatisfactory_performance	asaMwoRajanaka_niRpAxana#asaMwoRajanaka_niRpAxana#noun#2#RM
upper_division_clerk	ucca_SrecI_lipika#ucca_SrecI_lipika#noun#3#RM
ups_and_down	uwWAna-pawana#uwWAna-pawana#noun#3#RM
valuation_date	mUlyAMkana_kI_wArIKa#mUlyAMkana_kI_wArIKa#noun#2#RM
variations_are_due_to_rounding_off	anwara_pUrNAMkana_ke_kAraNa_hE#anwara_pUrNAMkana_ke_kAraNa_hE#noun#6#RM
verified_and_found_correct	jAMca_kI_Ora_sahI_pAyA_sawyApiwa_kiyA_Ora_sahI_pAyA#jAMca_kI_Ora_sahI_pAyA_sawyApiwa_kiyA_Ora_sahI_pAyA#noun#4#RM
vests_in	meM_nihiwa_hE#meM_nihiwa_hE#noun#2#RM
viewed_in_the_above_context	uparowa_saMxaBaZ_meM_xeKane_para#uparowa_saMxaBaZ_meM_xeKane_para#noun#5#RM
war_risk_pension_section	yuxXa_joKima_peMSana_anuBAga#yuxXa_joKima_peMSana_anuBAga#noun#4#RM
was_of_the_view	kA_vicAra_WA#kA_vicAra_WA#noun#4#RM
welfare_assistant	kalyANa-sahAyaka#kalyANa-sahAyaka#noun#2#RM
welfare_officer	kalyANa_aXikArI#kalyANa_aXikArI#noun#2#RM
whichever_is_earlier	jo_BI_pahale_ho#jo_BI_pahale_ho#noun#3#RM
whole_,_as	kula_milAkara/saMBavawa:#kula_milAkara/saMBavawa:#noun#3#RM
wishes_to_place_on_record_his_appreciation_of_work_done	kie_gae_kArya_kI_sarAhanA_karawe_hEM#kie_gae_kArya_kI_sarAhanA_karawe_hEM#noun#10#RM
with_due_regard_to	kA_samyaka_XyAna_raKawe_hue#kA_samyaka_XyAna_raKawe_hue#noun#4#RM
with_effect_from	se_praBAvI#se_praBAvI#noun#3#RM
with_full_particulars	pUre_byOre_ke_sAWa/pUrNa_byOroM_sahiwa#pUre_byOre_ke_sAWa/pUrNa_byOroM_sahiwa#noun#3#RM
with_immediate_effect	wuraMwa/wawkAla#wuraMwa/wawkAla#noun#3#RM
with_reference_to	ke_saMbaMXa_meM/ke_saMxaBaZ_meM#ke_saMbaMXa_meM/ke_saMxaBaZ_meM#noun#3#RM
with_the_concurrence_of	kI_sahamawi_se#kI_sahamawi_se#noun#4#RM
with_the_result_that	isake_pariNAmasvarUpa/pariNAmawa:#isake_pariNAmasvarUpa/pariNAmawa:#noun#4#RM
with_view_to	jisase_ki/kI_Rti_se/ueSya_se#jisase_ki/kI_Rti_se/ueSya_se#noun#3#RM
with_view_to_halting_falling_trend	girawI_pravqwwi_ko_rokane_ke_uxxeSya_se#girawI_pravqwwi_ko_rokane_ke_uxxeSya_se#noun#6#RM
without_any_further_reference	binA_kisI_Ora_saMxaBaZ_ke#binA_kisI_Ora_saMxaBaZ_ke#noun#4#RM
without_assigning_any_reasons	binA_koI_kAraNa_bawAe#binA_koI_kAraNa_bawAe#noun#4#RM
without_fail	binA_cUke/avaSyameva#binA_cUke/avaSyameva#noun#2#RM
without_the_consent_of	kI_sahamawi_ke_binA#kI_sahamawi_ke_binA#noun#4#RM
working_order_,_in	cAlU_hAlawa_meM#cAlU_hAlawa_meM#noun#4#RM
works_audit_department	nirmANa-kArya_leKAparIkRA_viBAga#nirmANa-kArya_leKAparIkRA_viBAga#noun#3#RM
works_miscellaneous_section	nirmANa-kArya_viviXa_anuBAga#nirmANa-kArya_viviXa_anuBAga#noun#3#RM
workshop_audit_department	varkaSApa_leKAparIkRA_viBAga#varkaSApa_leKAparIkRA_viBAga#noun#3#RM
would_indicate_concrete_terms	spaRta_SabxoM_meM_bawAegA#spaRta_SabxoM_meM_bawAegA#noun#4#RM
written_down_value	avaleKiwa_mUlya#avaleKiwa_mUlya#noun#3#RM
wrong_placement	galawa_jagaha_lagAyA_jAnA#galawa_jagaha_lagAyA_jAnA#noun#2#RM
wrought_product	gaDZA_huA_uwpAxa#gaDZA_huA_uwpAxa#noun#2#RM
year_to_year	prawi_varRa/hara_sAla/vaRAZnuvarRa#prawi_varRa/hara_sAla/vaRAZnuvarRa#noun#3#RM
