#Source :: Extracted this dictionary from agriculture1_wiktionary.txt and agriculture2_wiktionary.txt, Agri_Glossaryt.doc
#Changes:: 1) Separated single word and multi words into separate dictionaries
#          2) English words are converted to lower case
#          3) Added category as 'noun#2#RM' by default
#Added  :: By Roja Lakshmi (06-11-14)
#######################################
aberrant_weather	asamAnya_mOsama#asamAnya_mOsama#noun#2#RM
abiotic_stress	ajEvika_xabAva#ajEvika_xabAva#noun#2#RM
aborted_seed	vikAsaroXiwa_bIja#vikAsaroXiwa_bIja#noun#2#RM
abscess_knife	PodZA_cIrane_kA_cAkU#PodZA_cIrane_kA_cAkU#noun#2#RM
absorption_loss	avaSoRaNa_hAni#avaSoRaNa_hAni#noun#2#RM
accelerated_erosion	wvariwa_aparaxana#wvariwa_aparaxana#noun#2#RM
accumulated_capital	saMciwa_pUzjI#saMciwa_pUzjI#noun#2#RM
accumulation_of_salt	lavaNa_saMcaya#lavaNa_saMcaya#noun#2#RM
acid_clay	amla_mqwwikA#amla_mqwwikA#noun#2#RM
acid_forming_fertiliser	amlakArI_urvaraka#amlakArI_urvaraka#noun#2#RM
acid_forming_fertilizer	amlakArI_urvaraka#amlakArI_urvaraka#noun#2#RM
acidic_rock	aXisivika_SEla#aXisivika_SEla#noun#2#RM
acidity_test	amlawA_parIkRaNa#amlawA_parIkRaNa#noun#2#RM
acid_soil	amlIya_mqxA#amlIya_mqxA#noun#2#RM
acid_value	amla_mAna#amla_mAna#noun#2#RM
active_absorption	sakriya_avaSoRaNa#sakriya_avaSoRaNa#noun#2#RM
active_ingradient_(a.i.)	sakriya_wawva/sakriya_avayava#sakriya_wawva/sakriya_avayava#noun#2#RM
actual_cost	vAswavika_lAgawa#vAswavika_lAgawa#noun#2#RM
actual_evapotranspiration	vAswavika_vARpana_vARpowsarjana#vAswavika_vARpana_vARpowsarjana#noun#2#RM
actual_expenditure	vAswavika_vyaya#vAswavika_vyaya#noun#2#RM
adapted_varieties	anukUliwa_kismeM#anukUliwa_kismeM#noun#2#RM
additive_effect	saMyojI_praBAva#saMyojI_praBAva#noun#2#RM
additive_gene_interaction	saMyogika_jIna_anyonyakriyA#saMyogika_jIna_anyonyakriyA#noun#2#RM
additive_gene	saMyogika_jIna#saMyogika_jIna#noun#2#RM
adjusted_price	samAyojiwa_kZImawa#samAyojiwa_kZImawa#noun#2#RM
administrative_coordination	praSAsakIya_samanvaya#praSAsakIya_samanvaya#noun#2#RM
adobe_soil	IMta_mqxA#IMta_mqxA#noun#2#RM
adopted_variety	anukUliwa_kZisma#anukUliwa_kZisma#noun#2#RM
advalorem_duty	yaWAmUlya_Sulka#yaWAmUlya_Sulka#noun#2#RM
adventitious_grass	apasWAnika_GAsa/apasWAnikaGAsa#apasWAnika_GAsa/apasWAnikaGAsa#noun#2#RM
adventitious_root	apasWAnika_mUla#apasWAnika_mUla#noun#2#RM
advisory_committee	salAhakAra_samiwi#salAhakAra_samiwi#noun#2#RM
advisory_council	salAhakAra_pariRaxa#salAhakAra_pariRaxa#noun#2#RM
aeolian_deposit	vAwoDZa_nikRepa#vAwoDZa_nikRepa#noun#2#RM
aeolian_soil	vAwoDZa_mqxA#vAwoDZa_mqxA#noun#2#RM
aerating_root	vAyugrAhI_mUla#vAyugrAhI_mUla#noun#2#RM
aerial_growth	vAyava_vqxXi#vAyava_vqxXi#noun#2#RM
aerial_layering	gUtI_bAMXanA#gUtI_bAMXanA#noun#2#RM
aerial_root	vAyava_mUla#vAyava_mUla#noun#2#RM
aerial_stem	vAyavI_yawanA#vAyavI_yawanA#noun#2#RM
aerobic_bacteria	vAyujIvI_bEktIri_yA#vAyujIvI_bEktIri_yA#noun#2#RM
aerobic_decomposition	vAyu_apaGatana#vAyu_apaGatana#noun#2#RM
after_crop	uwwara_sasya#uwwara_sasya#noun#2#RM
after_growth	punavqrxXi#punavqrxXi#noun#2#RM
after_ripening	pAkowwara#pAkowwara#noun#2#RM
age_of_farmer	kqRaka_Ayu/kisAna_kI_umra#kqRaka_Ayu/kisAna_kI_umra#noun#2#RM
agricultural_capital	kqRigawa_pUzjI#kqRigawa_pUzjI#noun#2#RM
agricultural_class	Kewihara_varga#Kewihara_varga#noun#2#RM
agricultural_commission	kqRi_Ayoga#kqRi_Ayoga#noun#2#RM
agricultural_credit	kqRi_uXAra/kqRi_sAKa#kqRi_uXAra/kqRi_sAKa#noun#2#RM
agricultural_credit_society	kqRi_uXAra_samiwi/kqRi_sAKa_samiwi#kqRi_uXAra_samiwi/kqRi_sAKa_samiwi#noun#2#RM
agricultural_debt_relief_act	kqRi_qNa_vimocana_aXiniyama#kqRi_qNa_vimocana_aXiniyama#noun#2#RM
agricultural_department	kqRi_viBAga#kqRi_viBAga#noun#2#RM
agricultural_depression	kqRi_maMxI#kqRi_maMxI#noun#2#RM
agricultural_economics	kqRi_ArWikI/kqRi_arWaSAswra#kqRi_ArWikI/kqRi_arWaSAswra#noun#2#RM
agricultural_eco-system	kqRi_pArisWiwikI#kqRi_pArisWiwikI#noun#2#RM
agricultural_efficiency	kqRi_kuSalawA#kqRi_kuSalawA#noun#2#RM
agricultural_extension	kqRi_prasAra/viswAra#kqRi_prasAra/viswAra#noun#2#RM
agricultural_forecasting	kqRi_pUrvAnumAna#kqRi_pUrvAnumAna#noun#2#RM
agricultural_hazard	kqRi_vipaxA#kqRi_vipaxA#noun#2#RM
agricultural_income	kqRi_Aya#kqRi_Aya#noun#2#RM
agriculturally_important	kqRi_upayogI#kqRi_upayogI#noun#2#RM
agricultural_machinery	kqRi_yaMwra#kqRi_yaMwra#noun#2#RM
agricultural_marketing	kqRi_vipaNana#kqRi_vipaNana#noun#2#RM
agricultural_minimum_wages	nyUnawama_kqRi_majZaxUrI#nyUnawama_kqRi_majZaxUrI#noun#2#RM
agricultural_operation	kqRi_kArya#kqRi_kArya#noun#2#RM
agricultural_planning	kqRi_Ayojana/kqRi_yojanA#kqRi_Ayojana/kqRi_yojanA#noun#2#RM
agricultural_policy	kqRi_nIwi#kqRi_nIwi#noun#2#RM
agricultural_practice	kqRi_kriyA#kqRi_kriyA#noun#2#RM
agricultural_produce	kqRi_upaja#kqRi_upaja#noun#2#RM
agricultural_production	kqRi_uwpAxana#kqRi_uwpAxana#noun#2#RM
agricultural_product	kqRi_uwpAxa#kqRi_uwpAxa#noun#2#RM
agricultural_profit	kqRi_lABa#kqRi_lABa#noun#2#RM
agricultural_purpose	kqRi_uxxeSya#kqRi_uxxeSya#noun#2#RM
agricultural_research_centre	kqRi_anusaMXAna_keMxra#kqRi_anusaMXAna_keMxra#noun#2#RM
agricultural_research_institute	kqRi_anusaMXAna_saMsWAna#kqRi_anusaMXAna_saMsWAna#noun#2#RM
agricultural_sector	kqRi_kRewra#kqRi_kRewra#noun#2#RM
agricultural_society	kqRi_samiwi#kqRi_samiwi#noun#2#RM
agricultural_stage	kqRi_avasWA#kqRi_avasWA#noun#2#RM
Agricultural_system	kqRi_praNAlI#kqRi_praNAlI#noun#2#RM
agricultural_wages	kqRi_majZaxUrI#kqRi_majZaxUrI#noun#2#RM
agrilcultural_economy	kqRi_arWavyavasWA#kqRi_arWavyavasWA#noun#2#RM
agroforestry_system	kqRi_vAnikI_praNAlI#kqRi_vAnikI_praNAlI#noun#2#RM
agronomic_character	sasyIya_aBilakRaNa#sasyIya_aBilakRaNa#noun#2#RM
agronomic_research	sasyIya_anusaMXAna#sasyIya_anusaMXAna#noun#2#RM
agronomic_value	sasyIya_mAna#sasyIya_mAna#noun#2#RM
air_chamber	vAyu_kakRa#vAyu_kakRa#noun#2#RM
air_drainage	vAyu_nikAsa#vAyu_nikAsa#noun#2#RM
air_dry_soil	vAwa_SuRka_mqxA#vAwa_SuRka_mqxA#noun#2#RM
air_layering	gUtI_bAMXanA#gUtI_bAMXanA#noun#2#RM
air_permeability	vAyu_pAragamyawA#vAyu_pAragamyawA#noun#2#RM
air_porosity	vAwa_saraMXrawA#vAwa_saraMXrawA#noun#2#RM
alkali_disease	kRArIya_roga#kRArIya_roga#noun#2#RM
alkaline_soil	KArI_mqxA/kRArIya_mqxA/Usara_mittI#KArI_mqxA/kRArIya_mqxA/Usara_mittI#noun#2#RM
alkaline_toxicity	kRArIya_AviRAluwA#kRArIya_AviRAluwA#noun#2#RM
alkali_soil	kRArIya_mqxA#kRArIya_mqxA#noun#2#RM
allied_fibres	sambaxXa_reSe#sambaxXa_reSe#noun#2#RM
allied_science	sambaxXa_vijFAna#sambaxXa_vijFAna#noun#2#RM
allitic_soil	elAitika_mqxA#elAitika_mqxA#noun#2#RM
alluval_soil	jaloDZa_mittI#jaloDZa_mittI#noun#2#RM
alluvial_deposits	jaloDZa_nikRepa#jaloDZa_nikRepa#noun#2#RM
alluvial_fan	jaloDZa_PElAva#jaloDZa_PElAva#noun#2#RM
alluvial_material	jaloDZa_sAmagrI#jaloDZa_sAmagrI#noun#2#RM
alluvial_plain	jaloDZa_mExAna#jaloDZa_mExAna#noun#2#RM
alluvial_soil	jaloDa_mqxA/jaloDZa_mqxA#jaloDa_mqxA/jaloDZa_mqxA#noun#2#RM
almond_crown_gall	bAxAma_SiKara_pitikA#bAxAma_SiKara_pitikA#noun#2#RM
almond_mosaic	bAxAma_mojeka#bAxAma_mojeka#noun#2#RM
alpine_ecology	AlpIya_pArisWiwikI#AlpIya_pArisWiwikI#noun#2#RM
alpine_meadow_soils	Alpina_mIdZova_sAilsa#Alpina_mIdZova_sAilsa#noun#2#RM
alternaria_blight	AltaraneriyA_blAita#AltaraneriyA_blAita#noun#2#RM
alternaria_leaf_bright	pawwI_Xabbe#pawwI_Xabbe#noun#2#RM
alternate_husbandry	vEkalpika_XaMXA#vEkalpika_XaMXA#noun#2#RM
alternative_cost	vEkalpika_lAgawa#vEkalpika_lAgawa#noun#2#RM
alternative_goal	vEkalpika_lakRya#vEkalpika_lakRya#noun#2#RM
alternative_hypothesis	vEkalpika_parikalpanA#vEkalpika_parikalpanA#noun#2#RM
alternative_inheritance	anyawara_vaMSAgawi#anyawara_vaMSAgawi#noun#2#RM
ambient_temperature	pariveSa_wApa#pariveSa_wApa#noun#2#RM
amendment_soil	saMSoXiwa_mqxA#saMSoXiwa_mqxA#noun#2#RM
ammonia_oxidation	amoniyA_AksIkaraNa#amoniyA_AksIkaraNa#noun#2#RM
ammonia_synthesis	amoniyA_saMSleRaNa#amoniyA_saMSleRaNa#noun#2#RM
ammonical_fermentation	amoniyA_kiNvana#amoniyA_kiNvana#noun#2#RM
anaerobic_bacteria	avAyujIvI_jIvANu#avAyujIvI_jIvANu#noun#2#RM
anaerobic_decomposition	avAyu_apaGatana#avAyu_apaGatana#noun#2#RM
anaerobic_respiration	anAksI_Svasana#anAksI_Svasana#noun#2#RM
analysis_of_covariance	sahavicaraNa_viSleRaNa,#sahavicaraNa_viSleRaNa,#noun#2#RM
analysis_of_data	AMkadZoM_kA_viSleRaNa#AMkadZoM_kA_viSleRaNa#noun#2#RM
analysis_of_date	AzkadZoM_kA_viSleRaNa#AzkadZoM_kA_viSleRaNa#noun#2#RM
analysis_of_variance	vicaraNa_viSleRaNa#vicaraNa_viSleRaNa#noun#2#RM
analytical_statistics	viSleRaNAwmaka_sAMKyikI#viSleRaNAwmaka_sAMKyikI#noun#2#RM
analytical_technique	viSleRaNAwmaka_praviXi#viSleRaNAwmaka_praviXi#noun#2#RM
anarchistic_tendencies	arAjaka_pravqwwiyAM#arAjaka_pravqwwiyAM#noun#2#RM
angular_arrangement	koNIya_vinyAsa#koNIya_vinyAsa#noun#2#RM
angular_leaf_spot	koNIya_parNaxAga#koNIya_parNaxAga#noun#2#RM
animal_breeding	paSu_prajanana#paSu_prajanana#noun#2#RM
animal_carcase	paSu_Rava#paSu_Rava#noun#2#RM
animal_disease	paSu_roga#paSu_roga#noun#2#RM
animal_husbandry	paSupAlana#paSupAlana#noun#2#RM
animal_nutrition	paSu_poRaNa/paSu_poSaNa#paSu_poRaNa/paSu_poSaNa#noun#2#RM
animal_tankage	paSu_garwAvaReSa#paSu_garwAvaReSa#noun#2#RM
anion_solubilization	qNAyana_vilayana#qNAyana_vilayana#noun#2#RM
annual_return	vArSika_vivaraNI#vArSika_vivaraNI#noun#2#RM
annual_ring	vArSika_vilaya#vArSika_vilaya#noun#2#RM
annual_shoot	vArSika_praroha#vArSika_praroha#noun#2#RM
annual_statement	vArRika_vivaraNa#vArRika_vivaraNa#noun#2#RM
annual_summary	vArRika_sArAMSa#vArRika_sArAMSa#noun#2#RM
annual_tender	vArSika_komala_pOXA#vArSika_komala_pOXA#noun#2#RM
annual_yield	vArSika_upaja#vArSika_upaja#noun#2#RM
antagonism_of_ion	Ayana_viroXawA#Ayana_viroXawA#noun#2#RM
antagonistic_capacity	viroXI_kRamawA#viroXI_kRamawA#noun#2#RM
antagonistic_fungi	viroXI_kavaka#viroXI_kavaka#noun#2#RM
antagonistic_microorganism	viroXI_sUkRmajIva#viroXI_sUkRmajIva#noun#2#RM
anterior_presentation	agra_garBapraswuwi#agra_garBapraswuwi#noun#2#RM
ant_hill_earth	vAlmIki_mittI#vAlmIki_mittI#noun#2#RM
anthropic_soil	kqwrima_mqxA#kqwrima_mqxA#noun#2#RM
antibacterial_agent	prawijIvANu_kAraka#prawijIvANu_kAraka#noun#2#RM
anti_bacterial	prawijIvANuka#prawijIvANuka#noun#2#RM
antibactetial_agent	jIvANuroXI_kAraka#jIvANuroXI_kAraka#noun#2#RM
anti_cyclone	prawicakravAwa#prawicakravAwa#noun#2#RM
anti_foaming_agent	PenaroXI_kAraka#PenaroXI_kAraka#noun#2#RM
anti_freezing	himanaroXI#himanaroXI#noun#2#RM
anti_friction	prawiGarSaNa_beyariMga#prawiGarSaNa_beyariMga#noun#2#RM
apical_angle	SiKAgra_koNa#SiKAgra_koNa#noun#2#RM
apical_bud	SIrRasWa_kalikA#SIrRasWa_kalikA#noun#2#RM
apical_cell	SiKAgra_koSikA#SiKAgra_koSikA#noun#2#RM
apical_cleavage	SIrRasWa_vixalana#SIrRasWa_vixalana#noun#2#RM
apical_dominance	SiKAgra_praBAviwA#SiKAgra_praBAviwA#noun#2#RM
apical_growth	SIrRa_vqxXi/agra_vqxXi/SIrRa_vqxXi#SIrRa_vqxXi/agra_vqxXi/SIrRa_vqxXi#noun#2#RM
apple_blotch	seba_kA_xAga#seba_kA_xAga#noun#2#RM
apple_fruit_weevil	seba_kA_Guna#seba_kA_Guna#noun#2#RM
apple_rust	seba_kitta#seba_kitta#noun#2#RM
applied_economics	anuprayukwa_arWaSAsZwra#anuprayukwa_arWaSAsZwra#noun#2#RM
applied_force	prayukwa_bala#prayukwa_bala#noun#2#RM
appraised_value	AMkAgayAmUlya/AzkA_mUlya#AMkAgayAmUlya/AzkA_mUlya#noun#2#RM
approach_grafting	milAna_ropaNa#milAna_ropaNa#noun#2#RM
approved_variety	svIkqwa_kisma#svIkqwa_kisma#noun#2#RM
aquatic_plant	jalIyapOXA#jalIyapOXA#noun#2#RM
aqueous_extractants	jalIya_niSkarSaka#jalIya_niSkarSaka#noun#2#RM
aqueous_solution	jalIya_Gola#jalIya_Gola#noun#2#RM
aqueous_tissue	jalIya_uwaka#jalIya_uwaka#noun#2#RM
arable_land	kqRya_BUmi/kqRi_yogya_BUmi/KewI_ke_wahawa_kRewra/kqSya_BUmi#kqRya_BUmi/kqRi_yogya_BUmi/KewI_ke_wahawa_kRewra/kqSya_BUmi#noun#2#RM
arbitrary_correction	svecCa_saMSuxXi#svecCa_saMSuxXi#noun#2#RM
arbitrary_origin	svecCa_mUlabiMxu#svecCa_mUlabiMxu#noun#2#RM
arbitrary_value	ecCika_mAna#ecCika_mAna#noun#2#RM
arbitrated_exchange_rate	aMwarpaNana_vinimaya_xara#aMwarpaNana_vinimaya_xara#noun#2#RM
arbour_or_pergola_system	maMdala_praNAlI#maMdala_praNAlI#noun#2#RM
arc_process	Arka_viXi#Arka_viXi#noun#2#RM
area_under_crop	sasyagawa_kRewra/Pasala_ke_wahawa_kRewra/sasyagawa_kRewra#sasyagawa_kRewra/Pasala_ke_wahawa_kRewra/sasyagawa_kRewra#noun#2#RM
area_under_cultivation	kqRigawa_kRewra/jowaBUmi/kqRigawa_kRewra#kqRigawa_kRewra/jowaBUmi/kqRigawa_kRewra#noun#2#RM
area_under_irrigation	siMcAI_ke_wahawa_kRewra/siMcana_kRewra/siMciwa_kRewra#siMcAI_ke_wahawa_kRewra/siMcana_kRewra/siMciwa_kRewra#noun#2#RM
arid_climate	SuRka_jalavAyu#SuRka_jalavAyu#noun#2#RM
aridity_index	SuRkawA_sUcakAMka#SuRkawA_sUcakAMka#noun#2#RM
arid_legumes	SuRka_PaliyAM#SuRka_PaliyAM#noun#2#RM
arid_soil	SuRka_mqxA#SuRka_mqxA#noun#2#RM
arm_disease_of_grape	aMgUra_kA_mqwaSAKa_roga#aMgUra_kA_mqwaSAKa_roga#noun#2#RM
aromatic_plants	sugaMXiwa_pOXe#sugaMXiwa_pOXe#noun#2#RM
articles_of_comfort	suKakara_vaswueM#suKakara_vaswueM#noun#2#RM
articular_facet	saMXi_sirA#saMXi_sirA#noun#2#RM
artificial_compaction	kqwrima_saMhawawA#kqwrima_saMhawawA#noun#2#RM
artificial_compost	kqwrima_kamposta#kqwrima_kamposta#noun#2#RM
artificial_drainage	kqwrima_jala_nikAsa#kqwrima_jala_nikAsa#noun#2#RM
artificial_epiphatolic	kqwrima_roga_sqjana#kqwrima_roga_sqjana#noun#2#RM
artificial_farm_manure	kqwrima_kArbanI_KAxa/kqwrima_PArma_KAxa#kqwrima_kArbanI_KAxa/kqwrima_PArma_KAxa#noun#2#RM
artificial_fertilizer	kqwrima_urvaraka#kqwrima_urvaraka#noun#2#RM
artificial_hybridization	kqwrima_saMkaraNa#kqwrima_saMkaraNa#noun#2#RM
artificial_inoculation	kqwrima_niveRana#kqwrima_niveRana#noun#2#RM
artificial_insemination	kqwrima_vIrya_secana#kqwrima_vIrya_secana#noun#2#RM
artificial_manure	kqwrima_KAxa#kqwrima_KAxa#noun#2#RM
artificial_mulch	kqwrima_palavAra#kqwrima_palavAra#noun#2#RM
artificial_parthenogenesis	kqwrima_aniSekajanana#kqwrima_aniSekajanana#noun#2#RM
artificial_pollination	kqwrima_parAgaNa#kqwrima_parAgaNa#noun#2#RM
artificial_selection	kqwrima_varaNa#kqwrima_varaNa#noun#2#RM
artificial_silk	kqwrima_reSama#kqwrima_reSama#noun#2#RM
ascending_order	ArohI_krama#ArohI_krama#noun#2#RM
asexual_reproduction	alEMgika_janana#alEMgika_janana#noun#2#RM
ash_colour	matamElA_raMga#matamElA_raMga#noun#2#RM
ash_gourd	peTA/BUrA_kaxxU#peTA/BUrA_kaxxU#noun#2#RM
ash_metabolism	rAKa_upApacaya#rAKa_upApacaya#noun#2#RM
aspergillus_niger	kAlI_PaPUMxa#kAlI_PaPUMxa#noun#2#RM
assessed_value	mUlyAMkiwa_mAna#mUlyAMkiwa_mAna#noun#2#RM
assigned_quota	aXimAnya_kotA#aXimAnya_kotA#noun#2#RM
association_coeficient	sAhacarya_guNAMka#sAhacarya_guNAMka#noun#2#RM
association_of_attribute	guNa_sAhacarya#guNa_sAhacarya#noun#2#RM
associative_action	saMyogika_kriyA#saMyogika_kriyA#noun#2#RM
associative_digestibility	saMyogika_pacanIyawA#saMyogika_pacanIyawA#noun#2#RM
associative_effect	saMsargI_praBAva#saMsargI_praBAva#noun#2#RM
associative_phenomena	saMsargI_xqRya#saMsargI_xqRya#noun#2#RM
assorting_effect	pqWakkaraNa_praBAva#pqWakkaraNa_praBAva#noun#2#RM
assured_mean	kalpiwa_mAXya#kalpiwa_mAXya#noun#2#RM
aster_spotted_wilt	estara_kA_cakawwexAra_mlAni#estara_kA_cakawwexAra_mlAni#noun#2#RM
aster_wilt	estara_pIwaroga#estara_pIwaroga#noun#2#RM
at_an_average	Osawana#Osawana#noun#2#RM
at_par	samAna#samAna#noun#2#RM
audio_visual_aids	xqRya_Sravya_sAXana#xqRya_Sravya_sAXana#noun#2#RM
aural_aid	karNIya_sAXana#karNIya_sAXana#noun#2#RM
auto_alloploid	sva_parAgaNiwa#sva_parAgaNiwa#noun#2#RM
auto_allopolyploid	sva_parabahuguNiwawA#sva_parabahuguNiwawA#noun#2#RM
autocatalytic_reaction	svowprerakaprawikriyA#svowprerakaprawikriyA#noun#2#RM
autochthonous_bacteria	svasWAnika_jIvANu#svasWAnika_jIvANu#noun#2#RM
autumn_cleaning	pawaJadZakAlIna_saPZAI#pawaJadZakAlIna_saPZAI#noun#2#RM
autumn_cultivation	pawaJadZakAlIna_KewI/katAI#pawaJadZakAlIna_KewI/katAI#noun#2#RM
available_water_in_soils	mqxAoM_meM_upalabXa_jala#mqxAoM_meM_upalabXa_jala#noun#2#RM
average_holding	Osawa_jowa#Osawa_jowa#noun#2#RM
average_marginal_productivity	Osawa_sImAMwa_uwpAxakawA#Osawa_sImAMwa_uwpAxakawA#noun#2#RM
average_output	Osawa_uwpAxa#Osawa_uwpAxa#noun#2#RM
average_return	Osawa_prawiPala#Osawa_prawiPala#noun#2#RM
average_value	Osawa_mUlya#Osawa_mUlya#noun#2#RM
average_weight	Osawa_BAra#Osawa_BAra#noun#2#RM
average_yield	Osawa_upaja#Osawa_upaja#noun#2#RM
award_and_recognition	puraskAra_evaM_mAnyawAez#puraskAra_evaM_mAnyawAez#noun#2#RM
axial_flower	akRIya_puRpa/akRIya_PUla#akRIya_puRpa/akRIya_PUla#noun#2#RM
axillary_bud	kakRasWa_kalikA#kakRasWa_kalikA#noun#2#RM
backgrond_information	pqSTaBUmi_sUcanA#pqSTaBUmi_sUcanA#noun#2#RM
barren_land	baMjara_BUmi#baMjara_BUmi#noun#2#RM
basal_pit	AXAra_garwa#AXAra_garwa#noun#2#RM
basement_rocks	AXAra_SElasaMXa#AXAra_SElasaMXa#noun#2#RM
base_run-off	AXAra_apavAha#AXAra_apavAha#noun#2#RM
basin_irrigation	xroNI-siMcAI#xroNI-siMcAI#noun#2#RM
basin_listing	kyArI_banAnA#kyArI_banAnA#noun#2#RM
bed_irrigation	kyArI_siMcAI#kyArI_siMcAI#noun#2#RM
bee_fly	Bramara_makKI#Bramara_makKI#noun#2#RM
below_par_value	avamUlya#avamUlya#noun#2#RM
bench_terrace	bEMca_teresa#bEMca_teresa#noun#2#RM
bench_terraces	sopAna_vexikAez#sopAna_vexikAez#noun#2#RM
bengal_curantus	kaMrOxA#kaMrOxA#noun#2#RM
benthic_animal	niwalasWa_prANI#niwalasWa_prANI#noun#2#RM
bias_sampling	aBinawa_prawixarSana#aBinawa_prawixarSana#noun#2#RM
bio_chemistry	jEva_rasAyana#jEva_rasAyana#noun#2#RM
bio_climatology	jIva-jalavAyuvijFAna#jIva-jalavAyuvijFAna#noun#2#RM
bio_control	jEva_niyaMwraNa#jEva_niyaMwraNa#noun#2#RM
bio_diversity	jEva_viviXawA#jEva_viviXawA#noun#2#RM
bio_fertiliser	jEva_urvaraka#jEva_urvaraka#noun#2#RM
biological_control	jEva_niyaMwraNa#jEva_niyaMwraNa#noun#2#RM
biological_cycle	jEva-cakra#jEva-cakra#noun#2#RM
biological_forces	jEvika_SakwiyAz#jEvika_SakwiyAz#noun#2#RM
biological_form	jEvika_prakAra#jEvika_prakAra#noun#2#RM
biomass_energy_production	boYyomAsa_UrjA_uwpAxana#boYyomAsa_UrjA_uwpAxana#noun#2#RM
biomass_nitrogen	nawrajana_jEva_mAwrA#nawrajana_jEva_mAwrA#noun#2#RM
bio_pesticides_tissue	jEva_nASIjIva_uwwaka#jEva_nASIjIva_uwwaka#noun#2#RM
bisholi's_weed	ajavAyana#ajavAyana#noun#2#RM
black_blum	jAmuna#jAmuna#noun#2#RM
black_cotton_soil	kAlI_mqxA#kAlI_mqxA#noun#2#RM
black_cumin	jIrA#jIrA#noun#2#RM
black_gram	udZaxa#udZaxa#noun#2#RM
black_pepper	kAlI_mirca#kAlI_mirca#noun#2#RM
black_spot	kAlI_ciwwI#kAlI_ciwwI#noun#2#RM
blooming_stage	PUlalagane_kA_samaya#PUlalagane_kA_samaya#noun#2#RM
blossom_blight	puRpapuMja_aMgamArI#puRpapuMja_aMgamArI#noun#2#RM
borer_beetle	Cixraka_BqMga#Cixraka_BqMga#noun#2#RM
bottle_gourd	lOkI#lOkI#noun#2#RM
branch_harvesting	sapawra_SAKA_katAI#sapawra_SAKA_katAI#noun#2#RM
breeder_seed	prajanaka_bIja#prajanaka_bIja#noun#2#RM
breeder_seed_production	prajanaka_bIja_uwpAxana#prajanaka_bIja_uwpAxana#noun#2#RM
broad_leaved_tree	cOdZe_pawwe_vAle_vqkRa#cOdZe_pawwe_vAle_vqkRa#noun#2#RM
bud_graft	kalama_lagAnA/kalI_caDZAnA#kalama_lagAnA/kalI_caDZAnA#noun#2#RM
bud_rot	kAlikA_sadZana#kAlikA_sadZana#noun#2#RM
buffaloes_heifer	BEMsoM_baCiyA_/BEMsoM_kA_osara#BEMsoM_baCiyA_/BEMsoM_kA_osara#noun#2#RM
bulk_density	sWUla_Ganawva#sWUla_Ganawva#noun#2#RM
buying_farm_inputs	PArma_niveSoM_kI_KarIxI#PArma_niveSoM_kI_KarIxI#noun#2#RM
calculation_of_data	Azkade_gaNanA#Azkade_gaNanA#noun#2#RM
callus_tissue	kiNva_Uwaka#kiNva_Uwaka#noun#2#RM
canopy_density	viwAna_Ganawva#viwAna_Ganawva#noun#2#RM
canopy_fringe	keSikA_JallarI#keSikA_JallarI#noun#2#RM
canopy_protection	viwAna_saMrakRaNa#viwAna_saMrakRaNa#noun#2#RM
capacity_building	kRamawA_nirmANa#kRamawA_nirmANa#noun#2#RM
capillary_condensation	keSikA_saMGanana#keSikA_saMGanana#noun#2#RM
capillary_water_capacity	keSikA_jala_kRamawA#keSikA_jala_kRamawA#noun#2#RM
cast_off	CodZanA#CodZanA#noun#2#RM
catchment_area	sravaNa_kRewra#sravaNa_kRewra#noun#2#RM
cation_exchange_capacity	XanAyana_vinimaya_kRamawA#XanAyana_vinimaya_kRamawA#noun#2#RM
causal_agent	rogakAraka#rogakAraka#noun#2#RM
cell_culture	koSika_saMvarXana#koSika_saMvarXana#noun#2#RM
certified_seed	pramANiwa_bIja#pramANiwa_bIja#noun#2#RM
chain_isomerism	SrqMKalA_samAvayavawA,#SrqMKalA_samAvayavawA,#noun#2#RM
check_dam	roka_bAzXa#roka_bAzXa#noun#2#RM
chemical_composition	rAsAyanika_saMGatana#rAsAyanika_saMGatana#noun#2#RM
chemical_manure	rAsAyanika_KAxa#rAsAyanika_KAxa#noun#2#RM
chopping_knife	saMkarwana_CurI#saMkarwana_CurI#noun#2#RM
chromosomal_bridge	guNasUwrI_yoja_ka#guNasUwrI_yoja_ka#noun#2#RM
chromosomal_fission	guNasUwra_viKaMdana#guNasUwra_viKaMdana#noun#2#RM
chronically_drought_prone_area	niraMwara_sUKA_graswa_kRewra#niraMwara_sUKA_graswa_kRewra#noun#2#RM
chronological_order	kAlAnukrama#kAlAnukrama#noun#2#RM
clayey_soil	cikanI_mittI#cikanI_mittI#noun#2#RM
clay_loam	matiyArI/xumata#matiyArI/xumata#noun#2#RM
climate_change	jalavAyu_parivarwana#jalavAyu_parivarwana#noun#2#RM
climate_continental	mahAxvIpIya_jalavAyu#mahAxvIpIya_jalavAyu#noun#2#RM
climate_oceanic	mahAsAgarIya_jalavAyu#mahAsAgarIya_jalavAyu#noun#2#RM
climatic_analogues	samavqwwi_jalavAyu#samavqwwi_jalavAyu#noun#2#RM
climatic_factors	jalavAyu_kAraka#jalavAyu_kAraka#noun#2#RM
climax_climatic	caramAvasWA_jalavAyu#caramAvasWA_jalavAyu#noun#2#RM
climax_edaphic	BUmi_caramAvasWA/mqxA_caramAvasWA#BUmi_caramAvasWA/mqxA_caramAvasWA#noun#2#RM
cloud_brust	barasa_padZanA/GanaGora_varRA#barasa_padZanA/GanaGora_varRA#noun#2#RM
cloud_bursting	barasa_padZanA/vqRtisPota/JamakArA#barasa_padZanA/vqRtisPota/JamakArA#noun#2#RM
cluster_bean	gvAra#gvAra#noun#2#RM
coefficient_of_variation_or_variability	vicaraNa_guNAMka#vicaraNa_guNAMka#noun#2#RM
cold_storage	SIwagqha#SIwagqha#noun#2#RM
cold_water	SIwajala#SIwajala#noun#2#RM
collateral_bud	saMpArSvika_kalikA#saMpArSvika_kalikA#noun#2#RM
collecting_fuel	IMXana_saMgraha#IMXana_saMgraha#noun#2#RM
collecting_water	jala_saMgraha#jala_saMgraha#noun#2#RM
colonial_area	sAmuxAyika_kRewra#sAmuxAyika_kRewra#noun#2#RM
combating_desertification	marUsWalIkaraNa_kA_viroXa#marUsWalIkaraNa_kA_viroXa#noun#2#RM
commercial_bank	vANijyika_bEMka#vANijyika_bEMka#noun#2#RM
common_millet	canA#canA#noun#2#RM
complimentary_gene	pUraka_jIna#pUraka_jIna#noun#2#RM
congenital_disease	janmajAwa_roga#janmajAwa_roga#noun#2#RM
consultancy_sercices	parAmarSaxAwrI_sevAeM#parAmarSaxAwrI_sevAeM#noun#2#RM
contagious_disease	saMsargaja_roga/sAMsargika_roga#saMsargaja_roga/sAMsargika_roga#noun#2#RM
continuous_cropping	niraMwara_sasyana/sawawa_Pasala#niraMwara_sasyana/sawawa_Pasala#noun#2#RM
contour_cropping	samocca_sasyana/kaMtUra_sasyana#samocca_sasyana/kaMtUra_sasyana#noun#2#RM
contour_farming	kaMtUra_kqRi/KewI#kaMtUra_kqRi/KewI#noun#2#RM
contour_furrow_or_trench	samocca_kuMda#samocca_kuMda#noun#2#RM
control_measure	niyaMwraNopAya#niyaMwraNopAya#noun#2#RM
control_stress	niyaMwriwa_prawibala#niyaMwriwa_prawibala#noun#2#RM
contton_leaf	kapAsa_varNa#kapAsa_varNa#noun#2#RM
cooperative_society	sahakArI_saMsWA#sahakArI_saMsWA#noun#2#RM
corn_beetle	XAnya_BqMga#XAnya_BqMga#noun#2#RM
corpus_allatum	aMdABa_piMda#aMdABa_piMda#noun#2#RM
correlation_co-efficient	sahasaMbaMXa_guNAMka#sahasaMbaMXa_guNAMka#noun#2#RM
cotton_breeder	kapAsa_prajanaka#kapAsa_prajanaka#noun#2#RM
cotton_lint	rUI#rUI#noun#2#RM
cotton_seed	binOlA/kapAsa_kA_bIja#binOlA/kapAsa_kA_bIja#noun#2#RM
cotton_seed_oil	binOlA_wela#binOlA_wela#noun#2#RM
cotyledonary_node	bIjapawrIya_parvasaMXi#bIjapawrIya_parvasaMXi#noun#2#RM
counter_tillage	samawala_juwAI#samawala_juwAI#noun#2#RM
cover_crop	BUmi_saMrakRI_sasya/BUmi_saMrakRI_Pasala#BUmi_saMrakRI_sasya/BUmi_saMrakRI_Pasala#noun#2#RM
cow_pea	lobiyA#lobiyA#noun#2#RM
critical_difference	krAMwika_aMwara#krAMwika_aMwara#noun#2#RM
critical_length	krAMwika_lambAI#krAMwika_lambAI#noun#2#RM
critical_limit	krAMwika_sImA#krAMwika_sImA#noun#2#RM
crop_forest	sasya_jaMgala/sasya_vana#sasya_jaMgala/sasya_vana#noun#2#RM
crop_intensification	Pasala_gahanawA/#Pasala_gahanawA/#noun#2#RM
cropping_intensity	sasya_saGanawA#sasya_saGanawA#noun#2#RM
cropping_pattern	Pasala_paxXawi#Pasala_paxXawi#noun#2#RM
cropping_systems	sasyana_praNAlI/Pasala_praNAlI#sasyana_praNAlI/Pasala_praNAlI#noun#2#RM
crop_plants	PasalI_pOXe#PasalI_pOXe#noun#2#RM
crop_production_system	Pasala_uwpAxana_praNAlI#Pasala_uwpAxana_praNAlI#noun#2#RM
crop_residue_management	sasyAvaSeRa_prabaMXana#sasyAvaSeRa_prabaMXana#noun#2#RM
crop_residue	sasyAvaSeRa#sasyAvaSeRa#noun#2#RM
crop_rotation	Pasala_cakra#Pasala_cakra#noun#2#RM
crop_weather_outlook	Pasala_mOsama_xqRtikoNa#Pasala_mOsama_xqRtikoNa#noun#2#RM
crown_grafting	SIrRa-ropaNa/SIrRa_kalama#SIrRa-ropaNa/SIrRa_kalama#noun#2#RM
crown_height	SIrRa_UMcAI/Apawra_UMcAI#SIrRa_UMcAI/Apawra_UMcAI#noun#2#RM
crushing_strength	saMmarxaka_sAmaWrya#saMmarxaka_sAmaWrya#noun#2#RM
cultivation_shifting	juwAI/kqRi_parivarwana#juwAI/kqRi_parivarwana#noun#2#RM
cultural_operations	karRaNa-kriyAez#karRaNa-kriyAez#noun#2#RM
culture_fisheries	mAwsyikI_saMvarXana#mAwsyikI_saMvarXana#noun#2#RM
custard_apple	SarIPA#SarIPA#noun#2#RM
cutting_age_knowledge	axyawana_anusaMXAna_jAnakArI#axyawana_anusaMXAna_jAnakArI#noun#2#RM
cutting_edge	uwkqRta#uwkqRta#noun#2#RM
damping_off	AxrramArI#AxrramArI#noun#2#RM
declining_price	girawA_BAva#girawA_BAva#noun#2#RM
declining_productivity	girawI_uwpAxakawA#girawI_uwpAxakawA#noun#2#RM
deep_ploughing	gaharI_juwAI#gaharI_juwAI#noun#2#RM
deep_soils	gaharI_mqxAez#gaharI_mqxAez#noun#2#RM
deep_water	gaharA_jala#gaharA_jala#noun#2#RM
deficit_area	aBAva_vAle_kRewra#aBAva_vAle_kRewra#noun#2#RM
demonstration_cum_seed	production_farm__praxarSana-saha-bIja_uwpAxana_PZArma#production_farm__praxarSana-saha-bIja_uwpAxana_PZArma#noun#2#RM
desert_climate	marusWalI_jalavAyu#marusWalI_jalavAyu#noun#2#RM
desert_crust	marusWala_BUpqRta#marusWala_BUpqRta#noun#2#RM
desert_soil	marusWalI_mqxA#marusWalI_mqxA#noun#2#RM
determinate_growth	niyawa_vqxXi/parimiwa_vqxXi#niyawa_vqxXi/parimiwa_vqxXi#noun#2#RM
detrimental_effect	hAnikAraka_praBAva#hAnikAraka_praBAva#noun#2#RM
dew_point	osAMka#osAMka#noun#2#RM
dibble_to	hAWa_se_bonA/coba#hAWa_se_bonA/coba#noun#2#RM
die_back_disease	paScamArI_roga#paScamArI_roga#noun#2#RM
die_back	paScamArI/SIrRAraMBIkRaya/paScakRaya#paScamArI/SIrRAraMBIkRaya/paScakRaya#noun#2#RM
directorate_of_extension	prasAra_nixeSAlaya#prasAra_nixeSAlaya#noun#2#RM
direct_run-off	sIXA_apavAha#sIXA_apavAha#noun#2#RM
direct_selling	sIXI_bikrI#sIXI_bikrI#noun#2#RM
disease_index	roga_wIAwA/roga_sUcakAMka#roga_wIAwA/roga_sUcakAMka#noun#2#RM
disease_management	roga_prabaMXana#roga_prabaMXana#noun#2#RM
division_of_crop_science	Pasala_vijFAna_saMBAga#Pasala_vijFAna_saMBAga#noun#2#RM
division_of_resource_management	saMsAXana_prabaMXana_saMBAga#saMsAXana_prabaMXana_saMBAga#noun#2#RM
dominant_breeding	prabala_prajanana#prabala_prajanana#noun#2#RM
dominant_ecology	praXAna_pArisWiwikI#praXAna_pArisWiwikI#noun#2#RM
double_cropping	xvi-Pasala_KewI#xvi-Pasala_KewI#noun#2#RM
drainage_basic	mUla_jalanikAsa#mUla_jalanikAsa#noun#2#RM
drainage_divide	jala_nikAsa_viBAjana#jala_nikAsa_viBAjana#noun#2#RM
drain_to	nikAlanA#nikAlanA#noun#2#RM
drip_irrigation	dripa_siMcAI/dZipa_siMcAI/tapakAvaka_siMcAI/tapakA_siMcaMI#dripa_siMcAI/dZipa_siMcAI/tapakAvaka_siMcAI/tapakA_siMcaMI#noun#2#RM
drought_alleviation_programme	akAla/sUKA_rAhawa_kAryakrama#akAla/sUKA_rAhawa_kAryakrama#noun#2#RM
drought_management	sUKA_prabaMXana#sUKA_prabaMXana#noun#2#RM
drought_resistance	SuRkawA-roXa/anAvqRti_roXa#SuRkawA-roXa/anAvqRti_roXa#noun#2#RM
drought_susceptible	sUKA_pravaNa#sUKA_pravaNa#noun#2#RM
drought_tolerant	sUKA_roXI#sUKA_roXI#noun#2#RM
dry_aggregate	kula_SuRkawA#kula_SuRkawA#noun#2#RM
dry_calorific_value	sUKA_uRmIyamAna#sUKA_uRmIyamAna#noun#2#RM
dry_climates	SuRka_jalavAyu#SuRka_jalavAyu#noun#2#RM
dry_ginger	sOMTa#sOMTa#noun#2#RM
dryland_crops	bArAnI_PasaleM#bArAnI_PasaleM#noun#2#RM
dryland_farming	bArAnI_KewI#bArAnI_KewI#noun#2#RM
dryland_society	bArAnI_kqRi_saMsWA#bArAnI_kqRi_saMsWA#noun#2#RM
dry_weight_percentage	SuRka_wola_prawiSawa#SuRka_wola_prawiSawa#noun#2#RM
dust_mulch	XUla_palavAra#XUla_palavAra#noun#2#RM
early_maturing	agewI_pakane_vAlI#agewI_pakane_vAlI#noun#2#RM
economic_activities	ArWika_gawiviXiyAz#ArWika_gawiviXiyAz#noun#2#RM
economical_plants	lABakara_pOXe#lABakara_pOXe#noun#2#RM
economic_analysis	ArWika_viSleRaNa#ArWika_viSleRaNa#noun#2#RM
economic_condition	ArWika_sWiwi#ArWika_sWiwi#noun#2#RM
edible_pine	cilagojA#cilagojA#noun#2#RM
effected_part	grasiwa_BAga#grasiwa_BAga#noun#2#RM
effective_precipitation	praBAvI_avapawana#praBAvI_avapawana#noun#2#RM
elite_lines	cunI_huI_SreRTa_vaMSAvaliyAM#cunI_huI_SreRTa_vaMSAvaliyAM#noun#2#RM
eluvial_horizon	apoDa_saMswara#apoDa_saMswara#noun#2#RM
embryo_culture	BrUNa_saMvarXana#BrUNa_saMvarXana#noun#2#RM
equivalent_diameter	wulya_vyAsa/sama_vyAsa/samawulya_vyAsa#wulya_vyAsa/sama_vyAsa/samawulya_vyAsa#noun#2#RM
eroded_clay	aparaxiwa_mqwwikA#aparaxiwa_mqwwikA#noun#2#RM
erode_to	aparaxana#aparaxana#noun#2#RM
erosion_accelerated	wvariwa_aparaxana#wvariwa_aparaxana#noun#2#RM
erosion_gully	avanAlikA_aparaxana#avanAlikA_aparaxana#noun#2#RM
erosion_normal	sAmAnya_BU-kRaraNa#sAmAnya_BU-kRaraNa#noun#2#RM
erosion_pavement	UparI_swara_aparaxana#UparI_swara_aparaxana#noun#2#RM
erosion_rill	alpasariwa_aparaxana#alpasariwa_aparaxana#noun#2#RM
erosion_sheet	pqRTa_aparaxana#pqRTa_aparaxana#noun#2#RM
erratic_rain_fall	aniyamiwa_varRA#aniyamiwa_varRA#noun#2#RM
evaporated_milk	vARpiwa_xUXa#vARpiwa_xUXa#noun#2#RM
evaporation_pan	vARpana_kuMdA/vARpana_pEna#vARpana_kuMdA/vARpana_pEna#noun#2#RM
evaporation_potential	vARpana_kRamawA#vARpana_kRamawA#noun#2#RM
exchangeable_sodium_percentage	vinimaya_sodZiyama_prawiSawa#vinimaya_sodZiyama_prawiSawa#noun#2#RM
exchange_value	vinimaya_mUlya#vinimaya_mUlya#noun#2#RM
existing_and_improved	varwamAna_evaM_unnawa/behawara#varwamAna_evaM_unnawa/behawara#noun#2#RM
exlcusive_right	ekamAwra_aXikAra#ekamAwra_aXikAra#noun#2#RM
exotic_material	asAmAnya_paxArWa#asAmAnya_paxArWa#noun#2#RM
experience_of_farmers	kqRaka_anuBava#kqRaka_anuBava#noun#2#RM
experimental_farming	prayogAwmaka_KewI#prayogAwmaka_KewI#noun#2#RM
experimental_field	prAyogika_Kewa/prayogAwmaka#prAyogika_Kewa/prayogAwmaka#noun#2#RM
experimental_fields	prayogAwmaka_kRewra#prayogAwmaka_kRewra#noun#2#RM
experimental_learning	prayogAwmaka_aXyayana#prayogAwmaka_aXyayana#noun#2#RM
exposure_visit	paricAyAwmaka_xOrA#paricAyAwmaka_xOrA#noun#2#RM
ex_site	mUla_sWAna_se_ala_ga#mUla_sWAna_se_ala_ga#noun#2#RM
extended_technology	prOxyogikI_viswAra#prOxyogikI_viswAra#noun#2#RM
extend_of_technology	prOxyogikI_kA_viswAra#prOxyogikI_kA_viswAra#noun#2#RM
extra_axillary_bud	awirikwa_kakRasWa_kalikA#awirikwa_kakRasWa_kalikA#noun#2#RM
farmer/farming_community	kqRaka_samuxAya#kqRaka_samuxAya#noun#2#RM
farmer_innovators	anveRaka_kisAna#anveRaka_kisAna#noun#2#RM
farmers_organization	kisAna_saMgaTana#kisAna_saMgaTana#noun#2#RM
farm_implements	kqRi_OjZAra#kqRi_OjZAra#noun#2#RM
farming_system	kqRi_praNAlI/kqRivyavasWA#kqRi_praNAlI/kqRivyavasWA#noun#2#RM
farm_machanization	Pasala_yAMwrIkaraNa#Pasala_yAMwrIkaraNa#noun#2#RM
farm_machine	kqRi_yaMwra#kqRi_yaMwra#noun#2#RM
farm_practices	PArma_kArya_praNAlI#PArma_kArya_praNAlI#noun#2#RM
farm_waste	kqRi_avaSeRa#kqRi_avaSeRa#noun#2#RM
farmyard_manure	KalihAnI_KAxa#KalihAnI_KAxa#noun#2#RM
fat_solvent	vasA_vilAyaka#vasA_vilAyaka#noun#2#RM
fatty_acid	vasA_umla#vasA_umla#noun#2#RM
fiber_fineness	waMwu_mahInawA#waMwu_mahInawA#noun#2#RM
fiber_quality	waMwu_kI_guNawA#waMwu_kI_guNawA#noun#2#RM
fiber_strength	waMwu_kI_majabUwI#waMwu_kI_majabUwI#noun#2#RM
field_capacity	kRewra_kRamawA/PIlda_kRamawA#kRewra_kRamawA/PIlda_kRamawA#noun#2#RM
field_level_survey	kRewrIya_swara_para_sarvekRaNa#kRewrIya_swara_para_sarvekRaNa#noun#2#RM
field_supervision	kRewrIya_paryavekRaNa#kRewrIya_paryavekRaNa#noun#2#RM
field_work	kRewrIya_kArya#kRewrIya_kArya#noun#2#RM
financial_analysis	viwwIya_samIkRA#viwwIya_samIkRA#noun#2#RM
financial_crisis	viwwIya_saMkata#viwwIya_saMkata#noun#2#RM
financial_year	viwwIya_varRa#viwwIya_varRa#noun#2#RM
fine_texture	bArIka_kaNa-AkAra#bArIka_kaNa-AkAra#noun#2#RM
finger_millet	maMduA/rAgI/maMduA#maMduA/rAgI/maMduA#noun#2#RM
fire_forest	xavAnala#xavAnala#noun#2#RM
fire_line	PAyara/lAina#PAyara/lAina#noun#2#RM
fire_protection	agni_surakRA#agni_surakRA#noun#2#RM
fire_season	Aga_ke_mOsama#Aga_ke_mOsama#noun#2#RM
fishing_vessal	maCalI_pakadZane_kI_nOkA/mawsya_powa#maCalI_pakadZane_kI_nOkA/mawsya_powa#noun#2#RM
fish_seed	maCalI_kA_jIrA#maCalI_kA_jIrA#noun#2#RM
fixed_costs	bazXI_lAgawa#bazXI_lAgawa#noun#2#RM
fixed_price	nirXAriwa_mUlya#nirXAriwa_mUlya#noun#2#RM
flag_leaf	Xvaja_pawwA#Xvaja_pawwA#noun#2#RM
flooding_soil	AplAvana_mqxA#AplAvana_mqxA#noun#2#RM
flood_plain	bADZa_mExAna#bADZa_mExAna#noun#2#RM
flood_prone	bADZa_pravaNa#bADZa_pravaNa#noun#2#RM
floor_price	nimnawama_mUlya#nimnawama_mUlya#noun#2#RM
flow_velocity	srAva_gawi/bahAva_gawi#srAva_gawi/bahAva_gawi#noun#2#RM
fodder_crop	cArA_Pasala#cArA_Pasala#noun#2#RM
fodder_grass	cArA_GAsa#cArA_GAsa#noun#2#RM
fog_precipitation	kuharA_avapawana#kuharA_avapawana#noun#2#RM
folk_varieties	loka_upajAwiyAM#loka_upajAwiyAM#noun#2#RM
food_assurance	KAxya_suniSciwawA#KAxya_suniSciwawA#noun#2#RM
food_crops	KAxya_PasaleM#KAxya_PasaleM#noun#2#RM
food_grain	KAxyAnna#KAxyAnna#noun#2#RM
food_grains	KAxyAnna#KAxyAnna#noun#2#RM
food_processing	KAxya_prasaMskaraNa#KAxya_prasaMskaraNa#noun#2#RM
forage_crop	cArA_Pasala#cArA_Pasala#noun#2#RM
forage_crops	cArA_PasaleM#cArA_PasaleM#noun#2#RM
foreign_trade	vixeSa_vyApAra#vixeSa_vyApAra#noun#2#RM
forest_community	sAmuxAyika_vana#sAmuxAyika_vana#noun#2#RM
forestry_farm	vanavixyA_PArma#vanavixyA_PArma#noun#2#RM
forest_secondary	paravarwI_vana#paravarwI_vana#noun#2#RM
forest_virgin	vana/virjina#vana/virjina#noun#2#RM
fortline_demonstration	agraNI_praxarSana_yA_nixarSana#agraNI_praxarSana_yA_nixarSana#noun#2#RM
foundation_seed	AXAra_bIja#AXAra_bIja#noun#2#RM
free_from_disease	roga_mukwa#roga_mukwa#noun#2#RM
free_trade_zone	mukwa_vyApAra_kRewra#mukwa_vyApAra_kRewra#noun#2#RM
frequency_distribution	bAraMbArawA/baMtana#bAraMbArawA/baMtana#noun#2#RM
front_line_demostraton	agrima_pakwi_praxarSana#agrima_pakwi_praxarSana#noun#2#RM
frost_free_season	wuRArahIna_qwu/mOsama#wuRArahIna_qwu/mOsama#noun#2#RM
frost_radiation	wuRAra_vikiraNa/pAlA_vikiraNa#wuRAra_vikiraNa/pAlA_vikiraNa#noun#2#RM
fungus_flora	kavaka_vanaspawi_samUha#kavaka_vanaspawi_samUha#noun#2#RM
gene_pools	jEvika_guNoM_kA_BaMdAra#jEvika_guNoM_kA_BaMdAra#noun#2#RM
genetic_library	anuvaMSika_BaMdAra#anuvaMSika_BaMdAra#noun#2#RM
geographical_information_system	BOgolika_sUcanA_praNAlI#BOgolika_sUcanA_praNAlI#noun#2#RM
geographic_area	BOgolika_kRewra#BOgolika_kRewra#noun#2#RM
germination_percentage	aMkuraNa_prawiSawa#aMkuraNa_prawiSawa#noun#2#RM
ginning_percentage	otAI_prawiSawa#otAI_prawiSawa#noun#2#RM
global_radiation	vEiAka_vikiraNa#vEiAka_vikiraNa#noun#2#RM
gold_medal	svarNa_paxaka#svarNa_paxaka#noun#2#RM
grafted_plant	kZalamI_pOXA#kZalamI_pOXA#noun#2#RM
grain_quality	anAja_guNavawwA#anAja_guNavawwA#noun#2#RM
gravitation_water	guruwvAkarRaNa_jala#guruwvAkarRaNa_jala#noun#2#RM
grazing_capacity	carAI_kRamawA#carAI_kRamawA#noun#2#RM
grazing_controlled	niyaMwriwa_carAI#niyaMwriwa_carAI#noun#2#RM
grazing_incidence	Apawana_carAI#Apawana_carAI#noun#2#RM
grazing_seasonal	mOsamI_carAI#mOsamI_carAI#noun#2#RM
greater_cardamom	badZI_ilAyacI#badZI_ilAyacI#noun#2#RM
green_gram	mUMga#mUMga#noun#2#RM
green_house_effect	pAxapa_gqha_praBAva/pAxapa-gqha_praBAva#pAxapa_gqha_praBAva/pAxapa-gqha_praBAva#noun#2#RM
green_house	pOXa_Gara#pOXa_Gara#noun#2#RM
green_leaf_manure	harI_pawwiyoM_kI_KAxa#harI_pawwiyoM_kI_KAxa#noun#2#RM
green_lentil	mUMga#mUMga#noun#2#RM
green_manure	harI_KAxa#harI_KAxa#noun#2#RM
green_manuring	harI_KAxa_xenA#harI_KAxa_xenA#noun#2#RM
grey_mildew	xahiyA_roga#xahiyA_roga#noun#2#RM
gross_domestic_product	sakala_GarelU_uwpAxa#sakala_GarelU_uwpAxa#noun#2#RM
ground_level	BUmiwala#BUmiwala#noun#2#RM
groundwater_run-off	BUmigawa_jala_apavAha#BUmigawa_jala_apavAha#noun#2#RM
growth_factor	vqxXi_Gataka#vqxXi_Gataka#noun#2#RM
growth_regulating_substance	vqxXi_niyAmaka_paxArWa#vqxXi_niyAmaka_paxArWa#noun#2#RM
gully_control	galI_niyaMwraNa#galI_niyaMwraNa#noun#2#RM
hairy_caterpiler	royexAra_illI#royexAra_illI#noun#2#RM
hand_ginning_machine	caraKA_otAI_maSIna#caraKA_otAI_maSIna#noun#2#RM
harvest_index	pExAvAra_sUcakAMka#pExAvAra_sUcakAMka#noun#2#RM
heavy_clay	matiyAra/BArI_mqxA#matiyAra/BArI_mqxA#noun#2#RM
heavy_soil	BArI_mqxA#BArI_mqxA#noun#2#RM
hhoary_basil	wulasI#wulasI#noun#2#RM
horse_grass	kulaWI#kulaWI#noun#2#RM
humidity_index	AxrrawA_sUcakAMka/namI_sUcakAMka#AxrrawA_sUcakAMka/namI_sUcakAMka#noun#2#RM
hybrid_vigor	saMkara_oja#saMkara_oja#noun#2#RM
hydraulic_conductivity	xravacAliwa_saMvAhakawA#xravacAliwa_saMvAhakawA#noun#2#RM
hydrolic_conductivity	jala-cAlakawA#jala-cAlakawA#noun#2#RM
hydrological_balance	jalavEjFAnika_saMwulana#jalavEjFAnika_saMwulana#noun#2#RM
hydrologic_budget	jalavEjFAnika_bajata#jalavEjFAnika_bajata#noun#2#RM
hydrologic_cycle	jalacakra/jalavARpacakra#jalacakra/jalavARpacakra#noun#2#RM
hygroscopic_water	AxrrawAgrAhI_jala#AxrrawAgrAhI_jala#noun#2#RM
immature_inflorescence	apakva_puRpakrama#apakva_puRpakrama#noun#2#RM
impeded_drainage	avaruxXa_jala_nikAsa#avaruxXa_jala_nikAsa#noun#2#RM
imported_varieties	AyAwiwa_kZismeM#AyAwiwa_kZismeM#noun#2#RM
import_restriction	AyAwa_prawibaMXa#AyAwa_prawibaMXa#noun#2#RM
improved_breed	behawara_nasla#behawara_nasla#noun#2#RM
improved_implements	navInawama_upakaraNa/unnawa_OjZAra#navInawama_upakaraNa/unnawa_OjZAra#noun#2#RM
improved_varieties	unnawa_kismeM#unnawa_kismeM#noun#2#RM
incipient_wilting	AraMBI_mlAni#AraMBI_mlAni#noun#2#RM
income_&_expenditure_account	Aya-vyaya_leKA#Aya-vyaya_leKA#noun#2#RM
indigenous_knowledge_system	svaxeSI_jFAna_paxXawiyAM#svaxeSI_jFAna_paxXawiyAM#noun#2#RM
indirect_expenses	aprawyakRa_vyaya#aprawyakRa_vyaya#noun#2#RM
individual_plant_selection	eka_pOXIya_varaNa#eka_pOXIya_varaNa#noun#2#RM
indo-gangetic_alluvium	iMdo-gEMgetaka_xomata#iMdo-gEMgetaka_xomata#noun#2#RM
infiltrability_of_soil	mqxA_kA_risAva#mqxA_kA_risAva#noun#2#RM
infiltration_rate	aMwaH_spaMxana_xaha/risAva_xara#aMwaH_spaMxana_xaha/risAva_xara#noun#2#RM
infiltration_velosity	risAva_vega/rivAsa_gawi#risAva_vega/rivAsa_gawi#noun#2#RM
information_technology	sUcanA_prOxyogikI#sUcanA_prOxyogikI#noun#2#RM
in-home_selling	GarelU_bikrI#GarelU_bikrI#noun#2#RM
inorganic_fertiliser	ajEva_KAxa/urvaraka#ajEva_KAxa/urvaraka#noun#2#RM
input-output_ratio	AxAna-praxAna_anupAwa#AxAna-praxAna_anupAwa#noun#2#RM
in_relation_to	ke_paripekRya_meM#ke_paripekRya_meM#noun#2#RM
insect_pest	hAnikAraka_kIta/kIta_pIdZaka/nASI_kIta#hAnikAraka_kIta/kIta_pIdZaka/nASI_kIta#noun#2#RM
insect_preservation	kIta_parirakRaNa#kIta_parirakRaNa#noun#2#RM
in-situ_moisture_conservation	svasWAne_namI_saMrakRaNa#svasWAne_namI_saMrakRaNa#noun#2#RM
in_situ	svasWAne#svasWAne#noun#2#RM
instalment_sale	bikrI_kiSwa#bikrI_kiSwa#noun#2#RM
insurance_crop	Pasala_bImA#Pasala_bImA#noun#2#RM
integrated_circuits	samekiwa_paripaWa#samekiwa_paripaWa#noun#2#RM
integrated_farming_system	samekiwa_kqRi_praNAlI#samekiwa_kqRi_praNAlI#noun#2#RM
integrated_market	samekiwa_bAjZAra#samekiwa_bAjZAra#noun#2#RM
integrated_nutrient	samekiwa_poRaNa#samekiwa_poRaNa#noun#2#RM
integrated_pest_management	samekiwa_nASIjIva_prabaMXana#samekiwa_nASIjIva_prabaMXana#noun#2#RM
integrated_water_&_nutrient_management	samekiwa_jala_evaM_poRaka_prabaMXana#samekiwa_jala_evaM_poRaka_prabaMXana#noun#2#RM
integration_nutrition_management	samekiwa_poRaNa_prabaMXana#samekiwa_poRaNa_prabaMXana#noun#2#RM
integration_of_livestock	paSuXana_kA_samAkalana#paSuXana_kA_samAkalana#noun#2#RM
intellectual_goods	bOxXiwa_vaswueM#bOxXiwa_vaswueM#noun#2#RM
intellectual_property_right	bOxXika_saMpawwi_aXikAra#bOxXika_saMpawwi_aXikAra#noun#2#RM
intensity_of_cropping	Pasala/sasya_aXikawA#Pasala/sasya_aXikawA#noun#2#RM
intensity_of_crop	sasya_saGanawA#sasya_saGanawA#noun#2#RM
intensive_cultivation/farming	saGana_KewI#saGana_KewI#noun#2#RM
intensive_farming	saGana_KewI/kqRi#saGana_KewI/kqRi#noun#2#RM
intensive_research	gahana_anusaMXAna#gahana_anusaMXAna#noun#2#RM
intergeneric_cross	aMwarAvaMSa_saMkara#aMwarAvaMSa_saMkara#noun#2#RM
international_crop_research_institute_for_semi_arid_tropics_(icrisat)	aMwarrARtrIya_arXa-SuRka_URNakatibaMXIya_Pasala_anusaMXAna_saMsWAna#aMwarrARtrIya_arXa-SuRka_URNakatibaMXIya_Pasala_anusaMXAna_saMsWAna#noun#2#RM
international_feed_resources_unit	aMwarrARtrIya_cArA_saMsAXana_ekaka#aMwarrARtrIya_cArA_saMsAXana_ekaka#noun#2#RM
international_monetary_fund	aMwarrARtrIya_muxrA_koRa#aMwarrARtrIya_muxrA_koRa#noun#2#RM
international_recognition	aMwarrARtrIya_mAnyawA#aMwarrARtrIya_mAnyawA#noun#2#RM
inter_product	aMwarA_uwpAxa#aMwarA_uwpAxa#noun#2#RM
inter_se	paraspara#paraspara#noun#2#RM
inter_varietal_cross	aMwarA_kZisma/aMwaHkZisma_saMkara#aMwarA_kZisma/aMwaHkZisma_saMkara#noun#2#RM
intraspecific_diversity	jAwimaya_viviXawA#jAwimaya_viviXawA#noun#2#RM
inveinal_chlorosis	SirAoM_ke_bIca_kA_BAga_pIlA_padZanA#SirAoM_ke_bIca_kA_BAga_pIlA_padZanA#noun#2#RM
in_vitro	kqwrima_parisWiwiyoM_meM#kqwrima_parisWiwiyoM_meM#noun#2#RM
irregular_bearing	aniyamiwa_Palana#aniyamiwa_Palana#noun#2#RM
irrigation_drainage_engineering	siMcAI_nikAsI_aBiyAMwrikI#siMcAI_nikAsI_aBiyAMwrikI#noun#2#RM
irrigation_efficiency	siMcAI_kRamawA#siMcAI_kRamawA#noun#2#RM
isolated_store_cluster	ekaliwa_BaNdAra_samUha#ekaliwa_BaNdAra_samUha#noun#2#RM
italian_millet	kaMganI#kaMganI#noun#2#RM
ivy_gourd	kuxasa#kuxasa#noun#2#RM
jack_tree	katahala#katahala#noun#2#RM
joint_holder	saMyukwa_XAraka#saMyukwa_XAraka#noun#2#RM
joint_tariff	saMyukwa_Sulka#saMyukwa_Sulka#noun#2#RM
joint_venture	saMyukwa_uxyama#saMyukwa_uxyama#noun#2#RM
kellenr's_feeding_standard	kelanara_KAxya_mAnaka#kelanara_KAxya_mAnaka#noun#2#RM
key_element	muKya_wawva#muKya_wawva#noun#2#RM
key_gene	muKya_jZIna#muKya_jZIna#noun#2#RM
key_village_centre	paSugrAma_keMxra#paSugrAma_keMxra#noun#2#RM
key_village_scheme	mUlagrAma_yojanA#mUlagrAma_yojanA#noun#2#RM
kharif_crop	KarIPa_kI_Pasala#KarIPa_kI_Pasala#noun#2#RM
kharif_season	KarIPa_mOsama#KarIPa_mOsama#noun#2#RM
kidney_bean	moTa/moWa#moTa/moWa#noun#2#RM
kindney_bean	udZaxa#udZaxa#noun#2#RM
kinetic_energy	gawija_UrjA#gawija_UrjA#noun#2#RM
kitchen_garden	gqhavAtikA#gqhavAtikA#noun#2#RM
labour_charge	majZaxUrI#majZaxUrI#noun#2#RM
lab_to_land_programme	prayogaSAlA_se_KewoM_waka_kAryakrama#prayogaSAlA_se_KewoM_waka_kAryakrama#noun#2#RM
lack_of_resources	saMsAXanoM_kI_kamI#saMsAXanoM_kI_kamI#noun#2#RM
land_degradation	BU-vikqwikaraNa/BUmi_vikqwikaraNa#BU-vikqwikaraNa/BUmi_vikqwikaraNa#noun#2#RM
land_development_bank	BU-vikAsa_bEMka#BU-vikAsa_bEMka#noun#2#RM
land_holding	BUmi_XAraNa#BUmi_XAraNa#noun#2#RM
land_levelling	BUmi_samawalana#BUmi_samawalana#noun#2#RM
land_mortgage_bank	BUmi_baMXaka_bEMka#BUmi_baMXaka_bEMka#noun#2#RM
land_races	xeSaja_prajAwiyAM#xeSaja_prajAwiyAM#noun#2#RM
land_revenue	BU-rAjasva#BU-rAjasva#noun#2#RM
land_scaping	BUsKalana#BUsKalana#noun#2#RM
land_scapping	BUmi_niyojana#BUmi_niyojana#noun#2#RM
land_survey	BU-sarvekRaNa#BU-sarvekRaNa#noun#2#RM
land_use	BU-upayoga/BUmi_upayoga#BU-upayoga/BUmi_upayoga#noun#2#RM
land_use_research_institute	BU-upayoga_anusaMXAna_saMsWAna#BU-upayoga_anusaMXAna_saMsWAna#noun#2#RM
last_legal_holder	aMwima_vEXa_XAraka#aMwima_vEXa_XAraka#noun#2#RM
late_maturing	paCewI_pakane_vAlI#paCewI_pakane_vAlI#noun#2#RM
laterite_soil	xumatI/xomata_mittI#xumatI/xomata_mittI#noun#2#RM
leaf_area_index	pawwA_kRewra_sUcakAMka#pawwA_kRewra_sUcakAMka#noun#2#RM
leaf_axil	parNakakRa#parNakakRa#noun#2#RM
leaf_base	parNAXAra#parNAXAra#noun#2#RM
leaf_minor	parNa_suraMgI#parNa_suraMgI#noun#2#RM
leaf_rust	parNa_kitta#parNa_kitta#noun#2#RM
leaf_scar	parNa_xAga#parNa_xAga#noun#2#RM
leaf_scorch	parNa_Julasa#parNa_Julasa#noun#2#RM
leaf_spot	parNa_ciwwI#parNa_ciwwI#noun#2#RM
lean_season	SuRka_mOsama#SuRka_mOsama#noun#2#RM
lesser_cardamom	CotI_ilAyacI#CotI_ilAyacI#noun#2#RM
liaison_officer	saMparka_aXikArI#saMparka_aXikArI#noun#2#RM
life_saving_irrigation	prANa_rakRA_siMcAI#prANa_rakRA_siMcAI#noun#2#RM
lint_percentage	rUI_prawiSawawA#rUI_prawiSawawA#noun#2#RM
little_millet	kutakI_koMxo#kutakI_koMxo#noun#2#RM
livestock_feed	cArA#cArA#noun#2#RM
loamy_clay_soil	xomata_matiyAra_mittI#xomata_matiyAra_mittI#noun#2#RM
logistic_support	AvaSyaka_sAmagrI_samarWana#AvaSyaka_sAmagrI_samarWana#noun#2#RM
long_staple	laMbA_reSA#laMbA_reSA#noun#2#RM
low_rainfall_areas	kama_varRAvAle_kRewra#kama_varRAvAle_kRewra#noun#2#RM
macro_structure	sWUla_saMracanA#sWUla_saMracanA#noun#2#RM
major_nutrient	muKya_poRaNa#muKya_poRaNa#noun#2#RM
management_watershed	jalagrahaNa_prabaMXana#jalagrahaNa_prabaMXana#noun#2#RM
managment_wild_life	jaMgalI_jIva_prabaMXana#jaMgalI_jIva_prabaMXana#noun#2#RM
marginal_farmer	sImAMwa_kisAna#sImAMwa_kisAna#noun#2#RM
marginal_soil	sImAMwa_BUmi/kama_upajAU_BUmi#sImAMwa_BUmi/kama_upajAU_BUmi#noun#2#RM
market_arrival	bAjZArI_Avaka#bAjZArI_Avaka#noun#2#RM
market_centre	vipaNana_keMxra#vipaNana_keMxra#noun#2#RM
market_demand	bAjZArI_mAzga#bAjZArI_mAzga#noun#2#RM
market_information	bAjZAra_sUcanA#bAjZAra_sUcanA#noun#2#RM
marketing_control	vipaNana_niyaMwraNa#vipaNana_niyaMwraNa#noun#2#RM
marketing_officer	vipaNana_aXikArI#vipaNana_aXikArI#noun#2#RM
market_intelligence	bAjZAra_AsUcanA#bAjZAra_AsUcanA#noun#2#RM
market_intermediary	vipaNana_bicOliyA#vipaNana_bicOliyA#noun#2#RM
market_price	bAjAra_BAva#bAjAra_BAva#noun#2#RM
market_report	bAjZAra_riporta#bAjZAra_riporta#noun#2#RM
market_review	bAjZAra_samIkRA#bAjZAra_samIkRA#noun#2#RM
market_value	bAjZAra_mUlya#bAjZAra_mUlya#noun#2#RM
mass_communication	jana_saMpreRaNa/jana_saMparka#jana_saMpreRaNa/jana_saMparka#noun#2#RM
mass_selection	samUha_cayana#samUha_cayana#noun#2#RM
maturity_index	paripakvawA_sUcakAMka#paripakvawA_sUcakAMka#noun#2#RM
maturity_ratio	paripakvawA_anupAwa#paripakvawA_anupAwa#noun#2#RM
maximum_water_holding_capacity	aXikawama_jalaXAraNa_kRamawA#aXikawama_jalaXAraNa_kRamawA#noun#2#RM
mean_length	Osawa_laMbAI#Osawa_laMbAI#noun#2#RM
means_of_communication	saMcAra_sAXana#saMcAra_sAXana#noun#2#RM
means_of_transport	parivahana_ke_sAXana#parivahana_ke_sAXana#noun#2#RM
medicinal_plant	ORaXIya_pOXA#ORaXIya_pOXA#noun#2#RM
medicinal_plants	ORaXIya_pOXe#ORaXIya_pOXe#noun#2#RM
medium_staple	Osawa_reSA#Osawa_reSA#noun#2#RM
medium_texture	bicalA_kaNa_AkAra#bicalA_kaNa_AkAra#noun#2#RM
mellow_soil	narama_mqxA#narama_mqxA#noun#2#RM
memorandum_of_understanding(mou)	samaJOwA/sahamawi_pawra#samaJOwA/sahamawi_pawra#noun#2#RM
mid-season_correction	maXya-mOsama_saMSoXana#maXya-mOsama_saMSoXana#noun#2#RM
mid_term_appraisal	maXyAvaXi_samIkRA#maXyAvaXi_samIkRA#noun#2#RM
minimum_bill_of_loading	nyUnawama_laxAna_pawra#nyUnawama_laxAna_pawra#noun#2#RM
minimum_price	nyUnawama_kZImawa#nyUnawama_kZImawa#noun#2#RM
minimum_support_prize	nyUnawama_samarWana_mUlya#nyUnawama_samarWana_mUlya#noun#2#RM
minimum_tillage	nyUnawama_jowa/juwAI#nyUnawama_jowa/juwAI#noun#2#RM
minor_irrigation	laGu_siMcAI#laGu_siMcAI#noun#2#RM
minor_nutrient	laGu_poRaNa#laGu_poRaNa#noun#2#RM
mixed_cropping	miSriwa_sasyana#miSriwa_sasyana#noun#2#RM
mixed_crops	miSraPasala#miSraPasala#noun#2#RM
mixed_farming	miSriwa_KewI#miSriwa_KewI#noun#2#RM
mixture_of_clay_and_sandy_soil	xomata#xomata#noun#2#RM
model_farm	AxarSa_PArma#AxarSa_PArma#noun#2#RM
moist_climates	nama_jalavAyu#nama_jalavAyu#noun#2#RM
moisture_absorption	namI_avaSoRaNa#namI_avaSoRaNa#noun#2#RM
moisture_content	namI_kI_mAwrA/jalAMSa#namI_kI_mAwrA/jalAMSa#noun#2#RM
moisture_equivalent	namI_saMwulana#namI_saMwulana#noun#2#RM
moisture_index	namI_sUcakAMka#namI_sUcakAMka#noun#2#RM
moisture_retention_curve	namI_XAraNa_cakra#namI_XAraNa_cakra#noun#2#RM
moisture_stress	namI_xabAva/namI_KiMcAva#namI_xabAva/namI_KiMcAva#noun#2#RM
moisture_tension	namI_wanAva#namI_wanAva#noun#2#RM
molecular_biology	ANvika_jIvavijFAna#ANvika_jIvavijFAna#noun#2#RM
molecular_configuration	ANvika_vinyAsa#ANvika_vinyAsa#noun#2#RM
monitoring_and_evaluation	parivIkRaNa_va_mUlyAMkana#parivIkRaNa_va_mUlyAMkana#noun#2#RM
mulch_farming	palavAra_kqRi#palavAra_kqRi#noun#2#RM
multiple_cost	bahuviXa_lAgawa#bahuviXa_lAgawa#noun#2#RM
multiple_cropping	bahu_PasalI#bahu_PasalI#noun#2#RM
multistoreyed_cropping	bahuwala_sasyana#bahuwala_sasyana#noun#2#RM
mushroom_culture	maSarUma_kalcara#maSarUma_kalcara#noun#2#RM
musk_melon	KarabUja#KarabUja#noun#2#RM
naked_seed	anAvqwwa_bIja#anAvqwwa_bIja#noun#2#RM
national_advisory_council	rARtrIya_salAhakAra_pariRaxa#rARtrIya_salAhakAra_pariRaxa#noun#2#RM
natural_resins_&_gums	prAkqwika_roYla_evaM_goMxa#prAkqwika_roYla_evaM_goMxa#noun#2#RM
natural_resources	prAkqwika_saMsAXana#prAkqwika_saMsAXana#noun#2#RM
necza_pine	cilagojA#cilagojA#noun#2#RM
neighbouring_district	padZOsI_jZile#padZOsI_jZile#noun#2#RM
net_amount	navala_rASi#navala_rASi#noun#2#RM
net_area_sown	kula_boyA_gayA_kRewra#kula_boyA_gayA_kRewra#noun#2#RM
net_gain	SuxXa_lABa#SuxXa_lABa#noun#2#RM
net_house	neta_hoYusa#neta_hoYusa#noun#2#RM
net_loss	SuxXa_GAtA/nivala_hAni#SuxXa_GAtA/nivala_hAni#noun#2#RM
net_profit	nivala/SuxXa_lABa#nivala/SuxXa_lABa#noun#2#RM
nigella_seeds	kalOMjI#kalOMjI#noun#2#RM
nitch_area	pramuKa_kRewra#pramuKa_kRewra#noun#2#RM
nitrogen_cycle	nAitrojana_cakra#nAitrojana_cakra#noun#2#RM
nitrogen_fixation	nAitrojana_viniveSana#nAitrojana_viniveSana#noun#2#RM
nitrogen_fixing	nAitrojana_yOgikIkaraNa#nAitrojana_yOgikIkaraNa#noun#2#RM
non_governmental_organisation_(ngo)	gEra_sarakArI_saMgaTana#gEra_sarakArI_saMgaTana#noun#2#RM
number_of_grains/plants	anAja/pOXoM_kI_saMKyA#anAja/pOXoM_kI_saMKyA#noun#2#RM
nut_borer	Pala_Cixraka#Pala_Cixraka#noun#2#RM
nut_meg	jAyaPala#jAyaPala#noun#2#RM
nutrient_management	poRaNa_prabaMXana#poRaNa_prabaMXana#noun#2#RM
off_season	be-mOsama#be-mOsama#noun#2#RM
off_year	niRPala_varRa#niRPala_varRa#noun#2#RM
oil_content	wela_wawva#wela_wawva#noun#2#RM
oil_seeds	wilahana#wilahana#noun#2#RM
omum_seed	ajavAyana#ajavAyana#noun#2#RM
on_year	PZasalI_varRa#PZasalI_varRa#noun#2#RM
opening_price	KulA_BAva#KulA_BAva#noun#2#RM
open_market	KulA_bAjZAra#KulA_bAjZAra#noun#2#RM
operating_centre	saMsAXana_keMxra#saMsAXana_keMxra#noun#2#RM
operating_profit	pracAlana_vyaya#pracAlana_vyaya#noun#2#RM
operational_research	paricAlana_anusaMXAna#paricAlana_anusaMXAna#noun#2#RM
opportunity_cost	vikalpa_wyAga#vikalpa_wyAga#noun#2#RM
optimum_price	anukUla_xara#anukUla_xara#noun#2#RM
organic_farming	jEvika_kqRi#jEvika_kqRi#noun#2#RM
organic_matter	jEva/kArbanika_paxArWa#jEva/kArbanika_paxArWa#noun#2#RM
organisational_matters	saMgaTanAwmaka_muxxe#saMgaTanAwmaka_muxxe#noun#2#RM
osmotic_pressure	rasAkarRaNa_xAba#rasAkarRaNa_xAba#noun#2#RM
out_put	uwpAxana#uwpAxana#noun#2#RM
outstanding_contribution	viSeRa_yogaxAna#viSeRa_yogaxAna#noun#2#RM
overall_efficiency	pUrNa_xakRawA#pUrNa_xakRawA#noun#2#RM
over_charge	aXipraBAra#aXipraBAra#noun#2#RM
over_control	sAmAnya_kI_wulanA_meM#sAmAnya_kI_wulanA_meM#noun#2#RM
over_the_year	kaI_varRoM_waka#kaI_varRoM_waka#noun#2#RM
particle_density	kaNa_Ganawva#kaNa_Ganawva#noun#2#RM
particle_size_analysis	kaNa_AkAra_viSleRaNa#kaNa_AkAra_viSleRaNa#noun#2#RM
partnership_and_linkage	sahaBAgiwA_Ora_sahayoga#sahaBAgiwA_Ora_sahayoga#noun#2#RM
pastoral_based_system	carAgAhI_AXAriwa_vyavasWA#carAgAhI_AXAriwa_vyavasWA#noun#2#RM
peak_season	carama_mOsama#carama_mOsama#noun#2#RM
pearl_millet	bAjarA#bAjarA#noun#2#RM
percolation_tank	aMwaHsravaNa_taMkI#aMwaHsravaNa_taMkI#noun#2#RM
performance_evaluation	niRpAxana_mUlyAMkana#niRpAxana_mUlyAMkana#noun#2#RM
periodic_yield	AvaXika_upaja#AvaXika_upaja#noun#2#RM
permanent_pastures	sWAI_carAgAha#sWAI_carAgAha#noun#2#RM
permanent_wilting	sWAI_mlAni/sWAI_muraJAna#sWAI_mlAni/sWAI_muraJAna#noun#2#RM
pest_control	kItanASI#kItanASI#noun#2#RM
pest_management	nASIjIva_prabaMXana#nASIjIva_prabaMXana#noun#2#RM
pf_value	pI.ePa._sUcaka/mAna#pI.ePa._sUcaka/mAna#noun#2#RM
physical_parameters	BOwika_mApaxaMda#BOwika_mApaxaMda#noun#2#RM
physical_properties	BOwika_guNaXarma#BOwika_guNaXarma#noun#2#RM
pigeon_pea	arahara#arahara#noun#2#RM
pilot_project	prAyogika_pariyojanA#prAyogika_pariyojanA#noun#2#RM
pink_bollworm	gulAbI_sUMdI#gulAbI_sUMdI#noun#2#RM
planning_commission	yojanA_Ayoga#yojanA_Ayoga#noun#2#RM
plan_outlay	yojanA_parivyaya#yojanA_parivyaya#noun#2#RM
plantation_crops	ropaNa_PasaleM#ropaNa_PasaleM#noun#2#RM
plant_bio_technology	pAxapa_jEva_prOxyogikI#pAxapa_jEva_prOxyogikI#noun#2#RM
plant_bio-technology	pAxapa_jEva_prOxyogikI#pAxapa_jEva_prOxyogikI#noun#2#RM
plant_community	pAxapa_samuxAya#pAxapa_samuxAya#noun#2#RM
plant_genetic	pAxapa_AnuvaMSikI#pAxapa_AnuvaMSikI#noun#2#RM
plant_genetic_resources	pAxapa_AnuvaMSika_saMsAXana#pAxapa_AnuvaMSika_saMsAXana#noun#2#RM
plant_geometry	pAxapa_jyAmiwi#pAxapa_jyAmiwi#noun#2#RM
planting_material	ropAI_sAmagrI#ropAI_sAmagrI#noun#2#RM
plant_nutrition	pAxapa_yojanA#pAxapa_yojanA#noun#2#RM
plant_pathology	pAxapa_rogavijFAna#pAxapa_rogavijFAna#noun#2#RM
plant_physiology	pAxapa_kAryikI#pAxapa_kAryikI#noun#2#RM
plant_population	pOXa_saMKyA#pOXa_saMKyA#noun#2#RM
plant_protection	pAxapa_saMrakRaNa#pAxapa_saMrakRaNa#noun#2#RM
plastic_limit	suGatyawA_sImA#suGatyawA_sImA#noun#2#RM
plastic_soil	suGatya_mqxA#suGatya_mqxA#noun#2#RM
plot_sample	namUnA_ploYta#namUnA_ploYta#noun#2#RM
plough_desi	xeSI_hala#xeSI_hala#noun#2#RM
plough_disc	wavexAra_hala#wavexAra_hala#noun#2#RM
plough_mouldboard	mittI-palata_hala#mittI-palata_hala#noun#2#RM
policy_issues	nIwigawa_muxxe#nIwigawa_muxxe#noun#2#RM
policy_research	nIwi_anusaMXAna#nIwi_anusaMXAna#noun#2#RM
pore_space	raMXra_kRewra#raMXra_kRewra#noun#2#RM
post_harvest_management	sasyowwara_prabaMXa/katAI_paRcAwa_prabaMXana#sasyowwara_prabaMXa/katAI_paRcAwa_prabaMXana#noun#2#RM
post_harvest	PasaloparAnwa#PasaloparAnwa#noun#2#RM
post_harvest_technology	PasalAnanwara_wakarIka#PasalAnanwara_wakarIka#noun#2#RM
post-harvest_tillage	katAI_ke_bAxa_kI_juwAI#katAI_ke_bAxa_kI_juwAI#noun#2#RM
potential_evapotranspiration	viBava/carama_vARpana-vARpowsarjana#viBava/carama_vARpana-vARpowsarjana#noun#2#RM
poultry_feed	cArA#cArA#noun#2#RM
powderly_mildew	romila_PaPUMxa#romila_PaPUMxa#noun#2#RM
practical_measures	prAyogika_upAya#prAyogika_upAya#noun#2#RM
pre-emergency_spraying	pUrvAexBexa_CidZakAva#pUrvAexBexa_CidZakAva#noun#2#RM
pregnancy_test	saMwawi_parIkRaNa#saMwawi_parIkRaNa#noun#2#RM
pre_release	vimocana_pUrva#vimocana_pUrva#noun#2#RM
pressure_membrane	JillI_xabAva_aMwaHsravaNa_taMkI#JillI_xabAva_aMwaHsravaNa_taMkI#noun#2#RM
prevalent_market_rate	cAlU_bAjZAra_BAva#cAlU_bAjZAra_BAva#noun#2#RM
prinicipal_scientist	praXAna_vEjFAnika#praXAna_vEjFAnika#noun#2#RM
prismatic_soil_structure	samapArAIya_mqxA_saMracanA#samapArAIya_mqxA_saMracanA#noun#2#RM
private_money_lender	nijI_sAhukAra#nijI_sAhukAra#noun#2#RM
product_cost	uwpAxa_lAgawa#uwpAxa_lAgawa#noun#2#RM
product_diversification	uwpAxa_viviXIkaraNa#uwpAxa_viviXIkaraNa#noun#2#RM
productivity_soil	mqxA_uwpAxakawA#mqxA_uwpAxakawA#noun#2#RM
profile_soil	BUmipArA_ciwra#BUmipArA_ciwra#noun#2#RM
profitable_farming	lABakArI_kqRi#lABakArI_kqRi#noun#2#RM
profitable_return	lABapraxa_prawiPala#lABapraxa_prawiPala#noun#2#RM
progressive_use	pragawi_prayoga#pragawi_prayoga#noun#2#RM
project_co-ordinator	pariyojanA_samanvayaka#pariyojanA_samanvayaka#noun#2#RM
project_director	pariyojanA_nixeSaka#pariyojanA_nixeSaka#noun#2#RM
project_leader	pariyojanA_aXyakRa#pariyojanA_aXyakRa#noun#2#RM
proposed_outlay	praswAviwa_parivyaya#praswAviwa_parivyaya#noun#2#RM
public_knowledge	sArvajanika_jFAna#sArvajanika_jFAna#noun#2#RM
puccinia_glumarum	paksIniyA_glUmerama#paksIniyA_glUmerama#noun#2#RM
pure_line	SuxXa_vaMSa_krama#SuxXa_vaMSa_krama#noun#2#RM
pure_strains	SuZxXa_nasla#SuZxXa_nasla#noun#2#RM
quality_control	guNavawwA_niyaMwraNa#guNavawwA_niyaMwraNa#noun#2#RM
quality_of_product	uwpAxa_kI_guNavawwA#uwpAxa_kI_guNavawwA#noun#2#RM
rabi_season	rabI_mOsama#rabI_mOsama#noun#2#RM
rainfall_simulator	renaPoYla_sImyUletara#renaPoYla_sImyUletara#noun#2#RM
rainfed_cropping_system	varRA_AXAriwa/varRApraXAna/varRASriwa_Pasala_praNAlI#varRA_AXAriwa/varRApraXAna/varRASriwa_Pasala_praNAlI#noun#2#RM
rainfed_farming	varRApraXAna_kqRi#varRApraXAna_kqRi#noun#2#RM
rainwater_conservation	varRAjala_saMrakRaNa#varRAjala_saMrakRaNa#noun#2#RM
rainy_day	varRA_kA_xina#varRA_kA_xina#noun#2#RM
rainy_spell	varRA_kI_JadZI#varRA_kI_JadZI#noun#2#RM
raising_animal	badZe_howe/baDZawe_paSu#badZe_howe/baDZawe_paSu#noun#2#RM
rapeseed_and_mustard	woriyA_evaM_sarasoM#woriyA_evaM_sarasoM#noun#2#RM
rate_of_interenst	byAja_xara#byAja_xara#noun#2#RM
ratoon_crop	pedZI/mUdZI_Pasala#pedZI/mUdZI_Pasala#noun#2#RM
raw_material	kaccA_mAla#kaccA_mAla#noun#2#RM
recent_advances_in_ruminant_nutrition	jugAlI_karane_vAle_paSu-poRaNa_meM_AXunika_vikAsa_cakramaNa/punaHcakra#jugAlI_karane_vAle_paSu-poRaNa_meM_AXunika_vikAsa_cakramaNa/punaHcakra#noun#2#RM
recurring_deposit	AvawrwI_jamA#AvawrwI_jamA#noun#2#RM
red_gram	malkA#malkA#noun#2#RM
red_rotten	lAla_galana#lAla_galana#noun#2#RM
red_sandy_loam_soil	lAla_baluI_xomata_mittI#lAla_baluI_xomata_mittI#noun#2#RM
red_soil	lAla_mqxA#lAla_mqxA#noun#2#RM
reduction_under_stress	prawibala_ke_aMwargawa_katOwI#prawibala_ke_aMwargawa_katOwI#noun#2#RM
reforest_to	punarvanaropaNa_karanA#punarvanaropaNa_karanA#noun#2#RM
regional_rural_bank	kRewrIya_grAmINa_bEMka#kRewrIya_grAmINa_bEMka#noun#2#RM
registered_seed	paMjIkqwa_bIja#paMjIkqwa_bIja#noun#2#RM
regression_co-efficient	samASrayaNa-guNAMka#samASrayaNa-guNAMka#noun#2#RM
regulated_market	niyaMwriwa_bAjZAra#niyaMwriwa_bAjZAra#noun#2#RM
relative_humidity	sApekRa_AxrrawA#sApekRa_AxrrawA#noun#2#RM
relay_cropping	anupaxa_sasyana#anupaxa_sasyana#noun#2#RM
remote_sensing	suxUra_saMvexI#suxUra_saMvexI#noun#2#RM
research_agenda	anusaMXAna_muxxA#anusaMXAna_muxxA#noun#2#RM
research_bulletin	anusaMXAna_buletina#anusaMXAna_buletina#noun#2#RM
research_characterization	saMsAXana_lakRaNa#saMsAXana_lakRaNa#noun#2#RM
research_&_development	anusaMXAna_evaM_vikAsa#anusaMXAna_evaM_vikAsa#noun#2#RM
research_highlights	pramuKa_anusaMXAna_upalabXiyAM#pramuKa_anusaMXAna_upalabXiyAM#noun#2#RM
reserve_capital	ArakRiwa_pUzjI#ArakRiwa_pUzjI#noun#2#RM
residual_shrinkage	avaSiRta_saMkocana#avaSiRta_saMkocana#noun#2#RM
resistant_variety	prawiroXaka_kisma#prawiroXaka_kisma#noun#2#RM
resource_characterization	saMsAXana_lakRaNa#saMsAXana_lakRaNa#noun#2#RM
resource_management	saMsAXana_prabaMXana#saMsAXana_prabaMXana#noun#2#RM
ribbed_gourd	kAlI_worI#kAlI_worI#noun#2#RM
ridge_and_furrow	meMdZa_evaM_gadDe#meMdZa_evaM_gadDe#noun#2#RM
rodent_control	kqnwaka_niyaMwraNa#kqnwaka_niyaMwraNa#noun#2#RM
root_feeding	mUla_veXa#mUla_veXa#noun#2#RM
root_stock	prakaMxa/mUlavqMwa#prakaMxa/mUlavqMwa#noun#2#RM
root_wilt_disease	jadZa_muraJA_roga#jadZa_muraJA_roga#noun#2#RM
root_zone	mUla_maMdala#mUla_maMdala#noun#2#RM
round_gourd	tiNdA#tiNdA#noun#2#RM
ruminant_nutrition	jugAlI_paSu-poRaNa#jugAlI_paSu-poRaNa#noun#2#RM
run_off	apavAha#apavAha#noun#2#RM
rural_area	grAmINa_kRewra#grAmINa_kRewra#noun#2#RM
rural_development	grAmINa/grAma_vikAsa#grAmINa/grAma_vikAsa#noun#2#RM
rural_literacy	grAmINa_sAkRarawA#grAmINa_sAkRarawA#noun#2#RM
rural_psychology	grAmINa_manovijFAna#grAmINa_manovijFAna#noun#2#RM
sale_deed	vikraya_vileKa#vikraya_vileKa#noun#2#RM
sale_proceeds	bikrI_Aya/prApwiyAM#bikrI_Aya/prApwiyAM#noun#2#RM
sales_assistant	bikrI_sahAyaka#bikrI_sahAyaka#noun#2#RM
saline-alkali_soil	KArI-kRArIya_mqxA#KArI-kRArIya_mqxA#noun#2#RM
saline_soil	KArI_mqxA/lavaNa_mqxA#KArI_mqxA/lavaNa_mqxA#noun#2#RM
saline_water	lavaNIya_jala#lavaNIya_jala#noun#2#RM
salt_affected_soil	lavaNa_praBAviwa_mqxA#lavaNa_praBAviwa_mqxA#noun#2#RM
sample_collection	namUnA_saMgrahaNa#namUnA_saMgrahaNa#noun#2#RM
sample_survey	namUnA_sarvekRaNa#namUnA_sarvekRaNa#noun#2#RM
sanction_budget	maMjZUra_bajata#maMjZUra_bajata#noun#2#RM
sandy_loam	baluI_xumata/xumata/xomata#baluI_xumata/xumata/xomata#noun#2#RM
sandy_soil	baluI_mqxA#baluI_mqxA#noun#2#RM
saturation_deficit	saMwqpwi_nyUnawA/saMwqpwi_aMwara#saMwqpwi_nyUnawA/saMwqpwi_aMwara#noun#2#RM
scale_insect	Salka_kIta#Salka_kIta#noun#2#RM
seasonal_crop	mOsamI_Pasala#mOsamI_Pasala#noun#2#RM
seasonal_trend	mOsamI_ruKZa#mOsamI_ruKZa#noun#2#RM
season_cropping	baDZawI_Pasala#baDZawI_Pasala#noun#2#RM
season_growing	varXana/ugAU_mOsama#varXana/ugAU_mOsama#noun#2#RM
secondary_nutrient	gONa_poRaNa#gONa_poRaNa#noun#2#RM
secondary_roots	xviwIyakajadZeM#xviwIyakajadZeM#noun#2#RM
seed_coat	bIjAvaraNa#bIjAvaraNa#noun#2#RM
seed_coat_fragment	bIjAvaraNa_ke_kaNa#bIjAvaraNa_ke_kaNa#noun#2#RM
seed_cotton	kapAsa#kapAsa#noun#2#RM
seed_drill	bIjavapiwra/bIja-drila#bIjavapiwra/bIja-drila#noun#2#RM
seed_garden	bIja_bAgZa#bIja_bAgZa#noun#2#RM
seed_index	bIja_sUcakAMka#bIja_sUcakAMka#noun#2#RM
seed_multiplication	bIja_guNAMka#bIja_guNAMka#noun#2#RM
seed_nut	bIja_Pala#bIja_Pala#noun#2#RM
seed_production	bIja_uwpAxana#bIja_uwpAxana#noun#2#RM
seed_setting	bIja_jamAnA#bIja_jamAnA#noun#2#RM
seed_technology	bIja_prOxyogikI#bIja_prOxyogikI#noun#2#RM
selected_variety	cuniMxA_kismeM#cuniMxA_kismeM#noun#2#RM
self_acquired	svarjiwa#svarjiwa#noun#2#RM
self_contained	saMvawHpUrNaspaRta#saMvawHpUrNaspaRta#noun#2#RM
self_explanatory	svawa#svawa#noun#2#RM
self_finance_group	svayaM_sahAyawA_samUha#svayaM_sahAyawA_samUha#noun#2#RM
self_finance_scheme	svayaM_sahAyawA_yojanApalavAra_maxA#svayaM_sahAyawA_yojanApalavAra_maxA#noun#2#RM
self_mulching_soil	svawa#svawa#noun#2#RM
self_pollination	svaparAgaNa#svaparAgaNa#noun#2#RM
selling_farm_products	PArma_uwpAxoM_ko_vikraya#PArma_uwpAxoM_ko_vikraya#noun#2#RM
selling_price	vikraya_mUlya#vikraya_mUlya#noun#2#RM
semi-arid_tropics_agriculture	arXa-SuRka_uRNa_katibaMXa_kqRi#arXa-SuRka_uRNa_katibaMXa_kqRi#noun#2#RM
semi_skilled	arXa_kuSala#arXa_kuSala#noun#2#RM
sesame_and_niger	wila_evaM_rAma_wila#wila_evaM_rAma_wila#noun#2#RM
shifting_cultivation	aMwaraNa_kqRi#aMwaraNa_kqRi#noun#2#RM
short_staple	CotA_reSA#CotA_reSA#noun#2#RM
significance_test	sArWakawA_parIkRaNa#sArWakawA_parIkRaNa#noun#2#RM
single_fibre	ikaharA_reSA#ikaharA_reSA#noun#2#RM
single_plant_selection	ekala_pAxapa_varaNa#ekala_pAxapa_varaNa#noun#2#RM
small_and_marginal_farmer	laGu_evaM_sImAMwa_kisAna#laGu_evaM_sImAMwa_kisAna#noun#2#RM
small_millets	Cote_mote_anAja#Cote_mote_anAja#noun#2#RM
small_stoneless	kiSamiSa#kiSamiSa#noun#2#RM
snake_gourd	ciciNdA#ciciNdA#noun#2#RM
sodic_soil	sodika_mqxA#sodika_mqxA#noun#2#RM
sodium_absorption_ratio	sodiyama_avaSoRaNa_anupAwa#sodiyama_avaSoRaNa_anupAwa#noun#2#RM
soft_water	mqxu_jala#mqxu_jala#noun#2#RM
soil_air	mqxA_vAyu#mqxA_vAyu#noun#2#RM
soil_auger	baramA_mqxA#baramA_mqxA#noun#2#RM
soil_conservation	mqxA_saMrakRaNa#mqxA_saMrakRaNa#noun#2#RM
soil_deplition	mqxA_apakRaya#mqxA_apakRaya#noun#2#RM
soil_erosion	mqxA_aparaxana/BU-katAva/BU-kRaraNa#mqxA_aparaxana/BU-katAva/BU-kRaraNa#noun#2#RM
soil_inventory	mqxA_sUcI_banAnA#mqxA_sUcI_banAnA#noun#2#RM
soil_management	mqxA_prabaMXana#mqxA_prabaMXana#noun#2#RM
soil_moisture	mqxA_namI#mqxA_namI#noun#2#RM
soil_moisture_replenishment	mqxA_AxrrawA_saMpUrwi#mqxA_AxrrawA_saMpUrwi#noun#2#RM
soil_science	mqxA_vijFAna#mqxA_vijFAna#noun#2#RM
soil_structure	mqxA_saMracanA#mqxA_saMracanA#noun#2#RM
soil_structure_types	mqxA_saMracanA_ke_prakAra#mqxA_saMracanA_ke_prakAra#noun#2#RM
soil_survey	BUmi/BU-sarvekRaNa#BUmi/BU-sarvekRaNa#noun#2#RM
soil_testing	mqxA_parIkRaNa#mqxA_parIkRaNa#noun#2#RM
soil_texture	mqxA_kaNa_AkAra#mqxA_kaNa_AkAra#noun#2#RM
soil_water_potential_capillary	mqxA_jala_kRamawA_koSakIya#mqxA_jala_kRamawA_koSakIya#noun#2#RM
soil_water_potential_gas_pressure	mqxA_jala_kRamawA_gEsa_xabAva#mqxA_jala_kRamawA_gEsa_xabAva#noun#2#RM
soil_water_potential_gravitational	mqxA_jala_kRamawA_gurUwvIya#mqxA_jala_kRamawA_gurUwvIya#noun#2#RM
soil_water_potential	mqxA_jala_kRamawA#mqxA_jala_kRamawA#noun#2#RM
soil_water_potential_osmotic	mqxA_jala_kRamawA_rasAkarRaNa#mqxA_jala_kRamawA_rasAkarRaNa#noun#2#RM
soil_water_potential_total	mqxA_jala_kRamawA_saMpUrNa#mqxA_jala_kRamawA_saMpUrNa#noun#2#RM
sole_crop	ekala_Pasala#ekala_Pasala#noun#2#RM
species_diversity	jAwIya_viviXawA#jAwIya_viviXawA#noun#2#RM
specific_resistant	viSiRta_prawiroXa#viSiRta_prawiroXa#noun#2#RM
spindle_leaf	kurkapawwA#kurkapawwA#noun#2#RM
split_application	bAMtakara_prayoga_karanA#bAMtakara_prayoga_karanA#noun#2#RM
split_application_fertilizer	bAMtakara_prayoga_karanA_urvaraka#bAMtakara_prayoga_karanA_urvaraka#noun#2#RM
split_application	kiswoM_meM_prayoga#kiswoM_meM_prayoga#noun#2#RM
sprinkler_irrigation	xrapwa_siMcAI#xrapwa_siMcAI#noun#2#RM
stake_holders	paNaXArI/BAgIxAra#paNaXArI/BAgIxAra#noun#2#RM
standard_atmosphere	mAnaka_vAyumaMdala#mAnaka_vAyumaMdala#noun#2#RM
standard_deviation	mAnaka_vicalana#mAnaka_vicalana#noun#2#RM
staple_length	waMwu_kI_laMbAI#waMwu_kI_laMbAI#noun#2#RM
steering_committee	viRaya_nirvAcana_samiwi#viRaya_nirvAcana_samiwi#noun#2#RM
stem_bleeding	wanAsrAla#wanAsrAla#noun#2#RM
stem_bore	wanA_Cexaka#wanA_Cexaka#noun#2#RM
stem_rot	wanA_sadZana#wanA_sadZana#noun#2#RM
strip_cropping	pattIxAra_KewI#pattIxAra_KewI#noun#2#RM
strip_tillage	pattIxAra_juwAI#pattIxAra_juwAI#noun#2#RM
structure_index	saMracanA_sUcakAMka#saMracanA_sUcakAMka#noun#2#RM
stubble_mulch	mUdZa_palavAra#mUdZa_palavAra#noun#2#RM
sub-surface_tillage	sWalamaMdala_karRaNa#sWalamaMdala_karRaNa#noun#2#RM
sugar_apple	sIwAPala#sIwAPala#noun#2#RM
sugar_beet	cukanxara#cukanxara#noun#2#RM
summer_camp	grIRmakAlIna_Sivira#grIRmakAlIna_Sivira#noun#2#RM
summer_school	grIRmakAlIna_SAlA#grIRmakAlIna_SAlA#noun#2#RM
sun_scotch	sUrya_Julasa#sUrya_Julasa#noun#2#RM
supplemental_irrigation	saMpUraka_siMcAI#saMpUraka_siMcAI#noun#2#RM
supplemental_sources	saMpUraka_mAXyama#saMpUraka_mAXyama#noun#2#RM
surface_level_irrigation	sawahI_siMcAI#sawahI_siMcAI#noun#2#RM
surface_run-off	walApavahana#walApavahana#noun#2#RM
surface_sealing	muxraNa-sWAna#muxraNa-sWAna#noun#2#RM
sustainable_agriculture	sWAI_kqRi/tikAU_KewI#sWAI_kqRi/tikAU_KewI#noun#2#RM
sustainable_dryland	sWAI_bArAnI#sWAI_bArAnI#noun#2#RM
sustained_productivity	tikAU_uwpAxakawA#tikAU_uwpAxakawA#noun#2#RM
tall_free_service	binA_mUlya_sevA#binA_mUlya_sevA#noun#2#RM
tap_root	mUsalA_jadZa/mUsala_mUla#mUsalA_jadZa/mUsala_mUla#noun#2#RM
teak_plants	tIka_ploYnta#tIka_ploYnta#noun#2#RM
temperate_climate	SIwoRNa_jalavAyu#SIwoRNa_jalavAyu#noun#2#RM
temporary_wilting	asWAyI_mlAnI#asWAyI_mlAnI#noun#2#RM
terrestrial_radiation	BOmika_vikiraNa#BOmika_vikiraNa#noun#2#RM
three_way_cross	wripaWI_saMkara/wrijanaka_saMkara#wripaWI_saMkara/wrijanaka_saMkara#noun#2#RM
tillage_contour	samoccareKA_juwAI#samoccareKA_juwAI#noun#2#RM
tillage_deep	gaharI_juwAI#gaharI_juwAI#noun#2#RM
tillage_minimum	nyUnawama_juwAI#nyUnawama_juwAI#noun#2#RM
tillage_mulch	palavAra_juwAI#palavAra_juwAI#noun#2#RM
tillage_primary	prAraMBika_juwAI#prAraMBika_juwAI#noun#2#RM
tillage_secondary	paravarwI_juwAI#paravarwI_juwAI#noun#2#RM
tilting_flume	tiltaga_PlUma#tiltaga_PlUma#noun#2#RM
time_of_concentration	sAMxrawA_samaya#sAMxrawA_samaya#noun#2#RM
time_tested	samayasamaya_para_jAMcI_gaI#samayasamaya_para_jAMcI_gaI#noun#2#RM
tissue_culture	Uwaka_saMvarXana#Uwaka_saMvarXana#noun#2#RM
topographic_factors	sWAlAkqwi_kAraka#sWAlAkqwi_kAraka#noun#2#RM
total_dry_weight	kula_SuRka_BAra#kula_SuRka_BAra#noun#2#RM
trade_balance	vyApAra_saMwulana#vyApAra_saMwulana#noun#2#RM
trade_promotion	vyApArika_saMbarXana#vyApArika_saMbarXana#noun#2#RM
traditional_plant_breeding_method	pAraMparika_pAxapa_prajanana_paxXawi#pAraMparika_pAxapa_prajanana_paxXawi#noun#2#RM
trainer's_training_centre	praSikRaka_praSikRaNa_keMxra#praSikRaka_praSikRaNa_keMxra#noun#2#RM
training_programme	praSikRaNa_kAryakrama#praSikRaNa_kAryakrama#noun#2#RM
transfer_of_technology	prOxyogikI_haswAMwaraNa#prOxyogikI_haswAMwaraNa#noun#2#RM
transgenic_cotton	parAjInI_kapAsa#parAjInI_kapAsa#noun#2#RM
tree_crop	pedZa/vqkRa_Pasala#pedZa/vqkRa_Pasala#noun#2#RM
tuber_crops	kaMxIya_PasaleM#kaMxIya_PasaleM#noun#2#RM
turn_over	KulI_bikrI#KulI_bikrI#noun#2#RM
ultimate_consumer	aMwima_upaBokwA#aMwima_upaBokwA#noun#2#RM
ultra_structure	awi_sUkRma_racanA#awi_sUkRma_racanA#noun#2#RM
under_utilised_crops	alpa_xohiwa_PasaleM#alpa_xohiwa_PasaleM#noun#2#RM
uneven_land	UbadZa-KAbadZa_jamIna#UbadZa-KAbadZa_jamIna#noun#2#RM
united_nations	saMyukwa_rARtra#saMyukwa_rARtra#noun#2#RM
untiring_efforts	aWaka_prayAsa#aWaka_prayAsa#noun#2#RM
use_efficiency	upayoga_kRamawA#upayoga_kRamawA#noun#2#RM
value_added	guNavarXiwa/mUlya_saMvarXana#guNavarXiwa/mUlya_saMvarXana#noun#2#RM
various_technologies	viBinna_prOxyogikiyAz#viBinna_prOxyogikiyAz#noun#2#RM
various_technology	viBinna_prOxyogikI#viBinna_prOxyogikI#noun#2#RM
vegetative_barrier	vAnaspawika_meDZa/vAnaspawika_bAzXa#vAnaspawika_meDZa/vAnaspawika_bAzXa#noun#2#RM
vertical_mulching	UXrva_palavAra#UXrva_palavAra#noun#2#RM
village_survey	grAma_sarvekRaNa#grAma_sarvekRaNa#noun#2#RM
voluntary_organisation	svEcCika_saMgaTana#svEcCika_saMgaTana#noun#2#RM
waste_land	bekAra_BUmi/vyarWa_BUmi/baMjara_BUmi#bekAra_BUmi/vyarWa_BUmi/baMjara_BUmi#noun#2#RM
waste_products	avaSiRta_uwpAxa#avaSiRta_uwpAxa#noun#2#RM
water_balance_equation	jala_saMwulana_samIkaraNa#jala_saMwulana_samIkaraNa#noun#2#RM
water_balance	jala_saMwulana#jala_saMwulana#noun#2#RM
water_deficit	jala_kI_sImA#jala_kI_sImA#noun#2#RM
water_harvesting	jala_saMcayana#jala_saMcayana#noun#2#RM
water_logging	jala-lagnawA/jalaroXa/jalAkramaNa#jala-lagnawA/jalaroXa/jalAkramaNa#noun#2#RM
water_melon	warabUja#warabUja#noun#2#RM
water_requirement	jala_AvaSyakawA#jala_AvaSyakawA#noun#2#RM
water_resistant	jalaroXI#jalaroXI#noun#2#RM
watershed_management	jalagrahaNa_prabaMXana#jalagrahaNa_prabaMXana#noun#2#RM
water_table	AMrBAEma_jalaswara/jala_sUcI#AMrBAEma_jalaswara/jala_sUcI#noun#2#RM
water_use_efficiency	jala_upayoga_xakRawA#jala_upayoga_xakRawA#noun#2#RM
water_yield	jala_upaja#jala_upaja#noun#2#RM
weather_forecast	mOsama_kA_pUrvAnumAna#mOsama_kA_pUrvAnumAna#noun#2#RM
weeding_out	nirAI-gudZAI/CaztAI#nirAI-gudZAI/CaztAI#noun#2#RM
wettable_sulphur	nilaMbanaSIla_gaMXaka#nilaMbanaSIla_gaMXaka#noun#2#RM
white_ant	xImaka#xImaka#noun#2#RM
white_goose_foot	baWuA#baWuA#noun#2#RM
white_grubs	saPexa_sUMdI#saPexa_sUMdI#noun#2#RM
wind_velocity	vAyu_vega#vAyu_vega#noun#2#RM
world_trade_organization	viA_vyApAra_saMgaTana#viA_vyApAra_saMgaTana#noun#2#RM
yard_stick	mAnaxaMda#mAnaxaMda#noun#2#RM
yellow_rust	haraxA/pIlA_kitta#haraxA/pIlA_kitta#noun#2#RM
yellow_rust_of_wheat	gehUz_kA_pIwa_kitta#gehUz_kA_pIwa_kitta#noun#2#RM
yellow_spot_of_pine_apple	anannAsa_pawi_ciwwI#anannAsa_pawi_ciwwI#noun#2#RM
yoke_tie	jowa/jowA#jowa/jowA#noun#2#RM
young_stock	bAla_paSuXana#bAla_paSuXana#noun#2#RM
zero_grazing	SUnya_carAI#SUnya_carAI#noun#2#RM
zero_tillage	SUnya_juwAI/SUnya_karRaNa#SUnya_juwAI/SUnya_karRaNa#noun#2#RM
zigzag_harrow	tedZA-medZA_hEro#tedZA-medZA_hEro#noun#2#RM
zinc_oxide	jZiMka_oYksAida#jZiMka_oYksAida#noun#2#RM
zonal_climatogenic_soil	kRewrIya_jalavAyu_praBAviwa_mqxA#kRewrIya_jalavAyu_praBAviwa_mqxA#noun#2#RM
zonal_coordinator	kRewrIya_samanvayaka#kRewrIya_samanvayaka#noun#2#RM
zonal_coordinator_unit	kRewrIya_samanvayaka_ikAI/yUnita#kRewrIya_samanvayaka_ikAI/yUnita#noun#2#RM
zonal_soil	kRewrIya/jonala_mqxA#kRewrIya/jonala_mqxA#noun#2#RM
peanut_soup	mUzgaPalI_se_banA_SorabA#mUzgaPalI_se_banA_SorabA#noun#2#RM
peanut_milk	mUzgaPalI_kA_xUXa#mUzgaPalI_kA_xUXa#noun#2#RM
oilcake_meal	KalI_kA_motA_AtA#KalI_kA_motA_AtA#noun#2#RM
catch_crop	aMwaravarwI_Pasala#aMwaravarwI_Pasala#noun#2#RM
