#banking multi dictionary extracted by Smriti Paliwal. Formatted by Roja (14-03-2016)
#Changes:: 1) Separated single word and multi words into separate dictionaries
#	   2) English words are converted to lower case
#	   3) Added category as 'noun' by default
#	   4) If last word is not punctuation then treated last word as head
#             or else treated last but one word as head
#####################################################################################
aap_anual_action_plan	vAfrRaka_kArya_yojanA#vAfrRaka_kArya_yojanA#noun#4#RM
acb_agricultural_credit_board	kqfrRa_qNaNa_borda#kqfrRa_qNaNa_borda#noun#4#RM
acb_apex_co-operative_bank	SiKara_sahakArI_bEMka#SiKara_sahakArI_bEMka#noun#4#RM
acd_agricultural_credit_department	kqRi_qNaNa_viBAga#kqRi_qNaNa_viBAga#noun#4#RM
acu_asian_clearing_union	eSiyAI_samASoXana_yUniyana#eSiyAI_samASoXana_yUniyana#noun#4#RM
ad_authorised_dealer	prAXikqwa_vyApArI#prAXikqwa_vyApArI#noun#3#RM
adb_asian_development_bank	eSiyAI_vikAsa_bEMka#eSiyAI_vikAsa_bEMka#noun#4#RM
additional_emoluments_(_compulsory_deposit_)_act_,_1974	awirikZwa_upalabXiyAM_(anivArya_nikRepa)_aXiniyama,_1974#awirikZwa_upalabXiyAM_(anivArya_nikRepa)_aXiniyama,_1974#noun#9#RM
administration_of_evacuee_property_act_,_1950	niRkrAMwa_sampafwwa_praSAsana_aXiniyama,_1950#niRkrAMwa_sampafwwa_praSAsana_aXiniyama,_1950#noun#7#RM
aeac_all_india_export_advisory_committee	aKila_BArawIya_niryAwa_parAmarSaxAwrI_samiwi#aKila_BArawIya_niryAwa_parAmarSaxAwrI_samiwi#noun#6#RM
aerc_agricultural_economic_research_centre	kqRi_ArWika_anusaMXAna_kenxra#kqRi_ArWika_anusaMXAna_kenxra#noun#5#RM
afc_agricultural_finance_corporation	kqRi_viwwa_nigama#kqRi_viwwa_nigama#noun#4#RM
agricultural_produce_(_grading_and_marking_)_act_,_1937	kqRi_upaja_(SreNIkaraNa_Ora_cinhAMkana)_aXiniyama,_1937#kqRi_upaja_(SreNIkaraNa_Ora_cinhAMkana)_aXiniyama,_1937#noun#10#RM
agricultural_produce_cess_act_,_1940	kqRi_upaja_upakara_aXiniyama,_1940#kqRi_upaja_upakara_aXiniyama,_1940#noun#6#RM
agricultural_refinance_and_development_corporation_act_,_1963	kqRi_punarviwwa_Ora_vikAsa_nigama_aXiniyama,_1963#kqRi_punarviwwa_Ora_vikAsa_nigama_aXiniyama,_1963#noun#8#RM
agriculturists_'_loans_act_,_1984	kqRaka_uXAra_aXiniyama,_1884#kqRaka_uXAra_aXiniyama,_1884#noun#6#RM
aic_agro_industries_corporation	kqRi_uxyoga_nigama#kqRi_uxyoga_nigama#noun#4#RM
aid_agency_for_international_development	anwarAZRtrIya_vikAsa_ejeMsI#anwarAZRtrIya_vikAsa_ejeMsI#noun#5#RM
aidis_all_india_debt_and_investment_survey	aKila_BArawIya_qNaNa_Ora_niveSa_sarvekRaNa#aKila_BArawIya_qNaNa_Ora_niveSa_sarvekRaNa#noun#7#RM
aihb_all_india_handicrafts_board	aKila_BArawIya_haswaSilpa_borda#aKila_BArawIya_haswaSilpa_borda#noun#5#RM
alda_agricultural_labourers_development_agency	kqRi_Sramika_vikAsa_ejeMsI#kqRi_Sramika_vikAsa_ejeMsI#noun#5#RM
all_india_services_act_,_1951	aKila_BArawIya_sevA_aXiniyama,_1951#aKila_BArawIya_sevA_aXiniyama,_1951#noun#6#RM
all_india_services_regulations_(_indemnity_)_act_,_1975	aKila_BArawIya_sevA_viniyama_(saMrakRaNa)_aXiniyama,_1975#aKila_BArawIya_sevA_viniyama_(saMrakRaNa)_aXiniyama,_1975#noun#10#RM
amu_asian_monetary_union	eSiyAI_mOfxraka_saMGa#eSiyAI_mOfxraka_saMGa#noun#4#RM
amu_asian_monetary_unit	eSiyAI_mOfxraka_ikAI#eSiyAI_mOfxraka_ikAI#noun#4#RM
anti_corruption_laws_(_amendment_)_act_,_1967	BraRtAcAra_niroXa_viXi_(saMSoXana)_aXiniyama,_1967#BraRtAcAra_niroXa_viXi_(saMSoXana)_aXiniyama,_1967#noun#9#RM
apc_agricultural_prices_commission	kqRi_mUlya_Ayoga#kqRi_mUlya_Ayoga#noun#4#RM
apprentices_act_,_1961	SikRu_aXiniyama,_1961#SikRu_aXiniyama,_1961#noun#4#RM
aprca_asian_pacific_regional_credit_association	eSiyAI_Ora_praSAMwa_kRewrIya_qNaNa_saMGa#eSiyAI_Ora_praSAMwa_kRewrIya_qNaNa_saMGa#noun#6#RM
apu_asian_payments_union	eSiyAI_BugawAna_saMGa#eSiyAI_BugawAna_saMGa#noun#4#RM
arbitration_(_protocol_and_convention_)_act_,_1937	mAXyasWam(protokola_Ora_afBasamaya)_aXiniyama,_1937#mAXyasWam(protokola_Ora_afBasamaya)_aXiniyama,_1937#noun#9#RM
arbitration_act_,_1940	mAXyasWama_aXiniyama,_1940#mAXyasWama_aXiniyama,_1940#noun#4#RM
ardc_agricultural_refinance_and_development_corporation	kqRi_punarviwwa_Ora_vikAsa_nigama#kqRi_punarviwwa_Ora_vikAsa_nigama#noun#6#RM
arm_additional_resource_mobilisation	awirikZwa_saMsAXana_jutAnA#awirikZwa_saMsAXana_jutAnA#noun#4#RM
arms_act_,_1959	AyuXa_aXiniyama,_1959#AyuXa_aXiniyama,_1959#noun#4#RM
asc_agricultural_service_centre	kqRi_sevA_kenxra#kqRi_sevA_kenxra#noun#4#RM
asean_association_of_south_east_asian_nations	xakRiNa_pUrva_eSiyAI_rARtroM_kA_saMGa#xakRiNa_pUrva_eSiyAI_rARtroM_kA_saMGa#noun#7#RM
asf_agricultural_stabilization_fund	kqRi_sWirIkaraNa_niXi#kqRi_sWirIkaraNa_niXi#noun#4#RM
asian_development_bank_act_,_1966	eSiyAI_vikAsa_bEMka_aXiniyama,_1966#eSiyAI_vikAsa_bEMka_aXiniyama,_1966#noun#6#RM
authorised_translations_(_central_laws_)_act_,_1973	prAXikqwa_anuvAxa_(kenxrIya_viXi)_aXiniyama,_1973#prAXikqwa_anuvAxa_(kenxrIya_viXi)_aXiniyama,_1973#noun#9#RM
avard_association_of_voluntary_agencies_for_rural_development	grAmINa_vikAsa_svEcCika_ejeMsI_saMGa#grAmINa_vikAsa_svEcCika_ejeMsI_saMGa#noun#8#RM
balance_sheet	wulana-pawra#wulana-pawra#noun#2#RM
bankers_books_evidence_act_,_1891	bEMkakAra_bahI_sAkRya_aXiniyama,_1891#bEMkakAra_bahI_sAkRya_aXiniyama,_1891#noun#6#RM
banking_and_public_financial_institutions_laws_(_amendment_)_act_,_1976	bEMkakArI_Ora_loka_viwwIya_saMsWA_viXi_(saMSoXana)_aXiniyama,_1976#bEMkakArI_Ora_loka_viwwIya_saMsWA_viXi_(saMSoXana)_aXiniyama,_1976#noun#12#RM
banking_companies_(_acquisition_and_transfer_of_undertakings_)_act_,_1969_,	bEMkakArI_kampanI_(upakramoM_kA_arjana_Ora_anwaraNa)_aXiniyama,_1969#bEMkakArI_kampanI_(upakramoM_kA_arjana_Ora_anwaraNa)_aXiniyama,_1969#noun#12#RM
banking_companies_(_amendment_)_act_,_1956	bEMkakArI_kampanI_(saMSoXana)_aXiniyama,_1956#bEMkakArI_kampanI_(saMSoXana)_aXiniyama,_1956#noun#8#RM
banking_companies_(_legal_practitioners_clients_accounts_)_act_,_1949	bEMkakArI_kampanI_(viXi_vyavasAyiyoM_ke_muvafkkaloM_ke_KAwe)_aXiniyama,_1949#bEMkakArI_kampanI_(viXi_vyavasAyiyoM_ke_muvafkkaloM_ke_KAwe)_aXiniyama,_1949#noun#11#RM
banking_regulation_act_,_1949	bEMkakArI_viniyamana_aXiniyama,_1949#bEMkakArI_viniyamana_aXiniyama,_1949#noun#5#RM
banking_service_commission_(_repeal_)_act_,_1978	bEMkakArI_sevA_Ayoga_(nirasana)_aXiniyama,_1978#bEMkakArI_sevA_Ayoga_(nirasana)_aXiniyama,_1978#noun#9#RM
bcc_backward_classes_commission	piCadZI_jAwi_Ayoga#piCadZI_jAwi_Ayoga#noun#4#RM
bdo_block_development_officer	KaMda_vikAsa_aXikArI#KaMda_vikAsa_aXikArI#noun#4#RM
bifr_board_for_industrial_and_financial_reconstruction	Oxyogika_Ora_viwwIya_punaniZrmANa_borda#Oxyogika_Ora_viwwIya_punaniZrmANa_borda#noun#7#RM
bill_of_exchange	vinimaya-pawra#vinimaya-pawra#noun#3#RM
bill_of_lading	laxAna-pawra#laxAna-pawra#noun#3#RM
bills_discounted	BunAye_gaye_bila#BunAye_gaye_bila#noun#2#RM
bills_for_collection	vasUlI_ke_lie_bila#vasUlI_ke_lie_bila#noun#3#RM
bills_payable	xeya_bila#xeya_bila#noun#2#RM
bills_receivable	prApya_bila#prApya_bila#noun#2#RM
births_,_deaths_and_marriage_registration_act_,_1886	janma,_mqwyu_Ora_vivAha_rajistrIkaraNa_aXiniyama,_1886#janma,_mqwyu_Ora_vivAha_rajistrIkaraNa_aXiniyama,_1886#noun#9#RM
bis_bank_for_international_settlement	aMwarAZRtrIya_nipatAna_bEMka#aMwarAZRtrIya_nipatAna_bEMka#noun#5#RM
boi_book_of_instructions	anuxeSa_puswaka#anuxeSa_puswaka#noun#4#RM
bpe_bureau_of_public_enterprises	loka_uxyama_kAryAlaya#loka_uxyama_kAryAlaya#noun#5#RM
bra_banking_regulation_act	bEMkakArI_vinimaya_aXiniyama#bEMkakArI_vinimaya_aXiniyama#noun#4#RM
branch_office	SAKA_kAryAlaya#SAKA_kAryAlaya#noun#2#RM
brs_bills_rediscounting_scheme	bila_punaBaZunAI_yojanA#bila_punaBaZunAI_yojanA#noun#4#RM
bsr_basic_statistical_return	mUlaBUwa_sAMfKyakIya_vivaraNI#mUlaBUwa_sAMfKyakIya_vivaraNI#noun#4#RM
bsrb_banking_services_recruitment_board	bEMkiMga_sevA_BarwI_borda#bEMkiMga_sevA_BarwI_borda#noun#5#RM
btc_bankers_training_college	bEMkara_praSikRaNa_mahAvixyAlaya#bEMkara_praSikRaNa_mahAvixyAlaya#noun#4#RM
cab_college_of_agricultural_banking	kqRi_bEMkiMga_mahAvixyAlaya#kqRi_bEMkiMga_mahAvixyAlaya#noun#5#RM
cab_cotton_advisory_board	kapAsa_parAmarSaxAwA_borda#kapAsa_parAmarSaxAwA_borda#noun#4#RM
cacp_commission_for_agricultural_costs_and_prices	kqRi_lAgawa_Ora_mUlya_Ayoga#kqRi_lAgawa_Ora_mUlya_Ayoga#noun#7#RM
cada_command_area_development_agency	kamAna_kRewra_vikAsa_ejeMsI#kamAna_kRewra_vikAsa_ejeMsI#noun#5#RM
cadp_command_area_development_programme	kamAna_kRewra_vikAsa_kAryakrama#kamAna_kRewra_vikAsa_kAryakrama#noun#5#RM
caiib_certificated_associate_of_the_indian_institute_of_bankers	BArawIya_bEMkara_saMsWAna_kA_pramANapawriwa_esosieta#BArawIya_bEMkara_saMsWAna_kA_pramANapawriwa_esosieta#noun#9#RM
capital_issues_(_control_)_act_,_1947	pUMjI_nirgamana_(niyaMwraNa)_aXiniyama,_1947#pUMjI_nirgamana_(niyaMwraNa)_aXiniyama,_1947#noun#8#RM
card_institutional_credit_for_agriculture_rural_development	qNa_vyavasWA_kI_punarIkRaNa_samiwi#qNa_vyavasWA_kI_punarIkRaNa_samiwi#noun#7#RM
carriage_by_air_act_,_1972	vimAnavahana_aXiniyama,_1972#vimAnavahana_aXiniyama,_1972#noun#6#RM
carriers_act_,_1865	vAhaka_aXiniyama,_1865#vAhaka_aXiniyama,_1865#noun#4#RM
cas_credit_authorisation_scheme	qNa_prAXikaraNa_yojanA#qNa_prAXikaraNa_yojanA#noun#4#RM
cash_credit	nakaxI_qNa#nakaxI_qNa#noun#2#RM
cbdt_central_board_of_direct_taxes	kenxrIya_prawyakRa_kara_borda#kenxrIya_prawyakRa_kara_borda#noun#6#RM
cbec_central_board_of_excise_and_customs	kenxrIya_uwpAxana_Ora_sImA_Sulka_borda#kenxrIya_uwpAxana_Ora_sImA_Sulka_borda#noun#7#RM
cbr_central_board_of_revenue	kenxrIya_rAjasva_borda#kenxrIya_rAjasva_borda#noun#5#RM
ccb_central_co-operative_bank	maXyavarwI_sahakArI_bEMka#maXyavarwI_sahakArI_bEMka#noun#4#RM
cci_cashew_corporation_of_india	BArawIya_kAjU_nigama#BArawIya_kAjU_nigama#noun#5#RM
cci_controller_of_capital_issues	pUMjI_nirgama_niyaMwraka#pUMjI_nirgama_niyaMwraka#noun#5#RM
cci_cotton_corporation_of_india	BArawIya_kapAsa_nigama#BArawIya_kapAsa_nigama#noun#5#RM
ccs_cash_compensatory_scheme	nakaxI_prawipUrwi_yojanA#nakaxI_prawipUrwi_yojanA#noun#4#RM
ccs_cash_compensatory_support	nakaxI_prawipUrwi_sahAyawA#nakaxI_prawipUrwi_sahAyawA#noun#4#RM
cd_convertible_debenture	parivarwanIya_dibEMcara#parivarwanIya_dibEMcara#noun#3#RM
cdf_currency_declaration_form	muxrA_GoRaNA_PArma#muxrA_GoRaNA_PArma#noun#4#RM
cdp_gross_domestic_product	sakala_xeSI_uwpAxa#sakala_xeSI_uwpAxa#noun#4#RM
cds_compulsory_deposit_scheme	anivArya_jamA_yojanA#anivArya_jamA_yojanA#noun#4#RM
census_act_,_1948	janagaNanA_aXiniyama,_1948#janagaNanA_aXiniyama,_1948#noun#4#RM
central_board_direct_taxes_(_validation_of_proceedings_)_act_,_1971	kenxrIya_prawyakRa_kara_borda_(kAryavAhiyoM_kA_viXimAnyakaraNa)_aXiniyama,_1971#kenxrIya_prawyakRa_kara_borda_(kAryavAhiyoM_kA_viXimAnyakaraNa)_aXiniyama,_1971#noun#12#RM
central_boards_of_revenue_act_,_1963	kenxrIya_rAjasva_borda_aXiniyama,_1963#kenxrIya_rAjasva_borda_aXiniyama,_1963#noun#7#RM
central_industrial_security_force_act_,_1968	kenxrIya_Oxyogika_surakRA_bala_aXiniyama,_1968#kenxrIya_Oxyogika_surakRA_bala_aXiniyama,_1968#noun#7#RM
central_sales_tax_act_,_1956	kenxrIya_vikraya_kara_aXiniyama,_1956#kenxrIya_vikraya_kara_aXiniyama,_1956#noun#6#RM
cff_compensatory_financing_facility	kRawipUraka_viwwapoRaNa_suviXA#kRawipUraka_viwwapoRaNa_suviXA#noun#4#RM
cghs_central_govt._health_scheme	kenxrIya_sarakAra_svAsWya_yojanA#kenxrIya_sarakAra_svAsWya_yojanA#noun#5#RM
cgo_credit_guarantee_organisation	qNa_gAraMtI_saMgaTana#qNa_gAraMtI_saMgaTana#noun#4#RM
cgs_credit_guarantee_scheme	qNa_gAraMtI_yojanA#qNa_gAraMtI_yojanA#noun#4#RM
cgwb_central_ground_water_board	kenxrIya_BU-jala_borda#kenxrIya_BU-jala_borda#noun#5#RM
charitable_and_religious_trusts_act_,_1920	pUrwa_Ora_XArmika_nyAsa_aXiniyama,_1920#pUrwa_Ora_XArmika_nyAsa_aXiniyama,_1920#noun#7#RM
charitable_endowments_act_,_1890	pUrwa_vinyAsa_aXiniyama,_1890#pUrwa_vinyAsa_aXiniyama,_1890#noun#5#RM
chartered_accountant	sanaxI_leKAkAra#sanaxI_leKAkAra#noun#2#RM
chartered_accountants_act_,_1949	cArtarda_akAunteMta_aXiniyama,_1949#cArtarda_akAunteMta_aXiniyama,_1949#noun#5#RM
child_marriage_restraint_act_,_1929	bAlaka_vivAha_avaroXa_aXiniyama,_1929#bAlaka_vivAha_avaroXa_aXiniyama,_1929#noun#6#RM
children_act_,_1960	bAlaka_aXiniyama,_1960#bAlaka_aXiniyama,_1960#noun#4#RM
cida_canadian_international_development_association	kanAdA_anwarAZRtrIya_vikAsa_saMGa#kanAdA_anwarAZRtrIya_vikAsa_saMGa#noun#5#RM
cieti_central_industrial_extension_training_institute	kenxrIya_Oxyogika_viswAra_praSikRaNa_saMsWAna#kenxrIya_Oxyogika_viswAra_praSikRaNa_saMsWAna#noun#6#RM
cif_cost_insurance_freight	lAgawa/bImA_Ora_BAdZA#lAgawa/bImA_Ora_BAdZA#noun#4#RM
cif_cost_insure_and_freight	lAgawa_bImA_Ora_mAMga#lAgawa_bImA_Ora_mAMga#noun#5#RM
cifc_cost_,_insurance_,_freight_commission	lAgawa/bImA/BAdZA_Ora_kamISana#lAgawa/bImA/BAdZA_Ora_kamISana#noun#7#RM
citizenship_act_,_1955	nAgarikawA_aXiniyama,_1955#nAgarikawA_aXiniyama,_1955#noun#4#RM
civil_defence_act_,_1968	nAgarika_surakRA_aXiniyama,_1968#nAgarika_surakRA_aXiniyama,_1968#noun#5#RM
cldb_central_land_development_bank	kenxrIya_BUmi_vikAsa_bEMka#kenxrIya_BUmi_vikAsa_bEMka#noun#5#RM
clrs_central_land_reforms_committee	kenxrIya_BUmi_suXAra_samiwi#kenxrIya_BUmi_suXAra_samiwi#noun#5#RM
cmea_council_for_mutual_economic_assistance	pArasparika_ArWika_sahAyawA_pariRaxa#pArasparika_ArWika_sahAyawA_pariRaxa#noun#6#RM
co-operative_societies_act_,_1912	sahakArI_sosAitI_aXiniyama,_1912#sahakArI_sosAitI_aXiniyama,_1912#noun#5#RM
cod_cash_on_delivery	supurxagI_para_nakaxa_axAyagI#supurxagI_para_nakaxa_axAyagI#noun#4#RM
code_of_civil_procedure_(_amendment_)_act_,_1956	sivila_prakriyA_saMhiwA_(saMSoXana)_aXiniyama,_1956#sivila_prakriyA_saMhiwA_(saMSoXana)_aXiniyama,_1956#noun#10#RM
code_of_civil_procedure_,_1908	sivila_prakriyA_saMhiwA,_1908#sivila_prakriyA_saMhiwA,_1908#noun#6#RM
code_of_criminal_procedure_,_1973	xaNda_prakriyA_saMhiwA,_1973#xaNda_prakriyA_saMhiwA,_1973#noun#6#RM
cofe-posa_conservation_of_foreign_exchange_prevention_of_smuggling_activities	vixeSI_muxrA_saMrakRaNa_Ora_waskarI_kArya_niroXa#vixeSI_muxrA_saMrakRaNa_Ora_waskarI_kArya_niroXa#noun#9#RM
coinage_act_,_1906	sikkA-nirmANa_aXiniyama,_1906#sikkA-nirmANa_aXiniyama,_1906#noun#4#RM
collection_of_statistics_act_,_1953	sAMfKyakIya_saMgrahaNa_aXiniyama,_1953#sAMfKyakIya_saMgrahaNa_aXiniyama,_1953#noun#6#RM
commercial_documents_evidence_act_,_1939	vANifjyaka_xaswAveja_sAkRya_aXiniyama,_1939#vANifjyaka_xaswAveja_sAkRya_aXiniyama,_1939#noun#6#RM
commission_of_inquiry_act_,_1952	jAMca_Ayoga_aXiniyama,_1952#jAMca_Ayoga_aXiniyama,_1952#noun#6#RM
companies_(_donation_to_national_funds_)_act_,_1951	kampanI_(rARtrIya_niXiyoM_meM_xAna)_aXiniyama,_1951#kampanI_(rARtrIya_niXiyoM_meM_xAna)_aXiniyama,_1951#noun#10#RM
companies_(_profits_)_surtax_act_,_1964	kampanI_(lABa)_awikara_aXiniyama,_1964#kampanI_(lABa)_awikara_aXiniyama,_1964#noun#8#RM
companies_(_surcharge_on_income-tax_)_act_,_1971	kampanI_(Aya-kara_para_aXiBAra)_aXiniyama,_1971#kampanI_(Aya-kara_para_aXiBAra)_aXiniyama,_1971#noun#9#RM
companies_(_temporary_restrictions_on_dividends_)_act_,_1974	kampanI_(lABAMSoM_para_asWAyI_nirbaMXana)_aXiniyama,_1974#kampanI_(lABAMSoM_para_asWAyI_nirbaMXana)_aXiniyama,_1974#noun#10#RM
companies_act_,_1956	kampanI_aXiniyama,_1956#kampanI_aXiniyama,_1956#noun#4#RM
company_secretaries_act_,_1980	kampanI_saciva_aXiniyama,_1980#kampanI_saciva_aXiniyama,_1980#noun#5#RM
comptroller_and_auditor_generals_(_duties_,_powers_and_conditions_of_service_)_act_,_1971	niyaMwraka-mahAleKAparIkRaka_(karwavya/SakwiyAM_waWA_sevA_kI_SarweM)_aXiniyama,_1971#niyaMwraka-mahAleKAparIkRaka_(karwavya/SakwiyAM_waWA_sevA_kI_SarweM)_aXiniyama,_1971#noun#16#RM
compulsory_deposit_scheme_(_income-tax_payers_)_act_,_1974	anivArya_nikRepa_skIma_(Aya-kara_xAwA)_aXiniyama,_1974#anivArya_nikRepa_skIma_(Aya-kara_xAwA)_aXiniyama,_1974#noun#10#RM
compulsory_deposit_scheme_act_,_1963	anivArya_nikRepa_skIma_aXiniyama,_1963#anivArya_nikRepa_skIma_aXiniyama,_1963#noun#6#RM
conservation_of_foreign_exchange_and_prevention_of_smuggling_activities_act_,_1974	vixeSI_muxrA_saMrakRaNa_Ora_waskarI_nivAraNa_aXiniyama,_1974#vixeSI_muxrA_saMrakRaNa_Ora_waskarI_nivAraNa_aXiniyama,_1974#noun#12#RM
contempt_of_courts_act_,_1971	nyAyAlaya_avamAna_aXiniyama,_1971#nyAyAlaya_avamAna_aXiniyama,_1971#noun#6#RM
contingency_fund_of_indian_act_,_1950	BArawa_kI_AkafsmakawA_niXi_aXiniyama,_1950#BArawa_kI_AkafsmakawA_niXi_aXiniyama,_1950#noun#7#RM
continuance_of_legal_proceedings_act_,_1948	viviXa_kAryavAhiyoM_kA_cAlU_raha_jAnA_aXiniyama,_1948#viviXa_kAryavAhiyoM_kA_cAlU_raha_jAnA_aXiniyama,_1948#noun#7#RM
contra_against_(_contra_entry_)	prawi_praviRti/xuwaraPA_praviRti/prawipakRI_uBayapakRI#prawi_praviRti/xuwaraPA_praviRti/prawipakRI_uBayapakRI#noun#5#RM
contract_labour_(_regulation_and_abolition_)_act_,_1970	TekA_Srama_(viniyamana_Ora_uwpAxana)_aXiniyama,_1970#TekA_Srama_(viniyamana_Ora_uwpAxana)_aXiniyama,_1970#noun#10#RM
copyright_act_,_1957	prawilipyaXikAra_aXiniyama,_1957#prawilipyaXikAra_aXiniyama,_1957#noun#4#RM
cost_and_works_accountants_act_,_1959	lAgawa_Ora_saMkarma_akAuMteMta_aXiniyama,_1959#lAgawa_Ora_saMkarma_akAuMteMta_aXiniyama,_1959#noun#7#RM
court-fees_act_,_1870	nyAyAlaya_PIsa_aXiniyama,_1870#nyAyAlaya_PIsa_aXiniyama,_1870#noun#4#RM
crafi-committee_to_review_arrangement_for	kqRi_Ora_grAmINa_vikAsa_ke_lie_saMsWAgawa#kqRi_Ora_grAmINa_vikAsa_ke_lie_saMsWAgawa#noun#5#RM
cri_concessional_rate_of_interest	riyAyawI_byAja_xara#riyAyawI_byAja_xara#noun#5#RM
criminal_law_amendment_act_,_1932	xaMda_viXi_saMSoXana_aXiniyama,_1932#xaMda_viXi_saMSoXana_aXiniyama,_1932#noun#6#RM
crr_cash_reserve_ratio	prArakRiwa_nakaxI_niXi_anupAwa#prArakRiwa_nakaxI_niXi_anupAwa#noun#4#RM
cso_central_statistical_organisation	kenxrIya_sAMfKyakIya_saMgaTana#kenxrIya_sAMfKyakIya_saMgaTana#noun#4#RM
csps_central_sector_plan_scheme	kenxrIya_kRewra_Ayojana_kI_yojanA#kenxrIya_kRewra_Ayojana_kI_yojanA#noun#5#RM
ctd_cumulative_term_deposit	saMcayI_sAvaXi_jamA#saMcayI_sAvaXi_jamA#noun#4#RM
current_account	cAlU_KAwA#cAlU_KAwA#noun#2#RM
customs_act_,_1962	sImA-Sulka_aXiniyama,_1962#sImA-Sulka_aXiniyama,_1962#noun#4#RM
customs_tariff_act_,_1975	sImA_Sulka_tEriPa_aXiniyama,_1975#sImA_Sulka_tEriPa_aXiniyama,_1975#noun#5#RM
cvri_central_veterinary_research_institute	kenxrIya_paSucikiwsA_anusaMXAna_saMsWA#kenxrIya_paSucikiwsA_anusaMXAna_saMsWA#noun#5#RM
cws_central_warehousing_corporation	kenxrIya_BANdAgAraNa_nigama#kenxrIya_BANdAgAraNa_nigama#noun#4#RM
dac_development_assistance_committee	vikAsa_sahAyawA_samiwi#vikAsa_sahAyawA_samiwi#noun#4#RM
davp_directorate_of_advertising_and_visual_publicity	vijFApana_evaM_Sya_pracAra_nixeSAlaya#vijFApana_evaM_Sya_pracAra_nixeSAlaya#noun#7#RM
dbod_department_of_banking_operations_development	bEMkiMga_paricAlana_Ora_vikAsa_viBAga#bEMkiMga_paricAlana_Ora_vikAsa_viBAga#noun#6#RM
dcc_district_consultative_committee	jilA_parAmarSaxAwrI_samiwi#jilA_parAmarSaxAwrI_samiwi#noun#4#RM
dccb_district_central_co-operative_bank	jilA_maXyavarwI_sahakArI_bEMka#jilA_maXyavarwI_sahakArI_bEMka#noun#5#RM
dcp_district_credit_plan	jilA_qNa_yojanA#jilA_qNa_yojanA#noun#4#RM
dds_duty_drawback_scheme	Sulka_vApasI_yojanA#Sulka_vApasI_yojanA#noun#4#RM
decrees_and_orders_validating_act_,_1936	dikrI_Ora_AxeSa_viXimAnyakaraNa_aXiniyama,_1936#dikrI_Ora_AxeSa_viXimAnyakaraNa_aXiniyama,_1936#noun#7#RM
defence_and_internal_security_of_india_act_,_1971	BArawa_rakRA_Ora_Anwarika_surakRA_aXiniyama,_1971#BArawa_rakRA_Ora_Anwarika_surakRA_aXiniyama,_1971#noun#9#RM
delimitation_act_,_1972	parisImana_aXiniyama,_1972#parisImana_aXiniyama,_1972#noun#4#RM
delimitation_commission_act_,_1962	parisImana_Ayoga_aXiniyama,_1962#parisImana_Ayoga_aXiniyama,_1962#noun#5#RM
demand_draft	mAMga_drAPta#mAMga_drAPta#noun#2#RM
departmental_inquiries_(_enforcement_of_attendance_of_witnesses_and_production_of_documents_)_act_,_1972	viBAgIya_jAMca_(sAkRiyoM_ko_hAjira_karAnA_waWA_xaswAveja_peSa_karAnA)_aXiniyama,_1972#viBAgIya_jAMca_(sAkRiyoM_ko_hAjira_karAnA_waWA_xaswAveja_peSa_karAnA)_aXiniyama,_1972#noun#16#RM
deposit_insurance_corporation_(_amendment_and_miscellaneous_provisions_)_act_,_1978	nikRepa_bImA_nigama_(saMSoXana_Ora_prakIrNa_upabanXa)_aXiniyama,_1978#nikRepa_bImA_nigama_(saMSoXana_Ora_prakIrNa_upabanXa)_aXiniyama,_1978#noun#12#RM
deposit_insurance_corporation_act_,_1961	nikRepa_bImA_nigama_aXiniyama,_1961#nikRepa_bImA_nigama_aXiniyama,_1961#noun#6#RM
der_debt_equity_ratio	qNa_IfkvatI_anupAwa#qNa_IfkvatI_anupAwa#noun#4#RM
des_duty_exemption_scheme	Sulka_CUta_yojanA#Sulka_CUta_yojanA#noun#4#RM
designs_act_,_1911	dijZAina_aXiniyama,_1911#dijZAina_aXiniyama,_1911#noun#4#RM
destriction_of_records_act_,_1917	afBaleKa_nASakaraNa_aXiniyama,_1917#afBaleKa_nASakaraNa_aXiniyama,_1917#noun#6#RM
dfhi_discount_and_finance_house_of_india_ltd.	BArawIya_miwIkAtA_Ora_viwwa_gqha_li-#BArawIya_miwIkAtA_Ora_viwwa_gqha_li-#noun#8#RM
dgci_directorate_general_of_commercial_intelligence_and_statistics	vANifjyaka_AsUcanA_Ora_aMka_saMkalana_mahAnixeSAlaya#vANifjyaka_AsUcanA_Ora_aMka_saMkalana_mahAnixeSAlaya#noun#8#RM
dgs_directorate_general_of_shipping	jahAjZarAnI_mahAnixeSAlaya#jahAjZarAnI_mahAnixeSAlaya#noun#5#RM
dgs_directorate_general_of_supplies_disposal	pUrwi_waWA_nipatAna_mahAnixeSAlaya#pUrwi_waWA_nipatAna_mahAnixeSAlaya#noun#6#RM
dgtd_directorate_general_of_technical_development	wakanIkI_vikAsa_mahAnixeSAlaya#wakanIkI_vikAsa_mahAnixeSAlaya#noun#6#RM
dic_district_industrial_centre	jilA_Oxyogika_kenxra#jilA_Oxyogika_kenxra#noun#4#RM
dicgc_deposit_insurance_credit_guarantee_corporation	nikRepa_bImA_Ora_prawyaya_gAraMtI_nigama#nikRepa_bImA_Ora_prawyaya_gAraMtI_nigama#noun#6#RM
displaced_persons_(_debts_adjustment_)_act_,_1951	visWApiwa_vyakwi_(qNa_samAyojana)_aXiniyama,_1951#visWApiwa_vyakwi_(qNa_samAyojana)_aXiniyama,_1951#noun#9#RM
dlf_development_loan_fund	vikAsa_qNa_niXi#vikAsa_qNa_niXi#noun#4#RM
documents_against_payment	BugawAna/axAyagI_para_praleKa#BugawAna/axAyagI_para_praleKa#noun#3#RM
documents_on_acceptance	sakArane/svIkqwi_para_praxeya_praleKa#sakArane/svIkqwi_para_praxeya_praleKa#noun#3#RM
dowry_prohibition_act_,_1961	xaheja_prawiReXa_aXiniyama,_1961#xaheja_prawiReXa_aXiniyama,_1961#noun#5#RM
dpap_drought_prone_area_programme	sUKA_pravaNa_kRewra_kAryakrama#sUKA_pravaNa_kRewra_kAryakrama#noun#5#RM
dpn_demand_promissory_note	mAMga_vacana_pawra#mAMga_vacana_pawra#noun#4#RM
dr_discharge_required	haswAkRara_apekRiwa_(BugawAna_hewu)#haswAkRara_apekRiwa_(BugawAna_hewu)#noun#3#RM
drawing_power	AharaNa_Sakwi/aXikAra#AharaNa_Sakwi/aXikAra#noun#2#RM
drda_district_rural_development_agencies	jafZlA_grAmINa_vikAsa_ejeMsI#jafZlA_grAmINa_vikAsa_ejeMsI#noun#5#RM
dris_differential_rate_of_interest_scheme	viBexaka_bjAya_xara_yojanA#viBexaka_bjAya_xara_yojanA#noun#6#RM
dtl_demand_and_time_liabilities	mAga_Ora_mIyAxI_xeyawAe#mAga_Ora_mIyAxI_xeyawAe#noun#5#RM
ebcs_export_bills_credit_scheme	niryAwa_bila_qNa_yojanA#niryAwa_bila_qNa_yojanA#noun#5#RM
ecafe_economic_commission_for_area_and_the_far_east	eSiyA_Ora_suxUra_pUrva_xeSoM_kA_ArWika_Ayoga#eSiyA_Ora_suxUra_pUrva_xeSoM_kA_ArWika_Ayoga#noun#9#RM
ecgc_export_credit_gurarantee_corporation_of_india_ltd	BArawIya_niryAwa_qNa_gAraMtI_nigama_li--#BArawIya_niryAwa_qNa_gAraMtI_nigama_li--#noun#8#RM
ecm_european_common_market	yUropIya_sAJA_bAjZAra#yUropIya_sAJA_bAjZAra#noun#4#RM
economic_offences_(_inapplicability_of_limitation_)_act_,_1974	ArWika_aparAXa_(parisImA_kA_lAgU_honA)_aXiniyama,_1974#ArWika_aparAXa_(parisImA_kA_lAgU_honA)_aXiniyama,_1974#noun#10#RM
ecu_european_currency_unit	yUropIya_muxrA_ikAI#yUropIya_muxrA_ikAI#noun#4#RM
eec_european_economic_community	yUropIya_ArWika_samuxAya#yUropIya_ArWika_samuxAya#noun#4#RM
eepc_engineering_export_promotion_council	iMjIniyarI_niryAwa_saMvarXana_pariRaxa#iMjIniyarI_niryAwa_saMvarXana_pariRaxa#noun#5#RM
eff_extended_fund_facility	praxawwa_niXi_suviXA#praxawwa_niXi_suviXA#noun#4#RM
efta_european_free_trade_association	yUropIya_mukZwa_vyApAra_saMGa#yUropIya_mukZwa_vyApAra_saMGa#noun#5#RM
ema_european_monetary_agreement	yUropIya_muxrA_karAra#yUropIya_muxrA_karAra#noun#4#RM
emblems_and_names_(_prevention_of_improper_use_)_act_,_1950	saMprawIka_Ora_nAma_kA_(anuciwa_prayoga_nivAraNa)_aXiniyama,_1950#saMprawIka_Ora_nAma_kA_(anuciwa_prayoga_nivAraNa)_aXiniyama,_1950#noun#12#RM
emergency_risks_(_goods_)_insurance_act_,_1971	ApAwa_saMkata_(mAla)_bImA_aXiniyama,_1971#ApAwa_saMkata_(mAla)_bImA_aXiniyama,_1971#noun#9#RM
emergency_risks_(_undertakings_)_insurance_act_,_1971	ApAwa_saMkata_(upakrama)_bImA_aXiniyama,_1971#ApAwa_saMkata_(upakrama)_bImA_aXiniyama,_1971#noun#9#RM
emf_export_marketing_fund_programme_of_exim_bank	ekjafZma_bEMka_kA_niryAwa_vipaNana_niXi_kAryakrama#ekjafZma_bEMka_kA_niryAwa_vipaNana_niXi_kAryakrama#noun#8#RM
emigration_act_,_1922	uwpravAsa_aXiniyama,_1922#uwpravAsa_aXiniyama,_1922#noun#4#RM
employees_'_liability_act_,_1938	niyojaka_xAyiwva_aXiniyama,_1938#niyojaka_xAyiwva_aXiniyama,_1938#noun#6#RM
employees_'_provident_funds_and_miscellaneous_provisions_act_,_1952	karmacArI_BaviRya-niXi_Ora_prakIrNa_upabaMXa_aXiniyama,_1952#karmacArI_BaviRya-niXi_Ora_prakIrNa_upabaMXa_aXiniyama,_1952#noun#10#RM
employment_of_children_act_,_1938	bAlaka_niyojana_aXiniyama,_1938#bAlaka_niyojana_aXiniyama,_1938#noun#6#RM
ems_european_monetary_system	yUropIya_mOfxraka_praNAlI#yUropIya_mOfxraka_praNAlI#noun#4#RM
epc_export_promotion_council	niryAwa_saMvarXana_pariRaxa#niryAwa_saMvarXana_pariRaxa#noun#4#RM
errors_and_ommissions_excepted	BUla-cUka_lenI-xenI#BUla-cUka_lenI-xenI#noun#4#RM
escap_economic_and_social_commission_for_asia_and_pacific	eSiyA_Ora_praSAMwa_kRewra_kA_ArWika_Ora_sAmAjika_Ayoga#eSiyA_Ora_praSAMwa_kRewra_kA_ArWika_Ora_sAmAjika_Ayoga#noun#9#RM
esic_employees_state_insurance_corporation	karmacArI_rAjya_bImA_nigama#karmacArI_rAjya_bImA_nigama#noun#5#RM
estate_duty_act_,_1953	sampaxA_Sulka_aXiniyama,_1953#sampaxA_Sulka_aXiniyama,_1953#noun#5#RM
ex_dividend	lABAMSa_rahiwa#lABAMSa_rahiwa#noun#2#RM
exim_export_-import_bank_of_india_bank	BArawIya_AyAwa-niryAwa_bEMka#BArawIya_AyAwa-niryAwa_bEMka#noun#7#RM
fao_food_and_agricultural_organisation	KAxya_Ora_kqRi_saMgaTana#KAxya_Ora_kqRi_saMgaTana#noun#5#RM
fas_free_alongside_ship	jahAja_waka_ni:Sulka/powa_paryaMwa_ni:Sulka#jahAja_waka_ni:Sulka/powa_paryaMwa_ni:Sulka#noun#4#RM
fbc_foreign_bills_for_collection	vasUlI_ke_lie_prApwa_vixeSI_bila#vasUlI_ke_lie_prApwa_vixeSI_bila#noun#5#RM
fbd_foreign_bills_discounted	BunAye_gaye_vixeSI_bila#BunAye_gaye_vixeSI_bila#noun#4#RM
fbn_foreign_bills_negotiated	parakrAmiwa_vixeSI_bila#parakrAmiwa_vixeSI_bila#noun#4#RM
fbp_foreign_bills_purchased	KarIxe_gaye_vixeSI_bila#KarIxe_gaye_vixeSI_bila#noun#4#RM
fca_foreign_currency_assets	vixeSI_muxrA_AswiyA#vixeSI_muxrA_AswiyA#noun#4#RM
fci_food_corporation_of_india	BArawIya_KAxya_nigama#BArawIya_KAxya_nigama#noun#5#RM
fcnr_foreign_currency_non-resident_account	vixeSI_muxrA_anivAsI_KAwA#vixeSI_muxrA_anivAsI_KAwA#noun#5#RM
fdr_fixed_deposit_receipt	sAvaXi_jamA_rasIxa#sAvaXi_jamA_rasIxa#noun#4#RM
feaed_foreign_exchange_act_enforcement_directorate	vixeSI_muxrA_aXiniyama_pravarwana_nixeSAlaya#vixeSI_muxrA_aXiniyama_pravarwana_nixeSAlaya#noun#6#RM
fedai_foreign_exchange_dealers_association_of_india	BArawIya_vixeSI_muxrA_vyApArI_saMGa#BArawIya_vixeSI_muxrA_vyApArI_saMGa#noun#7#RM
fera_foreign_exchange_regulations_act	vixeSI_muxrA_viniyamana_aXiniyama#vixeSI_muxrA_viniyamana_aXiniyama#noun#5#RM
fieo_federation_of_indian_export_organisation	BArawIya_niryAwa_saMgaTana_mahAsaMGa#BArawIya_niryAwa_saMgaTana_mahAsaMGa#noun#6#RM
finance_commission_(_miscellaneous_provisions_)_act_,_1951	viwwa_Ayoga_(prakIrNa_upabanXa)_aXiniyama,_1951#viwwa_Ayoga_(prakIrNa_upabanXa)_aXiniyama,_1951#noun#9#RM
firc_foreign_inward_remittance_certificate	vixeSI_Avaka_preRaNa_pramANapawra#vixeSI_Avaka_preRaNa_pramANapawra#noun#5#RM
fob_free_on_board	jahAja_para_ni:Sulka#jahAja_para_ni:Sulka#noun#4#RM
for_free_on_rail	rela_waka/paryaMwa_ni:Sulka#rela_waka/paryaMwa_ni:Sulka#noun#4#RM
foreign_exchange_regulation_act_,_1973	vixeSI_muxrA_viniyamana_aXiniyama,_1973#vixeSI_muxrA_viniyamana_aXiniyama,_1973#noun#6#RM
forfeited_deposits_act_,_1850	samapahqwa_nikRepa_aXiniyama,_1850#samapahqwa_nikRepa_aXiniyama,_1850#noun#5#RM
foward_contracts_(_regulation_)_act_,_1952	agi_rama_saMvixA_(viniyamana)_aXiniyama,_1952#agi_rama_saMvixA_(viniyamana)_aXiniyama,_1952#noun#8#RM
fp_cost_freight_price	lAgawa_Ora_BAdZA_mUlya#lAgawa_Ora_BAdZA_mUlya#noun#4#RM
frns_floating_rate_notes	asWira_xara_vAle_nota#asWira_xara_vAle_nota#noun#4#RM
fss_farmers_service_societies	kqRaka_sevA_samiwiyA#kqRaka_sevA_samiwiyA#noun#4#RM
fts_foreign_travel_scheme	vixeSa_yAwrA_yojanA#vixeSa_yAwrA_yojanA#noun#4#RM
ftt_foreign_travel_tax	vixeSa_yAwrA_kara#vixeSa_yAwrA_kara#noun#4#RM
ftz_free_trade_zone	mukZwa_vyApAra_kRewra#mukZwa_vyApAra_kRewra#noun#4#RM
fwp_food_for_work_programme	kAma_ke_baxale_AnAja_kAryakrama#kAma_ke_baxale_AnAja_kAryakrama#noun#5#RM
gatt_general_agreement_of_tariffs_and_trade	tEriPa_Ora_vyApAra_saMbaMXI_sAmAnya_karAra#tEriPa_Ora_vyApAra_saMbaMXI_sAmAnya_karAra#noun#7#RM
gcal_general_currency_area_licences	sAmAnya_muxrA_kRewra_lAiseMsa#sAmAnya_muxrA_kRewra_lAiseMsa#noun#5#RM
gdr_german_democratic_republic	jarmana_janavAxI_gaNarAjya#jarmana_janavAxI_gaNarAjya#noun#4#RM
general_insurance_business_(_nationalisation_)_act_,_1972	sAXAraNa_bImA_kArabAra_(rARtrIyakaraNa)_aXiniyama,_1972#sAXAraNa_bImA_kArabAra_(rARtrIyakaraNa)_aXiniyama,_1972#noun#9#RM
gic_general_insurance_corporation	sAXAraNa_bImA_nigama#sAXAraNa_bImA_nigama#noun#4#RM
gift-tax_act_,_1958	xAna-kara_aXiniyama,_1958#xAna-kara_aXiniyama,_1958#noun#4#RM
gnp_gross_national_product	sakala_rARtrIya_uwpAxa#sakala_rARtrIya_uwpAxa#noun#4#RM
gold_(_control_)_act_,_1968	svarNa_(niyaMwraNa)_aXiniyama,_1968#svarNa_(niyaMwraNa)_aXiniyama,_1968#noun#7#RM
government_savings_bank_act_,_1873	sarakArI_bacawa_bEMka_aXiniyama,_1873#sarakArI_bacawa_bEMka_aXiniyama,_1873#noun#6#RM
government_seal_act_,_1862	sarakArI_muxrA_aXiniyama,_1862#sarakArI_muxrA_aXiniyama,_1862#noun#5#RM
gpn_government_promissory_note	sarakArI_vacanapawra#sarakArI_vacanapawra#noun#4#RM
guardians_and_wards_act_,_1890	saMrakRaka_Ora_prawipAlya_aXiniyama,_1890#saMrakRaka_Ora_prawipAlya_aXiniyama,_1890#noun#6#RM
hadp_intensive_agriculture_district_programme	samAXAna_KewI_kA_jilA_kAryakrama#samAXAna_KewI_kA_jilA_kAryakrama#noun#5#RM
hdfc_housing_development_finance_corporation	AvAsa_vikAsa_viwwa_nigama#AvAsa_vikAsa_viwwa_nigama#noun#5#RM
head_office	praXAna_kAryAlaya#praXAna_kAryAlaya#noun#2#RM
hhec_handicrafts_handlooms_export_corporation_of_india_ltd.	BArawIya_haswaSilpa_Ora_haWakaraGA_niryAwa_nigama_li-#BArawIya_haswaSilpa_Ora_haWakaraGA_niryAwa_nigama_li-#noun#8#RM
high_denomination_bank_notes_(_demonstisation_)_act_,_1978	ucca_mUlya_bEMka_nota_(vimuxrIkaraNa)_aXiniyama,_1978#ucca_mUlya_bEMka_nota_(vimuxrIkaraNa)_aXiniyama,_1978#noun#10#RM
hindu_adoptions_and_maintenance_act_,_1956	hinxU_xawwaka_Ora_BaraNa-poRaNa_aXiniyama,_1956#hinxU_xawwaka_Ora_BaraNa-poRaNa_aXiniyama,_1956#noun#7#RM
hindu_disposition_of_property_act_,_1916	hinxU_sampafwwa_vyayana_aXiniyama,_1916#hinxU_sampafwwa_vyayana_aXiniyama,_1916#noun#7#RM
hindu_inheritance_(_removal_of_disabilities_)_act_,_1928	hinxU_virAsawa_(niyoZgyawA_nirAkaraNa)_aXiniyama,_1928#hinxU_virAsawa_(niyoZgyawA_nirAkaraNa)_aXiniyama,_1928#noun#10#RM
hindu_marriage_act_,_1955	hinxU_vivAha_aXiniyama,_1955#hinxU_vivAha_aXiniyama,_1955#noun#5#RM
hindu_minority_and_guardianship_act_,_1956	hinxU_aprApwavayawA_Ora_saMrakRakawA_aXiniyama,_1956#hinxU_aprApwavayawA_Ora_saMrakRakawA_aXiniyama,_1956#noun#7#RM
hindu_succession_act_,_1956	hinxU_uwwarAXikAra_aXiniyama,_1956#hinxU_uwwarAXikAra_aXiniyama,_1956#noun#5#RM
hire-purchase_act_,_1972	avakraya_aXiniyama,_1972#avakraya_aXiniyama,_1972#noun#4#RM
hpc_high_power_committee	ucca_aXikAra_prApwa_samiwi#ucca_aXikAra_prApwa_samiwi#noun#4#RM
hra_house_rent_allowance	makAna_kirAyA_BawwA#makAna_kirAyA_BawwA#noun#4#RM
huf_hindu_undivided_family	hinxU_aviBakZwa_parivAra#hinxU_aviBakZwa_parivAra#noun#4#RM
hyvp_high_yield_varieties_programme	aXika_upajavAlI_kismoM_kA_kAryakrama#aXika_upajavAlI_kismoM_kA_kAryakrama#noun#5#RM
iaas_indian_accounts_and_audit_service	BArawIya_leKA_Ora_leKA-parIkRA_sevA#BArawIya_leKA_Ora_leKA-parIkRA_sevA#noun#6#RM
iari_indian_agricultural_research_instt.	BArawIya_kqRi_anusaMXAna_saMsWAna#BArawIya_kqRi_anusaMXAna_saMsWAna#noun#5#RM
iata_international_air_transport_association	anwarAZRtrIya_havAI_parivahana_saMGa#anwarAZRtrIya_havAI_parivahana_saMGa#noun#5#RM
iba_indian_banks_association	BArawIya_bEMka_saMGa#BArawIya_bEMka_saMGa#noun#4#RM
ibc_inward_bills_for_collection	vasUlI_ke_lie_Avaka_bila#vasUlI_ke_lie_Avaka_bila#noun#5#RM
ibec_interantional_bank_for_economic_co-operation	aMwarAZRtrIya_ArWika_sahayoga_bEMka#aMwarAZRtrIya_ArWika_sahayoga_bEMka#noun#6#RM
ibps_institute_of_banking_personnel_selection	bEMkiMga_kArmika_cayana_saMsWAna#bEMkiMga_kArmika_cayana_saMsWAna#noun#6#RM
ibr_inward_bills_receivable	prApya_Avaka_bila#prApya_Avaka_bila#noun#4#RM
ibrd_international_bank_for_reconstruction_and_development	aMwarAZRtrIya_punaniZrmANa_Ora_vikAsa_bEMka#aMwarAZRtrIya_punaniZrmANa_Ora_vikAsa_bEMka#noun#7#RM
icar_indian_council_of_agricultural_research	BArawIya_kqRi_anusaMXAna_pariRaxa#BArawIya_kqRi_anusaMXAna_pariRaxa#noun#6#RM
icc_international_credit_card	aMwarAZRtrIya_kredita_kArda#aMwarAZRtrIya_kredita_kArda#noun#4#RM
icdp_intensive_cotton_district_programme	saGana_kapAsa_jilA_kAryakrama#saGana_kapAsa_jilA_kAryakrama#noun#5#RM
icici_industrial_credit_and_investment_corporation_of_india_ltd.	BArawIya_Oxyogika_qNa_Ora_niveSa_nigama_li-#BArawIya_Oxyogika_qNa_Ora_niveSa_nigama_li-#noun#9#RM
ida_international_development_association	aMwarAZRtrIya_vikAsa_saMGa#aMwarAZRtrIya_vikAsa_saMGa#noun#4#RM
idbi_industrial_development_bank_of_india	BArawIya_Oxyogika_vikAsa_bEMka#BArawIya_Oxyogika_vikAsa_bEMka#noun#6#RM
ifad_international_fund_for_agricultural_development	aMwarAZRtrIya_kqRi_vikAsa_niXi#aMwarAZRtrIya_kqRi_vikAsa_niXi#noun#6#RM
ifc_international_finance_corporation	aMwarAZRtrIya_viwwa_nigama#aMwarAZRtrIya_viwwa_nigama#noun#4#RM
ifci_industrial_finance_corporation_of_india	BArawIya_Oxyogika_viwwa_nigama#BArawIya_Oxyogika_viwwa_nigama#noun#6#RM
iffco_indian_farmers_fertilisers_corporation	BArawIya_kqRaka_urvaraka_nigama#BArawIya_kqRaka_urvaraka_nigama#noun#5#RM
ihdc_indian_handicrafts_development_corporation	BArawIya_haswaSilpa_vikAsa_nigama#BArawIya_haswaSilpa_vikAsa_nigama#noun#5#RM
iib_indian_institute_of_bankers	BArawIya_bEMkara_saMsWAna#BArawIya_bEMkara_saMsWAna#noun#5#RM
ijdp_intensive_jute_development_programme	gahana_jUta_vikAsa_kAryakrama#gahana_jUta_vikAsa_kAryakrama#noun#5#RM
ilo_international_labour_organization	aMwarAZRtrIya_Srama_saMgaTana#aMwarAZRtrIya_Srama_saMgaTana#noun#4#RM
imf_international_marketing_federation	aMwarAZRtrIya_vipaNana_mahAsaMGa#aMwarAZRtrIya_vipaNana_mahAsaMGa#noun#4#RM
imf_international_monetary_fund	aMwarAZRtrIya_muxrA_koRa#aMwarAZRtrIya_muxrA_koRa#noun#4#RM
imports_and_exports_(_control_)_act_,_1947	AyAwa_Ora_niryAwa_(niyaMwraNa)_aXiniyama,_1947#AyAwa_Ora_niryAwa_(niyaMwraNa)_aXiniyama,_1947#noun#9#RM
income-tax_act_,_1961	Aya-kara_aXiniyama,_1961#Aya-kara_aXiniyama,_1961#noun#4#RM
indian_bills_of_lading_act_,_1856	BArawIya_vahana-pawra_aXiniyama,_1856#BArawIya_vahana-pawra_aXiniyama,_1856#noun#7#RM
indian_carriage_of_goods_by_sea_act_,_1925	BArawIya_samuxra_xvArA_mAla_vahana_aXiniyama,_1925#BArawIya_samuxra_xvArA_mAla_vahana_aXiniyama,_1925#noun#9#RM
indian_companies_(_amendment_)_act_,_1930	BArawIya_kampanI_(saMSoXana)_aXiniyama,_1930#BArawIya_kampanI_(saMSoXana)_aXiniyama,_1930#noun#8#RM
indian_companies_(_foreign_interests_)_act_,_1918	BArawIya_kampanI_(vixeSI_hiwa)_aXiniyama,_1918#BArawIya_kampanI_(vixeSI_hiwa)_aXiniyama,_1918#noun#9#RM
indian_contract_act_,_1872	BArawIya_saMvixA_aXiniyama,_1872#BArawIya_saMvixA_aXiniyama,_1872#noun#5#RM
indian_evidence_act_,_1872	BArawIya_sAkRya_aXiniyama,_1872#BArawIya_sAkRya_aXiniyama,_1872#noun#5#RM
indian_lunacy_act_,_1912	BArawIya_pAgalapana_aXiniyama,_1912#BArawIya_pAgalapana_aXiniyama,_1912#noun#5#RM
indian_majority_act_,_1875	BArawIya_vayaskawA_aXiniyama,_1875#BArawIya_vayaskawA_aXiniyama,_1875#noun#5#RM
indian_partnership_act_,_1932	BArawIya_BAgIxArI_aXiniyama,_1932#BArawIya_BAgIxArI_aXiniyama,_1932#noun#5#RM
indian_patents_and_designs_act_,_1911	BArawIya_peteMta_Ora_dijAina_aXiniyama,_1911#BArawIya_peteMta_Ora_dijAina_aXiniyama,_1911#noun#7#RM
indian_penal_code_,_1860	BArawIya_xaMda_saMhiwA,_1860#BArawIya_xaMda_saMhiwA,_1860#noun#5#RM
indian_reserve_forces_act_,_1888	BArawIya_rijZarva_bala_aXiniyama,_1888#BArawIya_rijZarva_bala_aXiniyama,_1888#noun#6#RM
indian_securities_act_,_1920	BArawIya_prawiBUwi_aXiniyama,_1920#BArawIya_prawiBUwi_aXiniyama,_1920#noun#5#RM
indian_stamp_act_,_1899	BArawIya_stAmpa_aXiniyama,_1899#BArawIya_stAmpa_aXiniyama,_1899#noun#5#RM
indian_standards_institutions_(_certification_marks_)_act_,_1952	BArawIya_mAnaka_saMsWA_(pramANana_cinha)_aXiniyama,_1952#BArawIya_mAnaka_saMsWA_(pramANana_cinha)_aXiniyama,_1952#noun#10#RM
indian_statistical_institute_act_,_1959	BArawIya_sAMfKyakIya_saMsWAna_aXiniyama,_1959#BArawIya_sAMfKyakIya_saMsWAna_aXiniyama,_1959#noun#6#RM
indian_succession_act_,_1925	BArawIya_uwwarAXikAra_aXiniyama,_1925#BArawIya_uwwarAXikAra_aXiniyama,_1925#noun#5#RM
indian_trusts_act_,_1882	BArawIya_nyAsa_aXiniyama,_1882#BArawIya_nyAsa_aXiniyama,_1882#noun#5#RM
industrial_development_bank_of_india_act_,_1964_act_,_1952	BArawIya_Oxyogika_vikAsa_bEMka_aXiniyama,_1964#BArawIya_Oxyogika_vikAsa_bEMka_aXiniyama,_1964#noun#11#RM
industrial_dispute_act_,_1947	Oxyogika_vivAxa_aXiniyama,_1947#Oxyogika_vivAxa_aXiniyama,_1947#noun#5#RM
industrial_disputes_(_banking_and_insurance_companies_)_act_,_1949	Oxyogika_vivAxa_(bEMkakArI_waWA_bImA_kampaniyAM)_aXiniyama,_1949#Oxyogika_vivAxa_(bEMkakArI_waWA_bImA_kampaniyAM)_aXiniyama,_1949#noun#11#RM
industrial_disputes_(_banking_companies_)_decision_act_,_1955	Oxyogika_vivAxa_(bEMkakArI_kampanI)_viniScaya_aXiniyama,_1955#Oxyogika_vivAxa_(bEMkakArI_kampanI)_viniScaya_aXiniyama,_1955#noun#10#RM
industrial_employment_(_standing_orders_)_act_,_1946	Oxyogika_niyojana_(sWAyI_AxeSa)_aXiniyama,_1946#Oxyogika_niyojana_(sWAyI_AxeSa)_aXiniyama,_1946#noun#9#RM
industrial_finance_corporation_act_,_1948	Oxyogika_viwwa_nigama_aXiniyama,_1948#Oxyogika_viwwa_nigama_aXiniyama,_1948#noun#6#RM
insurance_act_,_1938	bImA_aXiniyama,_1938#bImA_aXiniyama,_1938#noun#4#RM
interest_act_,_1978	byAja_aXiniyama,_1978#byAja_aXiniyama,_1978#noun#4#RM
interest_tax_act_,_1974	byAja-kara_aXiniyama,_1974#byAja-kara_aXiniyama,_1974#noun#5#RM
international_finance_corporation_(_status_,_immunities_and_privileges_)_act_,_1958	anwarARtrIya_viwwa_nigama_(prafsWfAwa/unmukwi_wawA_viSeRAXikAra)_aXiniyama,_1958#anwarARtrIya_viwwa_nigama_(prafsWfAwa/unmukwi_wawA_viSeRAXikAra)_aXiniyama,_1958#noun#13#RM
international_monetary_fund_and_bank_act_,_1945	anwarARtrIya_muxrA_niXi_Ora_bEMka_aXiniyama,_1945#anwarARtrIya_muxrA_niXi_Ora_bEMka_aXiniyama,_1945#noun#8#RM
irbi_industrial_reconstruction_bank_of_india	BArawIya_Oxyogika_punaniZrmANa_bEMka#BArawIya_Oxyogika_punaniZrmANa_bEMka#noun#6#RM
irci_industrial_reconstruction_corporation_of_india_ltd.	BArawIya_Oxyogika_punaniZrmANa_nigama_li-#BArawIya_Oxyogika_punaniZrmANa_nigama_li-#noun#7#RM
irdp_integrated_rural_development_programme	samafnvawa_grAmINa_vikAsa_kAryakrama#samafnvawa_grAmINa_vikAsa_kAryakrama#noun#5#RM
irl_import_replenishment_licence	AyAwa_puna:pUrwi_lAiseMsa#AyAwa_puna:pUrwi_lAiseMsa#noun#4#RM
irmac_industrial_raw_material_assitance_centre	Oxyogika_kaccA_mAla_sahAyawA_kenxra#Oxyogika_kaccA_mAla_sahAyawA_kenxra#noun#6#RM
itc_import_trade_control	AyAwa_vyApAra_niyaMwraNa#AyAwa_vyApAra_niyaMwraNa#noun#4#RM
itdc_india_tourim_development_corporation	BArawa_paryatana_vikAsa_nigama#BArawa_paryatana_vikAsa_nigama#noun#5#RM
itdp_integrated_tribal_development_project	samafnvawa_janajAwi_vikAsa_pariyojanA#samafnvawa_janajAwi_vikAsa_pariyojanA#noun#5#RM
iti_industrial_training_institute	Oxyogika_praSikRaNa_kenxra#Oxyogika_praSikRaNa_kenxra#noun#4#RM
ivp_indira_vikas_patra	iMxirA_vikAsa_pawra#iMxirA_vikAsa_pawra#noun#4#RM
jci_jute_corporation_of_india	BArawIya_jUta_nigama#BArawIya_jUta_nigama#noun#5#RM
jetro_japan_external_trade_organisation	jApAnI_vixeSa_vyApAra_saMgaTana#jApAnI_vixeSa_vyApAra_saMgaTana#noun#5#RM
joint_account	saMyukZwa_KAwA#saMyukZwa_KAwA#noun#2#RM
kaftz_kandla_free_trade_zone	kAMdalA_mukZwa_vyApAra_kRewra#kAMdalA_mukZwa_vyApAra_kRewra#noun#5#RM
kvic_khadi_and_village_industries_commission	KAxI_waWA_grAmoxyoga_Ayoga#KAxI_waWA_grAmoxyoga_Ayoga#noun#6#RM
lamps_large-sized_multipurpose_society	bZadZe_AkAravAlI_bahu-ueSyIya_samiwi#bZadZe_AkAravAlI_bahu-ueSyIya_samiwi#noun#4#RM
land_acquisition_(_amendment_and_validation_)_act_,_1967	BUmi_arjana_(saMSoXana_waWA_viXimAnyakaraNa)_aXiniyama,_1967#BUmi_arjana_(saMSoXana_waWA_viXimAnyakaraNa)_aXiniyama,_1967#noun#10#RM
land_acquisition_act_,_1894	BUmi_arjana_aXiniyama,_1894#BUmi_arjana_aXiniyama,_1894#noun#5#RM
land_improvement_loans_act_,_1883	BUmi_vikAsa_uXAra_aXiniyama,_1883#BUmi_vikAsa_uXAra_aXiniyama,_1883#noun#6#RM
lbs_lead_bank_scheme	agraNI_bEMka_yojanA#agraNI_bEMka_yojanA#noun#4#RM
ldb_land_development_bank	BUmi_vikAsa_bEMka#BUmi_vikAsa_bEMka#noun#4#RM
legal_tender_(_inscribed_notes_)_act_,_1964	vEXa_nivixA_(anwarliKiwa_nota)_aXiniyama,_1964#vEXa_nivixA_(anwarliKiwa_nota)_aXiniyama,_1964#noun#9#RM
letter_of_credit	sAKa-pawra#sAKa-pawra#noun#3#RM
lf_licence_fee	lAiseMsa_Sulka#lAiseMsa_Sulka#noun#3#RM
libor_london_inter-bank_offered_rate	lanxana_aMwarbEMka_praswuwa_xara#lanxana_aMwarbEMka_praswuwa_xara#noun#5#RM
lic_life_insurance_corporation_of_india	BArawIya_jIvana_bImA_nigama#BArawIya_jIvana_bImA_nigama#noun#6#RM
life_insurance_corporation_act_,_1956	jIvana_bImA_nigama_aXiniyama,_1956#jIvana_bImA_nigama_aXiniyama,_1956#noun#6#RM
limitation_(_amendment_)_act_,_1969	parisImA_(saMSoXana)_aXiniyama,_1969#parisImA_(saMSoXana)_aXiniyama,_1969#noun#7#RM
limitation_act_,_1963	parisImA_aXiniyama,_1963#parisImA_aXiniyama,_1963#noun#4#RM
lmb_land_mortgage_bank	BUmi_banXaka_bEMka#BUmi_banXaka_bEMka#noun#4#RM
local_authorities_loans_act_,_1914	sWAnIya_prAXikaraNa_uXAra_aXiniyama,_1914#sWAnIya_prAXikaraNa_uXAra_aXiniyama,_1914#noun#6#RM
maintenance_of_internal_security_act_,_1971	Anwarika_surakRA_aXiniyama,_1971#Anwarika_surakRA_aXiniyama,_1971#noun#7#RM
marine_insurance_act_,_1963	samuxrI_bImA_aXiniyama,_1963#samuxrI_bImA_aXiniyama,_1963#noun#5#RM
marriages_validation_act_,_1892	vivAha_viXimAnyakaraNa_aXiniyama,_1892#vivAha_viXimAnyakaraNa_aXiniyama,_1892#noun#5#RM
married_womens_property_act_,_1874	vivAhiwa_mahilA_sampafwwa_aXiniyama,_1874#vivAhiwa_mahilA_sampafwwa_aXiniyama,_1874#noun#6#RM
maternity_benefit_act_,_1961	prasUwi_prasuviXA_aXiniyama,_1961#prasUwi_prasuviXA_aXiniyama,_1961#noun#5#RM
mco_miscellaneous_charges_order	viviXa_praBAra_AxeSa#viviXa_praBAra_AxeSa#noun#4#RM
metal_token_act_,_1889	XAwu_sikkA_aXiniyama,_1889#XAwu_sikkA_aXiniyama,_1889#noun#5#RM
mfala_marginal_farmers_and_agricultural_labourers_agency	sImAnwa_kqRaka_Ora_Kewihara_majaxUra_ejeMsI#sImAnwa_kqRaka_Ora_Kewihara_majaxUra_ejeMsI#noun#7#RM
mfda_marginal_farmers_development_agency	sImAnwa_kqRaka_vikAsa_ejeMsI#sImAnwa_kqRaka_vikAsa_ejeMsI#noun#5#RM
minimum_wages_act_,_1948	nyUnawama_majaxUrI_aXiniyama,_1948#nyUnawama_majaxUrI_aXiniyama,_1948#noun#5#RM
mlr_minimum_lending_rate	nyUnawama_byAja_xara#nyUnawama_byAja_xara#noun#4#RM
mmtc_minerals_metals_trading_corporation_of_india	BArawIya_Kanija_Ora_XAwu_vyApAra_nigama#BArawIya_Kanija_Ora_XAwu_vyApAra_nigama#noun#7#RM
monopolies_and_restrictive_trade_practices_act_,_1969	ekAXikAra_waWA_avaroXaka_vyavahAra_aXiniyama,_1969#ekAXikAra_waWA_avaroXaka_vyavahAra_aXiniyama,_1969#noun#8#RM
motor_vehicles_act_,_1939	motara_yAna_aXiniyama,_1939#motara_yAna_aXiniyama,_1939#noun#5#RM
mrtpc_monopolies_and_restrictive_trade_practices_commission	ekAXikAra_waWA_avaroXaka_vyApArika_vyavahAra_Ayoga#ekAXikAra_waWA_avaroXaka_vyApArika_vyavahAra_Ayoga#noun#7#RM
mt_mail_transfer	dAka_aMwaraNa#dAka_aMwaraNa#noun#3#RM
mtr_motor_transport_receipt	motara_parivahana_rasIxa#motara_parivahana_rasIxa#noun#4#RM
nabard_national_bank_for_agricultural_and_rural_development	rARtrIya_kqRi_Ora_grAmINa_vikAsa_bEMka#rARtrIya_kqRi_Ora_grAmINa_vikAsa_bEMka#noun#8#RM
nacltof_national_agricultural_credit_(_long_term_operations_)_fund	rARtrIya_kqRi_qNa_(xIrGakAlIna_pravarwana)_niXi#rARtrIya_kqRi_qNa_(xIrGakAlIna_pravarwana)_niXi#noun#10#RM
nacsf_national_agricultural_credit_(_stabilisation_)_fund	rARtrIya_kqRi_qNa_(sWirIkaraNa)_niXi#rARtrIya_kqRi_qNa_(sWirIkaraNa)_niXi#noun#8#RM
nafed_national_co-operative_marketing_federation	rARtrIya_sahakArI_vipaNana_mahAsaMGa#rARtrIya_sahakArI_vipaNana_mahAsaMGa#noun#5#RM
national_bank_for_agriculture_and_rural_development_act_,_1981	rARtrIya_kqRi_Ora_grAmINa_vikAsa_bEMka_aXiniyama,_1981#rARtrIya_kqRi_Ora_grAmINa_vikAsa_bEMka_aXiniyama,_1981#noun#10#RM
national_security_act_,_1980	rARtrIya_surakRA_aXiniyama,_1980#rARtrIya_surakRA_aXiniyama,_1980#noun#5#RM
nav_net_asset_value	nivala_Aswi_mUlya#nivala_Aswi_mUlya#noun#4#RM
nca_national_commission_on_agriculture	rARtrIya_kqRi_Ayoga#rARtrIya_kqRi_Ayoga#noun#5#RM
nccf_national_consumer_co-operative_federation_ltd.	neSanala_kaMjyUmara_ko-oYparetiva_PedareSana_li-#neSanala_kaMjyUmara_ko-oYparetiva_PedareSana_li-#noun#6#RM
ncd_non-convertible_debentures	aparivarwanIya_dibeMcara#aparivarwanIya_dibeMcara#noun#3#RM
ncdc_national_co-operation_development_corporation	rARtrIya_sahakArI_vikAsa_nigama#rARtrIya_sahakArI_vikAsa_nigama#noun#5#RM
ndc_national_development_council	rARtrIya_vikAsa_pariRaxa#rARtrIya_vikAsa_pariRaxa#noun#4#RM
nddb_national_dairy_development_board	rARtrIya_derI_vikAsa_borda#rARtrIya_derI_vikAsa_borda#noun#5#RM
ndp_net_domestic_product	SuxXa_xeSI_uwpAxa#SuxXa_xeSI_uwpAxa#noun#4#RM
nef_national_equity_fund	rARtrIya_IfkvatI_niXi#rARtrIya_IfkvatI_niXi#noun#4#RM
negotiable_instruments_act_,_1881	parakrAmya_liKawa_aXiniyama,_1881#parakrAmya_liKawa_aXiniyama,_1881#noun#5#RM
nhb_national_housing_bank	rARtrIya_AvAsa_bEMka#rARtrIya_AvAsa_bEMka#noun#4#RM
nibm_national_institute_of_bank_management	rARtrIya_bEMka_prabaMXa_saMsWAna#rARtrIya_bEMka_prabaMXa_saMsWAna#noun#6#RM
nic_national_industrial_classification	rARtrIya_Oxyogika_vargIkaraNa#rARtrIya_Oxyogika_vargIkaraNa#noun#4#RM
nic_non-industrial_countries	gEra-Oxyogika_xeSa#gEra-Oxyogika_xeSa#noun#3#RM
nicltof_national_industrial_credit_(_long_term_operations_)_fund	rARtrIya_Oxyogika_qNa_(xIrGakAlIna_pravarwana)_niXi#rARtrIya_Oxyogika_qNa_(xIrGakAlIna_pravarwana)_niXi#noun#10#RM
nidc_national_industrial_development_corporation	rARtrIya_Oxyogika_vikAsa_nigama#rARtrIya_Oxyogika_vikAsa_nigama#noun#5#RM
nitie_national_institution_for_training_in_industrial_engineering	rARtrIya_Oxyogika_iMjIniyarI_praSikRaNa_saMsWAna#rARtrIya_Oxyogika_iMjIniyarI_praSikRaNa_saMsWAna#noun#8#RM
nlr_net_liquidity_ratio	SuxXa_calaniXi_anupAwa#SuxXa_calaniXi_anupAwa#noun#4#RM
nmdc_national_mineral_development_corporation	rARtrIya_Kanija_vikAsa_nigama#rARtrIya_Kanija_vikAsa_nigama#noun#5#RM
nnb_net_national_product	SuxXa_rARtrIya_uwpAxa#SuxXa_rARtrIya_uwpAxa#noun#4#RM
noc_no_objection_certificate	anApafwwa_pramANapawra#anApafwwa_pramANapawra#noun#4#RM
not_available_,_not_applicable	anupalabXa/lAgU_nahIM#anupalabXa/lAgU_nahIM#noun#5#RM
nota_bene_,_note_well	tippaNI/nota#tippaNI/nota#noun#5#RM
notaries_act_,_1952	noterI_aXiniyama,_1952#noterI_aXiniyama,_1952#noun#4#RM
nrc_(_ltof_national_rural_credit_(_long_term_operations_)_fund	rARtrIya_grAmINa_qNa_(xIrGakAlIna_pravarwana)_niXi#rARtrIya_grAmINa_qNa_(xIrGakAlIna_pravarwana)_niXi#noun#12#RM
nrc_(_stabf_national_rural_credit_(_stabilisation_)_fund	rARtrIya_grAmINa_qNa_(sWirIkaraNa)_niXi#rARtrIya_grAmINa_qNa_(sWirIkaraNa)_niXi#noun#10#RM
nrdb_national_rural_development_bonds	rARtrIya_grAmINa_vikAsa_bAMda#rARtrIya_grAmINa_vikAsa_bAMda#noun#5#RM
nre/o_non-resident_external/ordinary_account	anivAsI_vixeSI/sAmAnya_KAwA#anivAsI_vixeSI/sAmAnya_KAwA#noun#4#RM
nrep_national_rural_development_programme	rARtrIya_grAmINa_rojZagAra_kAryakrama#rARtrIya_grAmINa_rojZagAra_kAryakrama#noun#5#RM
nreras_non_resident_external_rupee_account_scheme	anivAsI_bAhZaya_rupayA_KAwA_yojanA#anivAsI_bAhZaya_rupayA_KAwA_yojanA#noun#7#RM
nri_non-resident_indians	anivAsI_BArawIya#anivAsI_BArawIya#noun#3#RM
nsic_national_small_industries_corporation	rARtrIya_laGu_uxyoga_nigama#rARtrIya_laGu_uxyoga_nigama#noun#5#RM
nss_national_saving_certificate	rARtrIya_bacawa_pramANapawra#rARtrIya_bacawa_pramANapawra#noun#4#RM
nsso_national_sample_survey_organisation	rARtrIya_pawixarSa_sarvekRaNa_saMgaTana#rARtrIya_pawixarSa_sarvekRaNa_saMgaTana#noun#5#RM
ntc_national_textile_corporation	rARtrIya_vaswra_nigama#rARtrIya_vaswra_nigama#noun#4#RM
nts_neighbourhood_travel_scheme	padZosI_xeSoM_kI_yAwrA_yojanA#padZosI_xeSoM_kI_yAwrA_yojanA#noun#4#RM
oaths_act_,_1969	SapaWa_aXiniyama,_1969#SapaWa_aXiniyama,_1969#noun#4#RM
obc_outward_bills_for_collection	vasUlI_ke_lie_jAvaka_bila#vasUlI_ke_lie_jAvaka_bila#noun#5#RM
oda_official_development_assistance	AXikArika_vikAsa_sahAyawA#AXikArika_vikAsa_sahAyawA#noun#4#RM
oecd_organisation_for_economic_co-operation_and_development	ArWika_sahayoga_Ora_vikAsa_saMgaTana#ArWika_sahayoga_Ora_vikAsa_saMgaTana#noun#7#RM
oedc_oil_exporting_developing_countries	wela_niryAwaka_vikAsaSIla_xeSa#wela_niryAwaka_vikAsaSIla_xeSa#noun#5#RM
official_languages_act_,_1963	rAjaBARA_aXiniyama,_1963#rAjaBARA_aXiniyama,_1963#noun#5#RM
official_secrets_act_,_1923	SAsakIya_gupwa_bAla_aXiniyama,_1923#SAsakIya_gupwa_bAla_aXiniyama,_1923#noun#5#RM
official_trustees_act_,_1913	SAsakIya_nyAsI_aXiniyama,_1913#SAsakIya_nyAsI_aXiniyama,_1913#noun#5#RM
ogl_open_general_licence	KulA_sAmAnya_lAiseMsa#KulA_sAmAnya_lAiseMsa#noun#4#RM
opec_organisation_of_petroleum_exporting_countries	petroliyana_(wela)_niryAwaka_xeSoM_kA_saMgaTana#petroliyana_(wela)_niryAwaka_xeSoM_kA_saMgaTana#noun#6#RM
owners_risk	mAlika_kA_joKima#mAlika_kA_joKima#noun#2#RM
pacs_primary_agricultural_credit_society	prAWamika_kqRi_qNa_samiwi#prAWamika_kqRi_qNa_samiwi#noun#5#RM
payment_of_bonus_act_,_1965	bonasa_saMxAya_aXiniyama,_1965#bonasa_saMxAya_aXiniyama,_1965#noun#6#RM
payment_of_gratuity_act_,_1972	upaxAna_saMxAya_aXiniyama,_1972#upaxAna_saMxAya_aXiniyama,_1972#noun#6#RM
payment_of_wages_act_,_1936	majaxUrI_saMxAya_aXiniyama,_1936#majaxUrI_saMxAya_aXiniyama,_1936#noun#6#RM
pc_participation_certificate	sahaBAgiwA_pramANapawra#sahaBAgiwA_pramANapawra#noun#3#RM
pcb_primary_co-operative_bank	prAWamika_sahakArI_bEMka#prAWamika_sahakArI_bEMka#noun#4#RM
pdo_public_debt_office_(_reserve_bank_of_india_)	loka_qNa_kAryAlaya_(BArawIya_rijZarva_bEMka)#loka_qNa_kAryAlaya_(BArawIya_rijZarva_bEMka)#noun#9#RM
pep_productivity_,_efficiency_and_profitablity	uwpAxakawA/xakRawA_Ora_lABapraxa#uwpAxakawA/xakRawA_Ora_lABapraxa#noun#6#RM
per_annum	prawivarRa/vAfrRaka#prawivarRa/vAfrRaka#noun#2#RM
pldb_primary_land_development_bank	prAWamika_BUmi_vikAsa_bEMka#prAWamika_BUmi_vikAsa_bEMka#noun#5#RM
po_pay_order	axAyagI_AxeSa#axAyagI_AxeSa#noun#3#RM
pol_petroleum_,_oil_and_lubricants	petroliyama/wela_Ora_cikanAI_ke_paxArWa#petroliyama/wela_Ora_cikanAI_ke_paxArWa#noun#6#RM
power_of_attorney	muKwAranAmA#muKwAranAmA#noun#3#RM
powers-of_attorney_act_,_1882	muKwAranAmA_aXiniyama,_1882#muKwAranAmA_aXiniyama,_1882#noun#5#RM
praca_asian_and_pacific_regional_agricultural_credit_association	eSiyAI_Ora_praSAnwa_kRewrIya_kqRi_qNa_saMGa#eSiyAI_Ora_praSAnwa_kRewrIya_kqRi_qNa_saMGa#noun#8#RM
presidency-towns_insolvency_act_,_1909	presIdensI_nagara_xivAlA_aXiniyama,_1909#presIdensI_nagara_xivAlA_aXiniyama,_1909#noun#5#RM
presidency_magistrate_(_court_fees_)_act_,_1877	presideMsI_majistreta_(nyAyAlaya-PIsa)_aXiniyama,_1877#presideMsI_majistreta_(nyAyAlaya-PIsa)_aXiniyama,_1877#noun#9#RM
presidency_small_cause_courts_act_,_1882	presideMsI_laGuvAxa_nyAyAlaya_aXiniyama,_1882#presideMsI_laGuvAxa_nyAyAlaya_aXiniyama,_1882#noun#7#RM
prize_chits_and_money_circulation_schemes_(_banking_)_act_,_1978	inAmI_cita_Ora_Xana_paricAlana_skIma_(pAbanxI)_aXiniyama,_1978#inAmI_cita_Ora_Xana_paricAlana_skIma_(pAbanxI)_aXiniyama,_1978#noun#12#RM
produce_cess_act_,_1966	upaja_upakara_aXiniyama,_1966#upaja_upakara_aXiniyama,_1966#noun#5#RM
promissory_note	vacana-pawra#vacana-pawra#noun#2#RM
promissory_notes_(_stamp_)_act_,_1926	vacanapawra_(stAmpa)_aXiniyama,_1926#vacanapawra_(stAmpa)_aXiniyama,_1926#noun#8#RM
provident_funds_act_,_1925	BaviRya-niXi_aXiniyama,_1925#BaviRya-niXi_aXiniyama,_1925#noun#5#RM
provincial_insolvency_act_,_1920	prAnwIya_xivAlA_aXiniyama,_1920#prAnwIya_xivAlA_aXiniyama,_1920#noun#5#RM
provincial_small_cause_courts_act_,_1887	prAnwIya_laGuvAxa_nyAyAlaya_aXiniyama,_1887#prAnwIya_laGuvAxa_nyAyAlaya_aXiniyama,_1887#noun#7#RM
provisional_collection_of_taxes_act_,_1931	anafnwama_kara_saMgrahaNa_aXiniyama,_1931#anafnwama_kara_saMgrahaNa_aXiniyama,_1931#noun#7#RM
ps_post_scriptum_,_post_script	paScaleKa/PunaSca#paScaleKa/PunaSca#noun#6#RM
pta_pre-paid_ticket_advice	pUrvaxawwa_tikata_sUcanA#pUrvaxawwa_tikata_sUcanA#noun#4#RM
public_debt_act_,_1944	loka_qNa_aXiniyama,_1944#loka_qNa_aXiniyama,_1944#noun#5#RM
public_gambling_act_,_1867	sArvajanika_CUwa_aXiniyama,_1867#sArvajanika_CUwa_aXiniyama,_1867#noun#5#RM
public_provident_fund_act_,_1968	loka_BaviRya-niXi_aXiniyama,_1968#loka_BaviRya-niXi_aXiniyama,_1968#noun#6#RM
public_servants_(_inquiries_)_act_,_1850	loka_sevaka_(jAMca)_aXiniyama,_1850#loka_sevaka_(jAMca)_aXiniyama,_1850#noun#8#RM
public_suits_validation_act_,_1932	lokahiwavAxa_viXimAnyakaraNa_aXiniyama,_1932#lokahiwavAxa_viXimAnyakaraNa_aXiniyama,_1932#noun#6#RM
pucb_primary_urban_co-operative_bank	prAWamika_SaharI_sahakArI_bEMka#prAWamika_SaharI_sahakArI_bEMka#noun#5#RM
rbi_reserve_bank_of_india	BArawIya_rijZarva_bEMka#BArawIya_rijZarva_bEMka#noun#5#RM
rec_rural_electrification_corporation	grAmINa_vixyuwIkaraNa_nigama#grAmINa_vixyuwIkaraNa_nigama#noun#4#RM
reference_shares_(_regulation_of_dividends_)_act_,_1960	aXimAnI_Seyara_(lABASoM_kA_viniyamana)_aXiniyama,_1960#aXimAnI_Seyara_(lABASoM_kA_viniyamana)_aXiniyama,_1960#noun#10#RM
regional_rural_banks_act_,_1976	prAxeSika_grAmINa_bEMka_aXiniyama,_1976#prAxeSika_grAmINa_bEMka_aXiniyama,_1976#noun#6#RM
registration_act_,_1908	rajistrIkaraNa_aXiniyama,_1908#rajistrIkaraNa_aXiniyama,_1908#noun#4#RM
registration_of_births_and_deaths_act_,_1969	janma_Ora_mqwyu_rajistrIkaraNa_aXiniyama,_1969#janma_Ora_mqwyu_rajistrIkaraNa_aXiniyama,_1969#noun#8#RM
rep_replenishment_licence	puna:pUrwi_lAiseMsa#puna:pUrwi_lAiseMsa#noun#3#RM
reserve_bank_(_transfer_to_public_ownership_)_act_,_1948	rijZarva_bEMka_(loka_svAmiwva_ko_anwaraNa)_aXiniyama,_1948#rijZarva_bEMka_(loka_svAmiwva_ko_anwaraNa)_aXiniyama,_1948#noun#11#RM
reserve_bank_of_india_(_amendment_and_miscellaneous_provisions_)_act_,_1953	BArawIya_rijZarva_bEMka_(saMSoXana_waWA_prakIrNa_upabanXa)_aXiniyama,_1953#BArawIya_rijZarva_bEMka_(saMSoXana_waWA_prakIrNa_upabanXa)_aXiniyama,_1953#noun#13#RM
reserve_bank_of_india_act_1934	BArawIya_rijZarva_bEMka_aXiniyama,_1934#BArawIya_rijZarva_bEMka_aXiniyama,_1934#noun#6#RM
revention_of_corruption_act_,_1947	BraRtAcAra_nivAraNa_aXiniyama,_1947#BraRtAcAra_nivAraNa_aXiniyama,_1947#noun#6#RM
rifees_returning_indians_foreign_exchange_entitlement_scheme	svaxeSa_lOtanevAle_BArawIyoM_kI_vixeSI_muxrA_pAwrawA_yojanA#svaxeSa_lOtanevAle_BArawIyoM_kI_vixeSI_muxrA_pAwrawA_yojanA#noun#7#RM
rpi_retail_price_index	KuxarA_mUlya_sUcakAMka#KuxarA_mUlya_sUcakAMka#noun#4#RM
rrb_regional_rural_bank	kRewrIya_grAmINa_bEMka#kRewrIya_grAmINa_bEMka#noun#4#RM
rrmnp_revised_minimum_need_programme	saMSoXiwa_nyUnawama_AvaSyakawA_kAryakrama#saMSoXiwa_nyUnawama_AvaSyakawA_kAryakrama#noun#5#RM
rsvp_repondez_vous_plait_(_reply_if_you_)	uwwarAkAMkRI#uwwarAkAMkRI#noun#8#RM
rtc_rupee_travellers_cheques	rupayA_yAwrI_ceka#rupayA_yAwrI_ceka#noun#4#RM
safaune_ships_acquired_from_abroad_under_new_scheme	nayI_yojanA_ke_aMwargawa_vixeSoM_se_prApwa_jahAja#nayI_yojanA_ke_aMwargawa_vixeSoM_se_prApwa_jahAja#noun#8#RM
sail_steel_authority_of_india	BArawIya_ispAwa_prAXikaraNa#BArawIya_ispAwa_prAXikaraNa#noun#5#RM
savings_bank_(_account_)	bacawa_bEMka_(KAwA)#bacawa_bEMka_(KAwA)#noun#4#RM
sbi_state_bank_of_india	BArawIya_steta_bEMka#BArawIya_steta_bEMka#noun#5#RM
sc/st_scheduled_caste/scheduled_tribe	anusUciwa_jAwi/anusUciwa_janajAwi#anusUciwa_jAwi/anusUciwa_janajAwi#noun#4#RM
scb_scheduled_commercial_bank	anusUciwa_vANijya_bEMka#anusUciwa_vANijya_bEMka#noun#4#RM
scb_state_co-operative_bank	rAjya_sahakArI_bEMka#rAjya_sahakArI_bEMka#noun#4#RM
scc_selective_credit_control	cayanAwmaka_qNa_niyaMwraNa#cayanAwmaka_qNa_niyaMwraNa#noun#4#RM
scc_standing_coordination_committee	sWAyI_samanvayana_samiwi#sWAyI_samanvayana_samiwi#noun#4#RM
scef_standing_committee_on_export_finance	niryAwa_viwwa_saMbaMXI_sWAyI_samiwi#niryAwa_viwwa_saMbaMXI_sWAyI_samiwi#noun#6#RM
sci_shipping_corporation_of_india	BArawIya_nOvahana_nigama#BArawIya_nOvahana_nigama#noun#5#RM
scr_statutory_cash_reserve	sAMviXika_nakaxI_prArakRiwa_niXi#sAMviXika_nakaxI_prArakRiwa_niXi#noun#4#RM
scs_service_co-operative_society	sevA_sahakArI_samiwi#sevA_sahakArI_samiwi#noun#4#RM
sdr_special_drawing_rights	viSeRa_AharaNa_aXikAra#viSeRa_AharaNa_aXikAra#noun#4#RM
seb_state_electricity_board	rAjya_vixyuwa_borda#rAjya_vixyuwa_borda#noun#4#RM
seepz_santacruz_electronics_export_processing_zone	sAMwAkrUja_ilekroYnika_niryAwa_afBasaMskaraNa_kRewra#sAMwAkrUja_ilekroYnika_niryAwa_afBasaMskaraNa_kRewra#noun#6#RM
sepup_self-employment_programme_for_urban_poor	SaharI_nirXanoM_ke_lie_svarojZagAra_kAryakrama#SaharI_nirXanoM_ke_lie_svarojZagAra_kAryakrama#noun#6#RM
seuy_self-employment_for_educated_unemployed_youth	SikRiwa_borodZagAra_yuvakoM_ke_lie_svarojagAra#SikRiwa_borodZagAra_yuvakoM_ke_lie_svarojagAra#noun#6#RM
sfc_state_financial_corporation	rAjya_viwwIya_nigama#rAjya_viwwIya_nigama#noun#4#RM
sfda_small_farmers_development_agency	laGu_kqRaka_vikAsa_ejeMsI#laGu_kqRaka_vikAsa_ejeMsI#noun#5#RM
sfdc_small_farmers_development_corporation	laGu_kqRaka_vikAsa_nigama#laGu_kqRaka_vikAsa_nigama#noun#5#RM
sff_supplementary_financing_facility	pUraka_viwwapoRaNa_suviXA#pUraka_viwwapoRaNa_suviXA#noun#4#RM
sidc_state_industrial_development_corporation	rAjya_Oxyogika_vikAsa_nigama#rAjya_Oxyogika_vikAsa_nigama#noun#5#RM
sidf_small_industries_development_fund	laGu_uxyoga_vikAsa_niXi#laGu_uxyoga_vikAsa_niXi#noun#5#RM
sido_small_industries_development_organisation	laGu_uxyoga_vikAsa_saMGaTana#laGu_uxyoga_vikAsa_saMGaTana#noun#5#RM
siic_state_industrial_investment_corporation	rAjya_Oxyogika_niveSa_nigama#rAjya_Oxyogika_niveSa_nigama#noun#5#RM
slbc_state_level_banking_committee	rAjyaswarIya_bEMkiMga_samiwi#rAjyaswarIya_bEMkiMga_samiwi#noun#5#RM
sldb_state_land_development_bank	rAjya_BUmi_vikAsa_bEMka#rAjya_BUmi_vikAsa_bEMka#noun#5#RM
slgs_small_loan_guarantee_scheme	laGu_qNa_gAraMtI_yojanA#laGu_qNa_gAraMtI_yojanA#noun#5#RM
sliic_state_level_inter_institutional_committee	rAjyaswarIya_aMwara_saMsWAgawa_samiwi#rAjyaswarIya_aMwara_saMsWAgawa_samiwi#noun#6#RM
slr_statutory_liquidity_ratio	sAMviXika_calaniXi_anupAwa#sAMviXika_calaniXi_anupAwa#noun#4#RM
small_coins_(_offences_)_act_,_1971	Cote_sikke_(aparAXa)_aXiniyama,_1971#Cote_sikke_(aparAXa)_aXiniyama,_1971#noun#8#RM
smfda_small_and_marginal_farmers_development_agency	laGu_Ora_sImAnwa_kqRaka_vikAsa_ejeMsI#laGu_Ora_sImAnwa_kqRaka_vikAsa_ejeMsI#noun#7#RM
societries_registration_act_,_1860	sosAitI_rajistrIkaraNa_aXiniyama,_1860#sosAitI_rajistrIkaraNa_aXiniyama,_1860#noun#5#RM
special_bearer_bonds_(_immunities_and_exemptions_)_act_,_1981	viSeRa_vAhaka_banXapawra_(unmukwi_Ora_CUta)_aXiniyama,_1981#viSeRa_vAhaka_banXapawra_(unmukwi_Ora_CUta)_aXiniyama,_1981#noun#11#RM
special_courts_act_,_1979	viSeRa_nyAyAlaya_aXiniyama,_1979#viSeRa_nyAyAlaya_aXiniyama,_1979#noun#5#RM
special_marriage_act_,_1954	viSeRa_vivAha_aXiniyama,_1954#viSeRa_vivAha_aXiniyama,_1954#noun#5#RM
special_tribunals_(_supplementary_provisions_)_act_,_1946	viSeRa_aXikaraNa_(anupUraka_upabaMXa)_aXiniyama,_1946#viSeRa_aXikaraNa_(anupUraka_upabaMXa)_aXiniyama,_1946#noun#9#RM
srf_statutory_reserve_fund	sAMviXika_prArakRiwa_niXi#sAMviXika_prArakRiwa_niXi#noun#4#RM
ssidc_state_small_industries_development_corporation	rAjya_laGu_uxyoga_vikAsa_nigama#rAjya_laGu_uxyoga_vikAsa_nigama#noun#6#RM
state-associated_banks_(_miscellaneous_provisions_)_act_,_1962	rAjya_sahayukZwa_bEMka_(prakIrNa_upabanXa)_aXiniyama,_1962#rAjya_sahayukZwa_bEMka_(prakIrNa_upabanXa)_aXiniyama,_1962#noun#9#RM
state_agricultural_credit_corporations_act_,_1968	rAjya_kqRi_uXAra_nigama_aXiniyama,_1968#rAjya_kqRi_uXAra_nigama_aXiniyama,_1968#noun#7#RM
state_bank_of_india_(_subsidiary_banks_)_act_,_1959	BArawIya_steta_bEMka_(samanuRaMgI_bEMka)_aXiniyama,_1959#BArawIya_steta_bEMka_(samanuRaMgI_bEMka)_aXiniyama,_1959#noun#11#RM
state_bank_of_india_act_,_1955	BArawIya_steta_bEMka_aXiniyama,_1955#BArawIya_steta_bEMka_aXiniyama,_1955#noun#7#RM
state_financial_corporations_act_,_1951	rAjya_viwwIya_nigama_aXiniyama,_1951#rAjya_viwwIya_nigama_aXiniyama,_1951#noun#6#RM
stc_state_trading_corporation	rAjya_vyApAra_nigama#rAjya_vyApAra_nigama#noun#4#RM
sunfed_special_united_nations_fund_for_economic_development	ArWika_vikAsa_kI_viSeRa_saMyukZwa_rARtra_niXi#ArWika_vikAsa_kI_viSeRa_saMyukZwa_rARtra_niXi#noun#8#RM
swc_state_warehousing_corporation	rAjya_BANdAgAraNa_nigama#rAjya_BANdAgAraNa_nigama#noun#4#RM
tdai_trade_development_authority_of_india	BArawIya_vyApAra_vikAsa_prAXikaraNa#BArawIya_vyApAra_vikAsa_prAXikaraNa#noun#6#RM
tdl_time_and_demand_liabilities	mIyAxI_Ora_mAga_xeyawAe#mIyAxI_Ora_mAga_xeyawAe#noun#5#RM
tdo_telegraphic_delivery_order	wAra_preRaNa_AxeSa#wAra_preRaNa_AxeSa#noun#4#RM
tfai_trade_fair_authority_of_india	BArawIya_vyApAra_melA_prAXikaraNa#BArawIya_vyApAra_melA_prAXikaraNa#noun#6#RM
trade_and_merchandise_marks_act_,_1958_trade_unions_act_,_1926_transfer_of_evacuee_deposits_act_,_1954_of_property_act_,_1882	vyApAra_Ora_paNya_vaswu_cinha_aXiniyama,_195_vyAvasAya_saMGa_aXiniyama,_1926_niRkrAMwa_nikRepoM_kA_aMwaraNa_aXiniyama,_1954jwaMxemiwa_sampafwwa_anwaraNa_aXiniyama,_1882#vyApAra_Ora_paNya_vaswu_cinha_aXiniyama,_195_vyAvasAya_saMGa_aXiniyama,_1926_niRkrAMwa_nikRepoM_kA_aMwaraNa_aXiniyama,_1954jwaMxemiwa_sampafwwa_anwaraNa_aXiniyama,_1882#noun#24#RM
transfer_of_property_(_amendment_)_supplementary_act_,_1929	sampafwwa_anwaraNa_(saMSoXana)_anupUraka_aXiniyama,_1929#sampafwwa_anwaraNa_(saMSoXana)_anupUraka_aXiniyama,_1929#noun#10#RM
trust_laws_(_amendment_)_act_,_1975	nyAsa_viXi_(saMSoXana)_aXiniyama,_1975#nyAsa_viXi_(saMSoXana)_aXiniyama,_1975#noun#8#RM
trysem_training_of_rural_youth_for_self-employment	grAmINa_yuvakoM_ko_sva-niyojana_hewu_praSikRaNa#grAmINa_yuvakoM_ko_sva-niyojana_hewu_praSikRaNa#noun#7#RM
tt_telegraphic_transfer	wAra_aMwaraNa#wAra_aMwaraNa#noun#3#RM
ttci_tea_trading_corporation_of_india	BArawIya_cAya_vyApAra_nigama#BArawIya_cAya_vyApAra_nigama#noun#6#RM
uae_united_arab_emirates	saMyukZwa_araba_amIrAwa#saMyukZwa_araba_amIrAwa#noun#4#RM
ucb_urban_co-operative_bank	SaharI_sahakArI_bEMka#SaharI_sahakArI_bEMka#noun#4#RM
ucp_uniform_customs_procedure	samarUpa_viXi_prakriyA#samarUpa_viXi_prakriyA#noun#4#RM
unclaimed_deposits_act_,_1866_,	binA_xAve_vAle_nikRepa_aXiniyama,_1866#binA_xAve_vAle_nikRepa_aXiniyama,_1866#noun#5#RM
unctad_united_nations_conference_on_trade_and_development	saMyukZwa_rARtra_vyApAra_Ora_vikAsa_sammelana#saMyukZwa_rARtra_vyApAra_Ora_vikAsa_sammelana#noun#8#RM
unesco_united_nations_educational_,_scientific_and_cultural_organisation	saMyukZwa_rARtra_SikRA/vijFAna_Ora_saMsvIkqwi_saMGaTana_(yUnesko)#saMyukZwa_rARtra_SikRA/vijFAna_Ora_saMsvIkqwi_saMGaTana_(yUnesko)#noun#9#RM
unicef_united_nations_international_childrens_emergency_fund	saMyukZwa_rARtra_anwarAZRtrIya_bAla_ApAwa_niXi#saMyukZwa_rARtra_anwarAZRtrIya_bAla_ApAwa_niXi#noun#7#RM
unit_trust_of_india_act_,_1963	BArawIya_yUnita_trasta_aXiniyama,_1963#BArawIya_yUnita_trasta_aXiniyama,_1963#noun#7#RM
unlawful_activities_(_prevention_)_act_,_1967	viXi_viruxXa_kriyAkalApa_(nivAraNa)_aXiniyama,_1967#viXi_viruxXa_kriyAkalApa_(nivAraNa)_aXiniyama,_1967#noun#8#RM
untab_united_nations_technical_assitance_board	saMyukZwa_rARtra_wakanIkI_sahAyawA_borda#saMyukZwa_rARtra_wakanIkI_sahAyawA_borda#noun#6#RM
upsc_union_public_service_commission	saMGa_loka_sevA_Ayoga#saMGa_loka_sevA_Ayoga#noun#5#RM
urban_land_(_ceiling_and_regulation_)_act_,_1976	nagara_BUmi_(aXikawama_sImA_Ora_viniyamana)_aXiniyama,_1976#nagara_BUmi_(aXikawama_sImA_Ora_viniyamana)_aXiniyama,_1976#noun#10#RM
usis_united_states_information_services	saMyukZwa_rAjya_sUcanA_sevA#saMyukZwa_rAjya_sUcanA_sevA#noun#5#RM
usurious_loans_act_,_1918	awibyAja_uXAra_aXiniyama,_1918#awibyAja_uXAra_aXiniyama,_1918#noun#5#RM
usury_laws_repeal_act_,_1855	sUxaKorI_viXi_nirasana_aXiniyama,_1855#sUxaKorI_viXi_nirasana_aXiniyama,_1855#noun#6#RM
uti_unit_trust_of_india	BArawIya_yUnita_trasta#BArawIya_yUnita_trasta#noun#5#RM
voluntary_disclosure_of_income_and_wealth_act_,_1976	Aya_Ora_Xana_svecCayA_prakatana_aXiniyama,_1976#Aya_Ora_Xana_svecCayA_prakatana_aXiniyama,_1976#noun#9#RM
voluntary_surrender_of_salaries_(_exemption_from_taxation_)_act_,_1961	svecCayA_vewana_aByarpaNa_(karoM_se_CUta)_aXiniyama,_1961#svecCayA_vewana_aByarpaNa_(karoM_se_CUta)_aXiniyama,_1961#noun#12#RM
warehousing_corporations_act_,_1962	BANdAgAraNa_nigama_aXiniyama,_1962#BANdAgAraNa_nigama_aXiniyama,_1962#noun#5#RM
waste_lands_(_claims_)_act_,_1863	baMjara_BUmi_(xAve)_aXiniyama,_1863#baMjara_BUmi_(xAve)_aXiniyama,_1863#noun#8#RM
wealth-tax_act_,_1957	Xana-kara_aXiniyama,_1957#Xana-kara_aXiniyama,_1957#noun#4#RM
who_world_health_organisation	viSva_svAsWya_saMgaTana#viSva_svAsWya_saMgaTana#noun#4#RM
whr_ware_house_receipt	goxAma_rasIxa#goxAma_rasIxa#noun#4#RM
workmens_compensation_act_,_1923	karmakAra_prawikara_aXiniyama,_1923#karmakAra_prawikara_aXiniyama,_1923#noun#5#RM
zpg_zero_population_growth	SUnya_janasaMKyA_vqfxXa_xara#SUnya_janasaMKyA_vqfxXa_xara#noun#4#RM
