#computer multi dictionary extracted by Monika Sharma. Formatted by Roja (12-03-2016)
#Changes:: 1) Separated single word and multi words into separate dictionaries
#	   2) English words are converted to lower case
#	   3) Added category as 'noun' by default
#	   4) If last word is not punctuation then treated last word as head
#	      or else treated last but one word as head
#################################################################################
abnormal_termination	apasAmAnya_samApana#apasAmAnya_samApana#noun#2#RM
absolute_address	nirapekRa_pawA#nirapekRa_pawA#noun#2#RM
absolute_coordination	nirapekRa_nirxeSAMka#nirapekRa_nirxeSAMka#noun#2#RM
absolute_error	nirapekRa_wruti#nirapekRa_wruti#noun#2#RM
absolute_value	nirapekRa_mAna#nirapekRa_mAna#noun#2#RM
acceptance_test	svIkaraNa_parIkRaNa#svIkaraNa_parIkRaNa#noun#2#RM
access_mode	aBigama_viXA#aBigama_viXA#noun#2#RM
access_right	aBigama_aXikAra#aBigama_aXikAra#noun#2#RM
access_time	aBigama_kAla#aBigama_kAla#noun#2#RM
accoustic_coupler	Xvani_yugmaka#Xvani_yugmaka#noun#2#RM
accumulator_register	saMcAyaka_paMjI#saMcAyaka_paMjI#noun#2#RM
action_cycle	kriyA_cakra#kriyA_cakra#noun#2#RM
action_line	kriyA_lAina#kriyA_lAina#noun#2#RM
active_file	sakriya_saMcikA#sakriya_saMcikA#noun#2#RM
active_link	sakriya_kadI#sakriya_kadI#noun#2#RM
active_master_file	sakriya_praXAna_saMcikA#sakriya_praXAna_saMcikA#noun#3#RM
active_storage	sakriya_BaMdAraNa#sakriya_BaMdAraNa#noun#2#RM
activity_ratio	srikayawA_anupAwa#srikayawA_anupAwa#noun#2#RM
actual_addressabsolute_address	nirapekRa_pawA#nirapekRa_pawA#noun#3#RM
actual_data_transfer_rate	vAswavika_AMkadA_sWAnAMwaraNa_xara#vAswavika_AMkadA_sWAnAMwaraNa_xara#noun#4#RM
actual_instructioneffective_instruction	praBAvI_anuxeSa#praBAvI_anuxeSa#noun#3#RM
actual_key	vAswavika_kuMjI#vAswavika_kuMjI#noun#2#RM
address_bus	pawA_basa#pawA_basa#noun#2#RM
address_code	pawA_kUta#pawA_kUta#noun#2#RM
address_conversion	pawA_rUpAMwaraNa#pawA_rUpAMwaraNa#noun#2#RM
address_data	pawA_AMkade#pawA_AMkade#noun#2#RM
address_format	pawA_saMrUpa#pawA_saMrUpa#noun#2#RM
address_interlacing	pawA_aMwargraWana#pawA_aMwargraWana#noun#2#RM
address_mapping	pawA_prawiciwraNa#pawA_prawiciwraNa#noun#2#RM
address_pointer	pawA_saMkewaka#pawA_saMkewaka#noun#2#RM
address_register	pawA_paMjI#pawA_paMjI#noun#2#RM
address_space	pawA_sWAna#pawA_sWAna#noun#2#RM
address_track	pawA_mArga#pawA_mArga#noun#2#RM
addressable_point	pawAyogya_viMxu#pawAyogya_viMxu#noun#2#RM
addressable_position	pawAyogya_sWiwi#pawAyogya_sWiwi#noun#2#RM
addressable_storage	pawAyogya_BaMdAraNa#pawAyogya_BaMdAraNa#noun#2#RM
addressing_character	pawABigamana_saMprawIka#pawABigamana_saMprawIka#noun#2#RM
addressless_instruction_format	pawArahiwa_anuxeSa_saMrUpa#pawArahiwa_anuxeSa_saMrUpa#noun#3#RM
administrative_data_processing	praSAsanika_AMkadA_saMsAXana#praSAsanika_AMkadA_saMsAXana#noun#3#RM
advanced_communication_service	unnawa_saMcAra_sevA#unnawa_saMcAra_sevA#noun#3#RM
advanced_information_system	unnawa_sUcanA_waMwra#unnawa_sUcanA_waMwra#noun#3#RM
advanced_optical_character_reader	unnawa_prakASika_saMprawIka_paTiwra#unnawa_prakASika_saMprawIka_paTiwra#noun#4#RM
advanced_scientific_computer	unnawa_vEjFAnika_aBikaliwra#unnawa_vEjFAnika_aBikaliwra#noun#3#RM
aiming_circle	saMXAniwra#saMXAniwra#noun#2#RM
algebraic_manipulation	bIjIya_prakalaNa#bIjIya_prakalaNa#noun#2#RM
algebraic_manipulation_language	bIjIya_prakalaNa_BARA#bIjIya_prakalaNa_BARA#noun#3#RM
algebraic_sign_convention	bIjIya_cinha_paripAtI#bIjIya_cinha_paripAtI#noun#3#RM
algol_programming	elgAla_kramAxeSana#elgAla_kramAxeSana#noun#2#RM
algorithm_complexity	kalana_viXi_jatilawA#kalana_viXi_jatilawA#noun#2#RM
algorithmic_analysis	kalana_viXi_viSleRaNa#kalana_viXi_viSleRaNa#noun#2#RM
algorithmic_approach	kalana_viXIya_upagamana#kalana_viXIya_upagamana#noun#2#RM
all_purpose_computer	sarvoxaxeSIya_aBikaliwra#sarvoxaxeSIya_aBikaliwra#noun#3#RM
alpha_numeric	akRarAMkIya#akRarAMkIya#noun#2#RM
alpha_numeric_character_set	akRarAMkIya_saMprawIka_samuccaya#akRarAMkIya_saMprawIka_samuccaya#noun#4#RM
alpha_numeric_display_device	akRarAMkIya_praxarSa_yukwi#akRarAMkIya_praxarSa_yukwi#noun#4#RM
alpha_numeric_instruction	akRarAMkIya_anuxeSa#akRarAMkIya_anuxeSa#noun#3#RM
alpha_numeric_keyboard	akRarAMkIya_kuMjIpatala#akRarAMkIya_kuMjIpatala#noun#3#RM
alpha_numerical_keyboard_device	akRarAMkIya_kuMjIpatala_yukwi#akRarAMkIya_kuMjIpatala_yukwi#noun#4#RM
alphabetic_character_set	akRarAwmaka_saMprawIka_samuccaya#akRarAwmaka_saMprawIka_samuccaya#noun#3#RM
alphabetic_string	akRarAwmaka_rajju#akRarAwmaka_rajju#noun#2#RM
alterable_memory	parivarwanIya_smqwi#parivarwanIya_smqwi#noun#2#RM
alternate_route	vEkalpika_mArga#vEkalpika_mArga#noun#2#RM
ambiguous_reference	saMxigXa_saMxarBa#saMxigXa_saMxarBa#noun#2#RM
analog_computer	anurUpa_aBikaliwra#anurUpa_aBikaliwra#noun#2#RM
analog_converter	anurUpa_parivarwaka#anurUpa_parivarwaka#noun#2#RM
analog_function_generator	anurUpa_Palana_janaka#anurUpa_Palana_janaka#noun#3#RM
analog_programming	anurUpa_kramAxeSana#anurUpa_kramAxeSana#noun#2#RM
analog_signal	anurUpa_saMkewa#anurUpa_saMkewa#noun#2#RM
analog_switch	anurUpa_svica#anurUpa_svica#noun#2#RM
analog_to_digital_converter	anurUpa_aMkIya_parivarwaka#anurUpa_aMkIya_parivarwaka#noun#4#RM
analog_transmission	anurUpa_saMcarana#anurUpa_saMcarana#noun#2#RM
analytical_engine	vESleRika_iMjana#vESleRika_iMjana#noun#2#RM
and_gate	waWA_xvAra#waWA_xvAra#noun#2#RM
and_operation	waWA_saMkrIya#waWA_saMkrIya#noun#2#RM
answering_time	uwwara_kAla#uwwara_kAla#noun#2#RM
anticipatory_buffering	prawyASAmUlaka_cayakana#prawyASAmUlaka_cayakana#noun#2#RM
anticipatory_carry	prawyASAmUlaka_hAsila#prawyASAmUlaka_hAsila#noun#2#RM
anticipatory_paging	prawyASAmUlaka_pqRTana#prawyASAmUlaka_pqRTana#noun#2#RM
aperiodic_antenna	anAvarwI_entenA#anAvarwI_entenA#noun#2#RM
aperture_time	xvAraka_kAla#xvAraka_kAla#noun#2#RM
application_developer	anuprayoga_vikAsaka#anuprayoga_vikAsaka#noun#2#RM
application_layer	anuprayoga_swara#anuprayoga_swara#noun#2#RM
application_oriented_laguage	anuprayoga_mUlaka_BARA#anuprayoga_mUlaka_BARA#noun#3#RM
application_package	anuprayoga_(kramAxeSa)_saMkUla#anuprayoga_(kramAxeSa)_saMkUla#noun#2#RM
application_program	anuprayoga_kramAxeSa#anuprayoga_kramAxeSa#noun#2#RM
application_software	anuprayoga_prakriyA_sAmagrI#anuprayoga_prakriyA_sAmagrI#noun#2#RM
arbitrary_access	svecCA_aBigama#svecCA_aBigama#noun#2#RM
area_search	kRewra_Koja#kRewra_Koja#noun#2#RM
arguement_address	svawaMwra_cara_pawA#svawaMwra_cara_pawA#noun#2#RM
arguement_list	svawaMwra_cara_sUcI#svawaMwra_cara_sUcI#noun#2#RM
arithmatic_and_logic_unit	aMkagaNiwIya_evaM_warka_ekaka#aMkagaNiwIya_evaM_warka_ekaka#noun#4#RM
arithmatic_assignment_statement	aMkagaNiwIya_niyawana_kaWana#aMkagaNiwIya_niyawana_kaWana#noun#3#RM
arithmatic_constant	aMkagaNiwIya_acara#aMkagaNiwIya_acara#noun#2#RM
arithmatic_exception	aMkagaNiwIya_apavAxa#aMkagaNiwIya_apavAxa#noun#2#RM
arithmatic_expression	aMkagaNiwIya_vyaMjaka#aMkagaNiwIya_vyaMjaka#noun#2#RM
arithmatic_hierarchy	aMkagaNiwIya_paxAnukrama#aMkagaNiwIya_paxAnukrama#noun#2#RM
arithmatic_if_statement	aMkagaNiwIya_yaxi_kaWana#aMkagaNiwIya_yaxi_kaWana#noun#3#RM
arithmatic_logic_unit	aMkagaNiwIya_warka_ekaka#aMkagaNiwIya_warka_ekaka#noun#3#RM
arithmatic_operation	aMkagaNiwIya_saMkriyA#aMkagaNiwIya_saMkriyA#noun#2#RM
arithmatic_overflow	aMkagaNiwIya_aXipravAha#aMkagaNiwIya_aXipravAha#noun#2#RM
arithmatic_register	aMkagaNiwIya_paMjI#aMkagaNiwIya_paMjI#noun#2#RM
arithmatic_relation	aMkagaNiwIya_saMbaMXa#aMkagaNiwIya_saMbaMXa#noun#2#RM
arithmatic_statement	aMkagaNiwIya_kaWana#aMkagaNiwIya_kaWana#noun#2#RM
arithmatic_underflow	aMkagaNiwIya_aXopravAha#aMkagaNiwIya_aXopravAha#noun#2#RM
arithmatic_unit	aMkagaNiwIya_ekaka#aMkagaNiwIya_ekaka#noun#2#RM
arithmetical_instruction	aMkagaNiwIya_anuxeSa#aMkagaNiwIya_anuxeSa#noun#2#RM
array_computer	saraNI_aBikaliwra#saraNI_aBikaliwra#noun#2#RM
array_dimension	saraNI_vimA#saraNI_vimA#noun#2#RM
array_element	saraNI_avayava#saraNI_avayava#noun#2#RM
array_name	saraNI_nAma#saraNI_nAma#noun#2#RM
array_processing	saraNI_saMsAXana#saraNI_saMsAXana#noun#2#RM
array_processor	saraNI_saMsAXiwra#saraNI_saMsAXiwra#noun#2#RM
artificial_intelligence	kqwrima_buxXi#kqwrima_buxXi#noun#2#RM
artificial_language	kqwrima_BARA#kqwrima_BARA#noun#2#RM
ascending_sort	ArohI#ArohI#noun#2#RM
ascii_control_character	AskI_niyaMwraNa_saMprawIka#AskI_niyaMwraNa_saMprawIka#noun#3#RM
ascii_keyboard	AskI_kuMjI_patala#AskI_kuMjI_patala#noun#2#RM
aspect_ratio	aBimuKawA_anupAwa#aBimuKawA_anupAwa#noun#2#RM
assembler_language	kodAMwaraka_BARA#kodAMwaraka_BARA#noun#2#RM
assembly_language	kodAMwaraNa_BARA#kodAMwaraNa_BARA#noun#2#RM
assembly_language_software_flexibility	kodAMwaraNa_BARA_prakriyA_sAmagrI_namyawA#kodAMwaraNa_BARA_prakriyA_sAmagrI_namyawA#noun#4#RM
assignment_operation	niyawana_saMkriyA#niyawana_saMkriyA#noun#2#RM
assignment_statement	niyawana_kaWana#niyawana_kaWana#noun#2#RM
associative_address	sAhacarya_pawA#sAhacarya_pawA#noun#2#RM
associative_memory	sAhacarya_smqwi#sAhacarya_smqwi#noun#2#RM
associative_storage	sAhacarya_BaMdAraNa#sAhacarya_BaMdAraNa#noun#2#RM
asymmetric_device	asamamiwa_yukwi#asamamiwa_yukwi#noun#2#RM
asynchronous_communication	awulyakAlI_saMcAra#awulyakAlI_saMcAra#noun#2#RM
asynchronous_data_transfer	awulyakAlI_AMkadA_aMwaraNa#awulyakAlI_AMkadA_aMwaraNa#noun#3#RM
asynchronous_device	awulyakAlI_yukwi#awulyakAlI_yukwi#noun#2#RM
asynchronous_operation	awulyakAlI_pracAlana#awulyakAlI_pracAlana#noun#2#RM
attached_processor	saMlagna_saMsAXiwra#saMlagna_saMsAXiwra#noun#2#RM
attenuation_constant	kRINanAMka#kRINanAMka#noun#2#RM
audio_cassette	Sravya_kEseta#Sravya_kEseta#noun#2#RM
audio_response	Sravya_anukriyA#Sravya_anukriyA#noun#2#RM
audio_response_unit	Sravya_anukriyA_ekaka#Sravya_anukriyA_ekaka#noun#3#RM
audio_terminal	Sravya_aMwaka#Sravya_aMwaka#noun#2#RM
audit_programming	leKAparIkRA_kramAxeSana#leKAparIkRA_kramAxeSana#noun#2#RM
authoring_system	saMleKana_praNAlI#saMleKana_praNAlI#noun#2#RM
authorization_code	prAXikaraNa_kUta#prAXikaraNa_kUta#noun#2#RM
authorized_program	prAXikqwa_kramAxeSa#prAXikqwa_kramAxeSa#noun#2#RM
authorized_program_facility	prAXikqwa_kramAxeSa_suviXA#prAXikqwa_kramAxeSa_suviXA#noun#3#RM
auto_call	svawa:_AhavAna#svawa:_AhavAna#noun#2#RM
auto_coder	svakUta_leKaka#svakUta_leKaka#noun#2#RM
auto_index	svawa:_sUcaka#svawa:_sUcaka#noun#2#RM
automata_theory	svacala_prarUpa_sixXAMwa#svacala_prarUpa_sixXAMwa#noun#2#RM
automated_bibliography	kaMmpyUtariwa_graMWa_sUcI#kaMmpyUtariwa_graMWa_sUcI#noun#2#RM
automated_dictionary	kaMmpyUtariwa_koRA#kaMmpyUtariwa_koRA#noun#2#RM
automated_glossary	kaMmpyUtariwa_Sabxa_saMgraha#kaMmpyUtariwa_Sabxa_saMgraha#noun#2#RM
automated_stock_control	svacAliwa_stAka_niyaMwraNa#svacAliwa_stAka_niyaMwraNa#noun#3#RM
automatic_call_distributer	svawa:_AhavAna_viwaraka#svawa:_AhavAna_viwaraka#noun#3#RM
automatic_check	svawa:_jAMca#svawa:_jAMca#noun#2#RM
automatic_coding	svawa:_kUta_leKana#svawa:_kUta_leKana#noun#2#RM
automatic_computing	svawa:_aBikalana#svawa:_aBikalana#noun#2#RM
automatic_data_processing	svawa:_AMkadA_saMsAXana#svawa:_AMkadA_saMsAXana#noun#3#RM
automatic_dialing_unit	svawa:_dAyalana_ekaka#svawa:_dAyalana_ekaka#noun#3#RM
automatic_dictionary	svawa:_koSa#svawa:_koSa#noun#2#RM
automatic_error_correction	svawa:_wruti_saMsoXana#svawa:_wruti_saMsoXana#noun#3#RM
automatic_feed_punch	svawa:_BaraNa_Cixriwra#svawa:_BaraNa_Cixriwra#noun#3#RM
automatic_indexing	svawa:_sUcakIkaraNa#svawa:_sUcakIkaraNa#noun#2#RM
automatic_massage_routing	svawa:_saMxeSa_mArgana#svawa:_saMxeSa_mArgana#noun#3#RM
automatic_programming	svawa:_kramAxeSana#svawa:_kramAxeSana#noun#2#RM
automatic_recovery_program	svawa:_puna:_prApwi_kramAxeSa#svawa:_puna:_prApwi_kramAxeSa#noun#3#RM
automatic_restart	svawa:_punarAraMBana#svawa:_punarAraMBana#noun#2#RM
auxiliary_memory	sahAyaka_smqwi#sahAyaka_smqwi#noun#2#RM
auxiliary_operation	sahAyaka_pracAlana#sahAyaka_pracAlana#noun#2#RM
auxiliary_storage	sahAyaka_BaMdArana#sahAyaka_BaMdArana#noun#2#RM
average_access_tank	Osawa_aBigama_kAla#Osawa_aBigama_kAla#noun#3#RM
average_information_rate	Osawa_sUcanA_xara#Osawa_sUcanA_xara#noun#3#RM
average_trans_information_rate	Osawa_pAra_sUcanA_xara#Osawa_pAra_sUcanA_xara#noun#4#RM
back_plane	paSca_samawala#paSca_samawala#noun#2#RM
back_space	paScIyana#paScIyana#noun#2#RM
back_space_character	paScIyana_saMprawIka#paScIyana_saMprawIka#noun#3#RM
back_tracking	paSca_anumArgana#paSca_anumArgana#noun#2#RM
back_up	pUrwikara#pUrwikara#noun#2#RM
back_up_copy	pUrwikara_prawilipi#pUrwikara_prawilipi#noun#3#RM
back_up_file	pUrwikara_saMcikA#pUrwikara_saMcikA#noun#3#RM
back_up_memory	pUrwikara_smqwi#pUrwikara_smqwi#noun#3#RM
backgrounding_job	pqRTaBUmi_kArya#pqRTaBUmi_kArya#noun#2#RM
backgrounding_printing	pqRTaBUmi_muxraNa#pqRTaBUmi_muxraNa#noun#2#RM
backgrounding_processing	pqRTaBUmi_saMsAXana#pqRTaBUmi_saMsAXana#noun#2#RM
backing_storage	sahAyaka_BaMdAra#sahAyaka_BaMdAra#noun#2#RM
backward_channel	paScagAmI_praNAla#paScagAmI_praNAla#noun#2#RM
backward_file_recovery	paSca_saMcikA_puna:_prApwi#paSca_saMcikA_puna:_prApwi#noun#3#RM
backward_trace	paSca_anureKa#paSca_anureKa#noun#2#RM
balanced_circuit	saMwulana_paripaWa#saMwulana_paripaWa#noun#2#RM
balanced_sorting	saMwuliwa_sArtana#saMwuliwa_sArtana#noun#2#RM
balanced_ternary_system	saMwuliwa_wriAXArI_paxXawi#saMwuliwa_wriAXArI_paxXawi#noun#3#RM
band_stop_filter	bEMda_virAma_nisyaMxaka#bEMda_virAma_nisyaMxaka#noun#3#RM
band_width	bEMda_cOdAI#bEMda_cOdAI#noun#2#RM
bar_code	reKikA_kUta#reKikA_kUta#noun#2#RM
bar_code_reader	reKikA_kUta_paTiwra#reKikA_kUta_paTiwra#noun#3#RM
bar_code_scanner	reKikA_kUta_krama_vikRaka#reKikA_kUta_krama_vikRaka#noun#3#RM
bar_printer	reKikA_muxriwra#reKikA_muxriwra#noun#2#RM
base_address	AXAra_pawA#AXAra_pawA#noun#2#RM
base_band	AXAra_patatI#AXAra_patatI#noun#2#RM
base_element	AXAra_avayava#AXAra_avayava#noun#2#RM
base_notation	AXAra_saMkewana#AXAra_saMkewana#noun#2#RM
base_volume	mUlaKaMda#mUlaKaMda#noun#2#RM
basic_access_method	AXArI_aBigama_viXi#AXArI_aBigama_viXi#noun#3#RM
basic_code	AXArI_kUta#AXArI_kUta#noun#2#RM
basic_input/output	AXArI_niveSa/nigama#AXArI_niveSa/nigama#noun#2#RM
basic_instruction	AXAraBUwa_anuxeSa#AXAraBUwa_anuxeSa#noun#2#RM
basic_sequential_access_method	AXAraBUwa_anukramI_aBigama_viXi#AXAraBUwa_anukramI_aBigama_viXi#noun#4#RM
basic_system_instruction	AXArI_waMwra_anuxeSa#AXArI_waMwra_anuxeSa#noun#3#RM
batch_control_record	pracaya_niyaMwraNa_aBileKa#pracaya_niyaMwraNa_aBileKa#noun#3#RM
batch_operating_system	pracaya_saMkriyA_praNAlI#pracaya_saMkriyA_praNAlI#noun#3#RM
batch_processing	pracaya_saMsAXana#pracaya_saMsAXana#noun#2#RM
batched_communication	pracayiwa_saMcAra#pracayiwa_saMcAra#noun#2#RM
baud_rate	bAda_xara#bAda_xara#noun#2#RM
beam_deflection	kiraNapuja_vikRepaNa#kiraNapuja_vikRepaNa#noun#2#RM
beam_width	kiraNapuja_koNa#kiraNapuja_koNa#noun#2#RM
beginning_of_tape_mark	tepa_cinha_kA_prAraMBana#tepa_cinha_kA_prAraMBana#noun#4#RM
bench_mark	nirxeSa_cinha#nirxeSa_cinha#noun#2#RM
benchmart_test	nirxeSa_cinha_parIkRaNa#nirxeSa_cinha_parIkRaNa#noun#2#RM
bias_testing	aBinIwa_parIkRaNa#aBinIwa_parIkRaNa#noun#2#RM
biconditonal_operation	wulyawA_saMkriyA#wulyawA_saMkriyA#noun#2#RM
biconnected_graph	xviyojI_grAPa#xviyojI_grAPa#noun#2#RM
bidirectional_printing	xvixiSa_muxraNa#xvixiSa_muxraNa#noun#2#RM
binary_arithmatic_operation	xviAXArI_aMkagaNiwIya_saMkriyA#xviAXArI_aMkagaNiwIya_saMkriyA#noun#3#RM
binary_chain	xviAXArI_SrqMKalA#xviAXArI_SrqMKalA#noun#2#RM
binary_code	xviAXArI_kUta#xviAXArI_kUta#noun#2#RM
binary_coded_character	xviAXArI_kUtaliKiwa_saMprawIka#xviAXArI_kUtaliKiwa_saMprawIka#noun#3#RM
binary_coded_decimal	xviAXArI_kUtaliKiwa_xaSamalava#xviAXArI_kUtaliKiwa_xaSamalava#noun#3#RM
binary_coded_decimal_code	xviAXArI_kUtaliKiwa_xaSamalava_kUta#xviAXArI_kUtaliKiwa_xaSamalava_kUta#noun#4#RM
binary_coded_decimal_system	xviAXArI_kUtaliKiwa_xaSamalava_paxXawi#xviAXArI_kUtaliKiwa_xaSamalava_paxXawi#noun#4#RM
binary_coded_notation	xviAXArI_kUtaliKiwa_aMka_saMkewana#xviAXArI_kUtaliKiwa_aMka_saMkewana#noun#3#RM
binary_coding	xviAXArI_kUtaleKana#xviAXArI_kUtaleKana#noun#2#RM
binary_conversion	xviAXArI_rUpAMwaraNa#xviAXArI_rUpAMwaraNa#noun#2#RM
binary_digit	xviAXArI_aMka#xviAXArI_aMka#noun#2#RM
binary_half_adder	xviAXArI_arXayojaka#xviAXArI_arXayojaka#noun#3#RM
binary_loader	xviAXArI_BAraka#xviAXArI_BAraka#noun#2#RM
binary_notation	xviAXArI_saMkewana#xviAXArI_saMkewana#noun#2#RM
binary_number	xviAXArI_saMKyA#xviAXArI_saMKyA#noun#2#RM
binary_number_system	xviAXArI_saMKyA_paxXawi#xviAXArI_saMKyA_paxXawi#noun#3#RM
binary_operation	xviAXArI_saMkAraka#xviAXArI_saMkAraka#noun#2#RM
binary_operation_code	xviAXArI_saMkriyA_kUta#xviAXArI_saMkriyA_kUta#noun#3#RM
binary_relation	xvayI_saMbaMXa#xvayI_saMbaMXa#noun#2#RM
binary_search	xviBAjI_anveRaNa#xviBAjI_anveRaNa#noun#2#RM
binary_synchronous_communication	xviAXArI_wulyakAlIka_saMcAra#xviAXArI_wulyakAlIka_saMcAra#noun#3#RM
binary_tree	xvayI_warU#xvayI_warU#noun#2#RM
bipartite_graph	xviBAjya_grAPa#xviBAjya_grAPa#noun#2#RM
bipolar_memory	xviXuvI_smqwi#xviXuvI_smqwi#noun#2#RM
birth_death_process	janma_maraNa_prakrama#janma_maraNa_prakrama#noun#3#RM
bisection_algorithm	xviBAjana_kalana_viXi#xviBAjana_kalana_viXi#noun#2#RM
bistable_device	xvisWiwika_yukwi#xvisWiwika_yukwi#noun#2#RM
bit_density	xvayaMka_Ganawva#xvayaMka_Ganawva#noun#2#RM
bit_instruction	xvayaMka_anuxeSa#xvayaMka_anuxeSa#noun#2#RM
bit_location	xvayaMka_sWAna#xvayaMka_sWAna#noun#2#RM
bit_pattern	xvayaMka_prawirUpa#xvayaMka_prawirUpa#noun#2#RM
bit_position	xvayaMka_sWiwi#xvayaMka_sWiwi#noun#2#RM
bit_rate	xvayaMka_xara#xvayaMka_xara#noun#2#RM
bit_slice	xvayaMka_kawalI#xvayaMka_kawalI#noun#2#RM
bit_string	xvayaMka_rajjU#xvayaMka_rajjU#noun#2#RM
bite_manipulation	bAitara_prakalana#bAitara_prakalana#noun#2#RM
bits_per_second	xvayaMka_prawi_sekaNda#xvayaMka_prawi_sekaNda#noun#3#RM
blank_character	rikwa_saMprawIka#rikwa_saMprawIka#noun#2#RM
blank_diskette	rikwa_namyikA#rikwa_namyikA#noun#2#RM
blind_keyboard	aMXa_kuMjI_patala#aMXa_kuMjI_patala#noun#2#RM
block_check	KaMdaka_jAMca#KaMdaka_jAMca#noun#2#RM
block_check_proceeder	KaMdaka_jAMca_kriyA_viXi#KaMdaka_jAMca_kriyA_viXi#noun#3#RM
block_control_unit	KaMdaka_niyaMwraNa_ekaka#KaMdaka_niyaMwraNa_ekaka#noun#3#RM
block_copy	KaMdaka_prawilipi#KaMdaka_prawilipi#noun#2#RM
block_diagram	KaMdaka_AreKa#KaMdaka_AreKa#noun#2#RM
block_gap	aMwarKadaka_rikwi#aMwarKadaka_rikwi#noun#2#RM
block_length	KaMdaka_xErXya#KaMdaka_xErXya#noun#2#RM
block_record	KaMdaka_aBileKa#KaMdaka_aBileKa#noun#2#RM
block_size	KaMdaka_AmApa#KaMdaka_AmApa#noun#2#RM
block_structure	KaMdaka_saMracanA#KaMdaka_saMracanA#noun#2#RM
block_transfer	KaMdaka_sWAnAMwaraNa#KaMdaka_sWAnAMwaraNa#noun#2#RM
bold_face	mote_akRara#mote_akRara#noun#2#RM
boolean_comlimentation	bUlIya_saMpUraNa#bUlIya_saMpUraNa#noun#2#RM
boolean_connective	bUlIya_saMyojI#bUlIya_saMyojI#noun#2#RM
boolean_data_type	bUlIya_AMkadA_prakAra#bUlIya_AMkadA_prakAra#noun#3#RM
boolean_function	bUlIya_Palana#bUlIya_Palana#noun#2#RM
boolean_operation	bUlIya_saMkriyA#bUlIya_saMkriyA#noun#2#RM
boolean_operator	bUlIya_saMkAraka#bUlIya_saMkAraka#noun#2#RM
boot_strap_loader	svawWAnI#svawWAnI#noun#3#RM
boot_strap_memory	svawWAnI_smqwi#svawWAnI_smqwi#noun#3#RM
boot_straping	svawWAna#svawWAna#noun#2#RM
borrow_digit	paScAMka#paScAMka#noun#2#RM
bothway_communication	xviXA_saMcAra#xviXA_saMcAra#noun#2#RM
bottom_up_method	samAnayana_viXi#samAnayana_viXi#noun#3#RM
boundary_alignment	parisImA_sareKana#parisImA_sareKana#noun#2#RM
branch_and_bound_method	SAKA_Ora_paribaMXa_viXi#SAKA_Ora_paribaMXa_viXi#noun#4#RM
branch_instruction	SAKA_anuxeSa#SAKA_anuxeSa#noun#2#RM
break_key	vicCexa_kuMjI#vicCexa_kuMjI#noun#2#RM
break_point_switch	vicCexa_viMxu_svica#vicCexa_viMxu_svica#noun#3#RM
brightness_ratio	xyuwi_anupAwa#xyuwi_anupAwa#noun#2#RM
broadcast_mode	prasAraNa_viXA#prasAraNa_viXA#noun#2#RM
broadcast_sattelite	prasAraNa_upagraha#prasAraNa_upagraha#noun#2#RM
bubble_memory	buxabuxa_smqwi#buxabuxa_smqwi#noun#2#RM
bubble_sort	buxabuxa_CAMta#buxabuxa_CAMta#noun#2#RM
buffer_chanel	cayakiwa_praNAla#cayakiwa_praNAla#noun#2#RM
buffer_i/o_device	cayaka_ni/ni_yukwi#cayaka_ni/ni_yukwi#noun#3#RM
buffer_register	cayaka_paMjI#cayaka_paMjI#noun#2#RM
buffer_storage	cayaka_BaMdAraka#cayaka_BaMdAraka#noun#2#RM
buffered_implifier	cayakiwa_prabaMXaka#cayakiwa_prabaMXaka#noun#2#RM
buffered_input	cayakiwa_niveSa#cayakiwa_niveSa#noun#2#RM
built_in_function	aMwarnirmiwa_Palana#aMwarnirmiwa_Palana#noun#3#RM
built_in_procedure	aMwarnirmiwa_prakriyA#aMwarnirmiwa_prakriyA#noun#3#RM
burst_transmission	prasPota_saMcaraNa#prasPota_saMcaraNa#noun#2#RM
bus_controller	basa_niyaMwraka#basa_niyaMwraka#noun#2#RM
bus_termination	basa_aMwa#basa_aMwa#noun#2#RM
business_data_processing	vyavasAya_AMkadA_saMsAXana#vyavasAya_AMkadA_saMsAXana#noun#3#RM
business_information_system	vyavasAya_sUcanA_waMwra#vyavasAya_sUcanA_waMwra#noun#3#RM
busy_hour	vyaswa_GaMtA#vyaswa_GaMtA#noun#2#RM
busy_signal	vyaswa_saMkewa#vyaswa_saMkewa#noun#2#RM
busy_tone	vyaswawA_tona#vyaswawA_tona#noun#2#RM
byte_multiplexer_channel	bAita_bahusaMkewaka_praNAla#bAita_bahusaMkewaka_praNAla#noun#3#RM
byte_multiplexing	bAita_bahusaMkewana#bAita_bahusaMkewana#noun#2#RM
cable_casting	kebala_prasAraNa#kebala_prasAraNa#noun#2#RM
cable_television_service	kebala_telIvijana_sevA#kebala_telIvijana_sevA#noun#3#RM
cache_cache_memory	xruNikA_smqwi#xruNikA_smqwi#noun#3#RM
calculator_chip	parikaliwra_cipa#parikaliwra_cipa#noun#2#RM
calculator_without_programmability	kramAxeSanIyawA_rahiwa_parikaliwra#kramAxeSanIyawA_rahiwa_parikaliwra#noun#3#RM
call_by_reference	saMxarBa_AhavAna#saMxarBa_AhavAna#noun#3#RM
call_by_value	mAna_AhavAna#mAna_AhavAna#noun#3#RM
call_directing_code	AhavAna_nixeSana_kata#AhavAna_nixeSana_kata#noun#3#RM
call_forwarding	AhavAna_agreRaNa#AhavAna_agreRaNa#noun#2#RM
call_waiting	AhavAna_prawIkRA#AhavAna_prawIkRA#noun#2#RM
calling_program	AhavAna_kramAxeSa#AhavAna_kramAxeSa#noun#2#RM
calling_sub_program	AhavAna_upa_kramAxeSa#AhavAna_upa_kramAxeSa#noun#3#RM
cancel_key	nirasana_kuMjI#nirasana_kuMjI#noun#2#RM
card_chassis	kArda_nyAXAra#kArda_nyAXAra#noun#2#RM
card_column	pawraka_swaMBa#pawraka_swaMBa#noun#2#RM
card_deck	pawraka_gadadI#pawraka_gadadI#noun#2#RM
card_format	pawraka_saMrUpa#pawraka_saMrUpa#noun#2#RM
card_hopper	pawraka_plUwi_maMjuRA#pawraka_plUwi_maMjuRA#noun#2#RM
card_jam	pawraka_saMvAXA#pawraka_saMvAXA#noun#2#RM
card_loader	pawraka_BAraka#pawraka_BAraka#noun#2#RM
card_pack	pawraka_gadadI#pawraka_gadadI#noun#2#RM
card_programmed_calculator	pawraka_kramAxeSiwa_parikaliwra#pawraka_kramAxeSiwa_parikaliwra#noun#3#RM
card_punch	pawraka_Cixriwra#pawraka_Cixriwra#noun#2#RM
card_punching_technique	pawraka_CixraNa_wakanIka#pawraka_CixraNa_wakanIka#noun#3#RM
card_reader	pawraka_paTiwra#pawraka_paTiwra#noun#2#RM
card_sorter	pawraka_SAtiwra#pawraka_SAtiwra#noun#2#RM
card_stracker	pawraka_ciwIyaka#pawraka_ciwIyaka#noun#2#RM
card_to_disk_utility	pawraka_cakrikA_upayogiwA#pawraka_cakrikA_upayogiwA#noun#4#RM
card_to_magnetic_tape_conversion	pawraka_cumabakIya_tepa_rUpAMwaraNa#pawraka_cumabakIya_tepa_rUpAMwaraNa#noun#5#RM
card_varifying	pawraka_sawyApana#pawraka_sawyApana#noun#2#RM
carriage_control_character	vAhana_niyaMwraNa_saMprawIka#vAhana_niyaMwraNa_saMprawIka#noun#3#RM
carriage_return	vAhana_vApasI#vAhana_vApasI#noun#2#RM
carriage_return_character	vAhana_vApasI_saMprawIka#vAhana_vApasI_saMprawIka#noun#3#RM
carrier_load	nIwa_BAra#nIwa_BAra#noun#2#RM
carrier_signal	vAhaka_saMkewa#vAhaka_saMkewa#noun#2#RM
carrier_to_noise_ratio	vAhaka_rava_anupAwa#vAhaka_rava_anupAwa#noun#4#RM
carrier_wave	vAhaka_waraMga#vAhaka_waraMga#noun#2#RM
carry_digit	haswaMgawa_aMka#haswaMgawa_aMka#noun#2#RM
carry_flag	haswaMgawa_Xvaja#haswaMgawa_Xvaja#noun#2#RM
cascaded_merging	sopAniwa_vilayana#sopAniwa_vilayana#noun#2#RM
cata_language	aBilakRya_BARA#aBilakRya_BARA#noun#2#RM
catalogue_directory	kramAxeSa_sUci_nirxeSikA#kramAxeSa_sUci_nirxeSikA#noun#2#RM
catastrophic_error	vipawwipUrNa_wruti#vipawwipUrNa_wruti#noun#2#RM
cathod_ray_storage	kEWoda_kiraNa_BaMdAraNa#kEWoda_kiraNa_BaMdAraNa#noun#3#RM
cathod_ray_tube	kEWoda_kiraNa_nalikA#kEWoda_kiraNa_nalikA#noun#3#RM
cathod_ray_tube_display	kEWoda_kiraNa_nalikA_praxarSa#kEWoda_kiraNa_nalikA_praxarSa#noun#4#RM
cellular_mobile_telephone_network	koRtakIya_cala_telIPona_jAlakrama#koRtakIya_cala_telIPona_jAlakrama#noun#4#RM
central_control_unit	kenxrIya_niyaMwraNa_ekaka#kenxrIya_niyaMwraNa_ekaka#noun#3#RM
central_memory	kenxrIya_smqwi#kenxrIya_smqwi#noun#2#RM
central_office	kenxrIya_kAryAlaya#kenxrIya_kAryAlaya#noun#2#RM
central_station	niyaMwraNa_kenxra#niyaMwraNa_kenxra#noun#2#RM
centralized_data_processing	kenxrIkqwa_AMkadA_saMsAXana#kenxrIkqwa_AMkadA_saMsAXana#noun#3#RM
certified_tape	pramANikqwa_tepa#pramANikqwa_tepa#noun#2#RM
chain_link	SrqMKalA_kadI#SrqMKalA_kadI#noun#2#RM
chain_printer	SrqMKalA_muxriwra#SrqMKalA_muxriwra#noun#2#RM
chained_file	SrqMKaliwa_saMcikA#SrqMKaliwa_saMcikA#noun#2#RM
chained_list	SrqMKaliwa_sUci#SrqMKaliwa_sUci#noun#2#RM
channel_attest_station	praNAla_saMlagna_kenxra#praNAla_saMlagna_kenxra#noun#3#RM
chassis_assembly	nyAXAra_samAyojana#nyAXAra_samAyojana#noun#2#RM
check_bit	jAMca_xvayaMka#jAMca_xvayaMka#noun#2#RM
check_character	jAMca_saMprawIka#jAMca_saMprawIka#noun#2#RM
check_digit	jAMca_aMka#jAMca_aMka#noun#2#RM
check_indicator_instruction	jAMca_sUcaka_anuxeSa#jAMca_sUcaka_anuxeSa#noun#3#RM
check_out_routine	xoRamArjana_nemakA#xoRamArjana_nemakA#noun#3#RM
check_point_restart	jAMca_vinxu_puna:_prAraMBana#jAMca_vinxu_puna:_prAraMBana#noun#3#RM
check_routine	jAMca_nemakA#jAMca_nemakA#noun#2#RM
check_sum	jAMca_yoga#jAMca_yoga#noun#2#RM
check_word	jAMca_Sabxa#jAMca_Sabxa#noun#2#RM
child_sigment	saMwawi_KaMda#saMwawi_KaMda#noun#2#RM
chip_carrier	cipa_vAhaka#cipa_vAhaka#noun#2#RM
cipher_text	kUta_liKiwa_AMkade#kUta_liKiwa_AMkade#noun#2#RM
circuit_board	paripaWa_pata#paripaWa_pata#noun#2#RM
circuit_card	paripaWa_pawraka#paripaWa_pawraka#noun#2#RM
circuit_load	paripaWa_loda#paripaWa_loda#noun#2#RM
circuit_reliability	paripaWa_viSvasanIyawA#paripaWa_viSvasanIyawA#noun#2#RM
circuit_switching	paripaWa_svicana#paripaWa_svicana#noun#2#RM
circuit_switching_unit	paripaWa_svicana_ekaka#paripaWa_svicana_ekaka#noun#3#RM
circular_list	vqwwIya_sUci#vqwwIya_sUci#noun#2#RM
circular_shift	vqwwIya_visWApana#vqwwIya_visWApana#noun#2#RM
clear_area	rikwa_kRewra#rikwa_kRewra#noun#2#RM
clear_channel	spaRta_praNAla#spaRta_praNAla#noun#2#RM
clear_display	praxarSa_nirasana#praxarSa_nirasana#noun#2#RM
clock_frequency	kAlaxa_Avqwwi#kAlaxa_Avqwwi#noun#2#RM
clock_intrupt	kAlaxa_anwarAyana#kAlaxa_anwarAyana#noun#2#RM
clock_plus	kAlaxa_spaMxa#kAlaxa_spaMxa#noun#2#RM
clock_rate	kAlaxa_xara#kAlaxa_xara#noun#2#RM
clock_signal	kAlaxa_saMkewa#kAlaxa_saMkewa#noun#2#RM
clock_time	kAlaxa_samaya#kAlaxa_samaya#noun#2#RM
closed_loop	saMvqwa_pASa#saMvqwa_pASa#noun#2#RM
closely_cuppled	xqDawa:_yugmiwa#xqDawa:_yugmiwa#noun#2#RM
closing_of_a_file	saMcikA_samApana#saMcikA_samApana#noun#4#RM
cluster_analysis	gucCa_viSleRaNa#gucCa_viSleRaNa#noun#2#RM
cluster_controller	gucCa_niyaMwraka#gucCa_niyaMwraka#noun#2#RM
clustered_file	gucCiwa_saMcikA#gucCiwa_saMcikA#noun#2#RM
coated_card	pepiwa_pawraka#pepiwa_pawraka#noun#2#RM
coaxial_cable	samAkRa_kebala#samAkRa_kebala#noun#2#RM
cobol_progamming	kobola_kamAxeSana#kobola_kamAxeSana#noun#2#RM
code-independent_system	kUta_svawaMwra_waMwra#kUta_svawaMwra_waMwra#noun#2#RM
code_frame	kUta_Prema#kUta_Prema#noun#2#RM
code_set	kUta_samuccaya#kUta_samuccaya#noun#2#RM
code_word	kUta_Sabxa#kUta_Sabxa#noun#2#RM
coded_arithmetic_data	kUta_liKiwa_aMkagaNiwIya_AMkade#kUta_liKiwa_aMkagaNiwIya_AMkade#noun#3#RM
coded_decimal_notation	kUta_liKiwa_xaSamalava_saMkewana_paxXawi#kUta_liKiwa_xaSamalava_saMkewana_paxXawi#noun#3#RM
coded_program	kUtaliKiwa_kramAxeSa#kUtaliKiwa_kramAxeSa#noun#2#RM
coding_check	kUtaleKana_jAMca#kUtaleKana_jAMca#noun#2#RM
coding_form	kUtaleKana_PArma#kUtaleKana_PArma#noun#2#RM
coding_sheet	kUtaleKana_parNa#kUtaleKana_parNa#noun#2#RM
coincidence_error	saMpAwa_wruti#saMpAwa_wruti#noun#2#RM
cold_start	prAraMBana#prAraMBana#noun#2#RM
collating_sequence	samAnukramI_anukrama#samAnukramI_anukrama#noun#2#RM
column_move	swaMBa_visWApana#swaMBa_visWApana#noun#2#RM
combinational_circuit	saMyojana_paripaWa#saMyojana_paripaWa#noun#2#RM
combinational_logic	saMyojana_warka#saMyojana_warka#noun#2#RM
combinatorial_circuit	saMyojI_paripaWa#saMyojI_paripaWa#noun#2#RM
combined_read/write_head	saMyukwa_paTana/leKana_SIrRa#saMyukwa_paTana/leKana_SIrRa#noun#3#RM
command_chain	samAxeSa_SrqMKalA#samAxeSa_SrqMKalA#noun#2#RM
command_function	samAxeSa_prakArya#samAxeSa_prakArya#noun#2#RM
command_interpreter	samAxeSa_nirvacaka#samAxeSa_nirvacaka#noun#2#RM
command_list	samAxeSa_sUci#samAxeSa_sUci#noun#2#RM
command_processing	samAxeSa_saMsAXana#samAxeSa_saMsAXana#noun#2#RM
command_retry	samAxeSa_puna:_prayAsa#samAxeSa_puna:_prayAsa#noun#2#RM
comment_statement	tippaNI_kaWana#tippaNI_kaWana#noun#2#RM
commercial_application	vANijya_anuprayoga#vANijya_anuprayoga#noun#2#RM
common_block	sArva_KaMdaka#sArva_KaMdaka#noun#2#RM
common_business_orientedcobollanguage	sAXAraNa_vyavasAyamUlaka(kobola)BARA#sAXAraNa_vyavasAyamUlaka(kobola)BARA#noun#3#RM
common_carrier	sArva_vAhaka#sArva_vAhaka#noun#2#RM
common_control	sArva_niyaMwraNa#sArva_niyaMwraNa#noun#2#RM
common_error	sArva_wruti#sArva_wruti#noun#2#RM
common_language	sArva_BARA#sArva_BARA#noun#2#RM
common_routine	sArva_nemakA#sArva_nemakA#noun#2#RM
common_storage_area	sArva_BaMdAraNa_kRewra#sArva_BaMdAraNa_kRewra#noun#3#RM
communication_center	saMcAra_kenxra#saMcAra_kenxra#noun#2#RM
communication_channel	saMcAra_praNAla#saMcAra_praNAla#noun#2#RM
communication_common_carrier	saMcAra_sArvavAhaka#saMcAra_sArvavAhaka#noun#3#RM
communication_computer	saMcAra_aBikaliwra#saMcAra_aBikaliwra#noun#2#RM
communication_control_unit	saMcAra_niyaMwraka_ekaka#saMcAra_niyaMwraka_ekaka#noun#3#RM
communication_controller	saMcAra_niyaMwraNa#saMcAra_niyaMwraNa#noun#2#RM
communication_controller_node	saMcAra_niyaMwraka_AsaMXi#saMcAra_niyaMwraka_AsaMXi#noun#3#RM
communication_interface	saMcAra_aMwarApqRTa#saMcAra_aMwarApqRTa#noun#2#RM
communication_line	saMcAra_lAina#saMcAra_lAina#noun#2#RM
communication_link	saMcAra_kadI#saMcAra_kadI#noun#2#RM
communication_modem	saMcAra_modema#saMcAra_modema#noun#2#RM
communication_network	saMcAra_jAlakrama#saMcAra_jAlakrama#noun#2#RM
communication_satelite	saMcAra_upagraha#saMcAra_upagraha#noun#2#RM
communication_software	saMcAra_prakriyA_sAmagrI#saMcAra_prakriyA_sAmagrI#noun#2#RM
communication_terminal	saMcAra_aMwaka#saMcAra_aMwaka#noun#2#RM
community_dial_office	samuxAya_dAyala_kAryAlaya#samuxAya_dAyala_kAryAlaya#noun#3#RM
companion_store_back_up	sahacara_BaMdAra_pUrwikara#sahacara_BaMdAra_pUrwikara#noun#4#RM
comparison_operation	wulanA_saMkriyA#wulanA_saMkriyA#noun#2#RM
compatible_time_sharing_system	susaMgawa_kAla_BAgI_waMwra#susaMgawa_kAla_BAgI_waMwra#noun#4#RM
compile_duration	anuBARaNa_avaXi#anuBARaNa_avaXi#noun#2#RM
compile_time	anuBARaNa_kAla#anuBARaNa_kAla#noun#2#RM
compiler_inerface	anuBARaka_aMwarA_pqRTa#anuBARaka_aMwarA_pqRTa#noun#2#RM
compiling_program	anuBARaka#anuBARaka#noun#2#RM
complementary_operation	pUraka_saMkriyA#pUraka_saMkriyA#noun#2#RM
complete_operation	saMpUrNa_saMkriyA#saMpUrNa_saMkriyA#noun#2#RM
complex_costant	sammiSra_acara#sammiSra_acara#noun#2#RM
complex_data_type	sammiSra_AMkadA_prakAra#sammiSra_AMkadA_prakAra#noun#3#RM
complexity_theory	jatilawA_sixXAMwa#jatilawA_sixXAMwa#noun#2#RM
compliment_on_one	ekapUraka#ekapUraka#noun#3#RM
compliment_on_ten	xasapUraka#xasapUraka#noun#3#RM
compliment_on_two	xopUraka#xopUraka#noun#3#RM
complimented_number_system	pUrakiwa_saMKyA_paxXawi#pUrakiwa_saMKyA_paxXawi#noun#3#RM
composit_module_data_set	saMyukwa_prawirUpaka_AMkadA_samucca#saMyukwa_prawirUpaka_AMkadA_samucca#noun#4#RM
composited_circuit	saMyojI_paripaWa#saMyojI_paripaWa#noun#2#RM
compound_condition	saMyukwa_prawibaMXa#saMyukwa_prawibaMXa#noun#2#RM
compound_statement	saMyukwa_kaWana#saMyukwa_kaWana#noun#2#RM
computational_complexity	aBikalanAwmaka_jatilawA#aBikalanAwmaka_jatilawA#noun#2#RM
computational_model	aBikalanAwmaka_nixarSa#aBikalanAwmaka_nixarSa#noun#2#RM
computer_aided_design	aBikaliwra_sahAya_aBikalpanA#aBikaliwra_sahAya_aBikalpanA#noun#3#RM
computer_aided_engineering	aBikaliwra_sahAya_iMjiniyariMga#aBikaliwra_sahAya_iMjiniyariMga#noun#3#RM
computer_aided_manufacture	aBikaliwra_sahAya_nirmANa#aBikaliwra_sahAya_nirmANa#noun#3#RM
computer_architecture	aBikaliwra_sWApawya_kalA#aBikaliwra_sWApawya_kalA#noun#2#RM
computer_arithmatic	aBikaliwrIya_aMkagaNiwa#aBikaliwrIya_aMkagaNiwa#noun#2#RM
computer_assisted_education	aBikaliwra_sahAyiwa_SikRA#aBikaliwra_sahAyiwa_SikRA#noun#3#RM
computer_assisted_instruction	aBikaliwra_sahAyiwa_anuxeSa#aBikaliwra_sahAyiwa_anuxeSa#noun#3#RM
computer_assisted_learning	aBikaliwra_sahAyiwa_aXigama#aBikaliwra_sahAyiwa_aXigama#noun#3#RM
computer_assisted_management	aBikaliwra_sahAyiwa_prabaMXa#aBikaliwra_sahAyiwa_prabaMXa#noun#3#RM
computer_assisted_teaching	aBikaliwra_sahAyiwa_SikRaNa#aBikaliwra_sahAyiwa_SikRaNa#noun#3#RM
computer_based_automation	aBikaliwra_aXAriwa_svacAlana#aBikaliwra_aXAriwa_svacAlana#noun#3#RM
computer_based_education	aBikaliwra_AXAriwa_SikRA#aBikaliwra_AXAriwa_SikRA#noun#3#RM
computer_based_learning	aBikaliwra_AXAriwa_aBigama#aBikaliwra_AXAriwa_aBigama#noun#3#RM
computer_circuitry	aBikaliwra_paripaWikI#aBikaliwra_paripaWikI#noun#2#RM
computer_code	aBikaliwra_kUta#aBikaliwra_kUta#noun#2#RM
computer_communication	aBikaliwra_saMcAra#aBikaliwra_saMcAra#noun#2#RM
computer_conferencing	aBikaliwra_mUlaka_sammelana#aBikaliwra_mUlaka_sammelana#noun#2#RM
computer_console	aBikaliwra_kansola#aBikaliwra_kansola#noun#2#RM
computer_crime	aBikaliwrIya_aparAXa#aBikaliwrIya_aparAXa#noun#2#RM
computer_cryptography	aBikaliwrIya_gUDaleKana#aBikaliwrIya_gUDaleKana#noun#2#RM
computer_expert	aBikaliwra_viSeRajFa#aBikaliwra_viSeRajFa#noun#2#RM
computer_game	aBikaliwra_Kela#aBikaliwra_Kela#noun#2#RM
computer_generation	aBikaliwra_pIDI#aBikaliwra_pIDI#noun#2#RM
computer_graphics	aBikaliwra_AleKikI#aBikaliwra_AleKikI#noun#2#RM
computer_hardware	aBikaliwra_yaMwra_sAmagrI#aBikaliwra_yaMwra_sAmagrI#noun#2#RM
computer_instruction	aBikaliwra_anuxeSa#aBikaliwra_anuxeSa#noun#2#RM
computer_instruction_code	aBikaliwra_anuxeSa_kUta#aBikaliwra_anuxeSa_kUta#noun#3#RM
computer_instruction_set	aBikaliwra_anuxeSa_samucca#aBikaliwra_anuxeSa_samucca#noun#3#RM
computer_interface_unit	aBikaliwra_aMwarApqRTa_ekaka#aBikaliwra_aMwarApqRTa_ekaka#noun#3#RM
computer_language	aBikaliwra_BARA#aBikaliwra_BARA#noun#2#RM
computer_language_symbol	aBikaliwra_BARA_prawIka#aBikaliwra_BARA_prawIka#noun#3#RM
computer_learning	aBikaliwra_aXigama#aBikaliwra_aXigama#noun#2#RM
computer_maintainance	aBikaliwra_anurakRaNa#aBikaliwra_anurakRaNa#noun#2#RM
computer_music	aBikaliwra_saMgIwa#aBikaliwra_saMgIwa#noun#2#RM
computer_network	aBikaliwra_jAlakrama#aBikaliwra_jAlakrama#noun#2#RM
computer_operation	aBikaliwra_saMkriyA#aBikaliwra_saMkriyA#noun#2#RM
computer_oriented_language	aBikaliwra_mUlaka_BARA#aBikaliwra_mUlaka_BARA#noun#3#RM
computer_output	aBikaliwra_nirgama#aBikaliwra_nirgama#noun#2#RM
computer_output_microfilm	aBikaliwra_mUlaka_sUkRmaPilma#aBikaliwra_mUlaka_sUkRmaPilma#noun#3#RM
computer_performance	aBikaliwra_niRpAxana#aBikaliwra_niRpAxana#noun#2#RM
computer_printer	aBikaliwra_muxriwra#aBikaliwra_muxriwra#noun#2#RM
computer_programme	aBikaliwra_kramAxeSa#aBikaliwra_kramAxeSa#noun#2#RM
computer_science	aBikaliwra_vijFAna#aBikaliwra_vijFAna#noun#2#RM
computer_security	aBikaliwra_surakRA#aBikaliwra_surakRA#noun#2#RM
computer_simulation	aBikaliwra_anukaraNa#aBikaliwra_anukaraNa#noun#2#RM
computer_software	aBikaliwra_prakriyA_sAmagrI#aBikaliwra_prakriyA_sAmagrI#noun#2#RM
computer_specialist	aBikaliwra_viSeRajFa#aBikaliwra_viSeRajFa#noun#2#RM
computer_system	aBikaliwra_waMwra#aBikaliwra_waMwra#noun#2#RM
computer_technology	aBikaliwra_prOxyOgikI#aBikaliwra_prOxyOgikI#noun#2#RM
computer_terminal	aBikaliwra_aMwaka#aBikaliwra_aMwaka#noun#2#RM
computer_time	aBikaliwra_kAla#aBikaliwra_kAla#noun#2#RM
computer_word	aBikaliwra_Sabxa#aBikaliwra_Sabxa#noun#2#RM
computering_centre	aBikalana_kenxra#aBikalana_kenxra#noun#2#RM
computering_power	aBikalana_kRamawA#aBikalana_kRamawA#noun#2#RM
computering_system	aBikalana_waMwra#aBikalana_waMwra#noun#2#RM
concatenated_data_set	saMSrqMKaliwa_AMkadA_samuccaya#saMSrqMKaliwa_AMkadA_samuccaya#noun#3#RM
conceptual_model	saMkalpanAwmaka_nixarSa#saMkalpanAwmaka_nixarSa#noun#2#RM
concurrent_processing	saMgAmI_saMsAXana#saMgAmI_saMsAXana#noun#2#RM
condition_prefix	prawibaMXa_pUrva_lagna#prawibaMXa_pUrva_lagna#noun#2#RM
conditional_assembly_instruction	prawibaMXI_kodAMwaraNa_anuxeSa#prawibaMXI_kodAMwaraNa_anuxeSa#noun#3#RM
conditional_branch_instruction	prawibaMXI_SAKA_anuxeSa#prawibaMXI_SAKA_anuxeSa#noun#3#RM
conditional_expression	prawibaMXI_vyaMjaka#prawibaMXI_vyaMjaka#noun#2#RM
conditional_jump	prawibaMXI_JaMpa#prawibaMXI_JaMpa#noun#2#RM
conditional_jump_instruction	prawibaMXI_JaMpa_anuxeSa#prawibaMXI_JaMpa_anuxeSa#noun#3#RM
conditional_statemant	prawibaMXI_kaWana#prawibaMXI_kaWana#noun#2#RM
conditional_transfer_instruction	prawibaMXI_sWAnAMwaraNa_anuxeSa#prawibaMXI_sWAnAMwaraNa_anuxeSa#noun#3#RM
conditional_variable	prawibaMXI_cara#prawibaMXI_cara#noun#2#RM
confidence_level	viSvasyawA_swara#viSvasyawA_swara#noun#2#RM
connected_storage	saMbaxXa_BaMdArana#saMbaxXa_BaMdArana#noun#2#RM
consecutive_operation	kramAgawa_saMkriyA#kramAgawa_saMkriyA#noun#2#RM
consistency_check	saMgawi_jAMca#saMgawi_jAMca#noun#2#RM
constant_area	acara_kRewra#acara_kRewra#noun#2#RM
constant_length_field	acara_laMbAI_kRewra#acara_laMbAI_kRewra#noun#3#RM
context_free_language	saMxarBa_mukwa_BARA#saMxarBa_mukwa_BARA#noun#3#RM
context_sensitive_language	saMxarBa_saMvexI_BARA#saMxarBa_saMvexI_BARA#noun#3#RM
continous_process_control	saMwawa_prakrama_niyaMwraNa#saMwawa_prakrama_niyaMwraNa#noun#3#RM
continous_system_simulation_language	saMwawa_waMwra_anukaraNa_BARA#saMwawa_waMwra_anukaraNa_BARA#noun#4#RM
continuation_card	sAMwawya_pawraka#sAMwawya_pawraka#noun#2#RM
continuity_check	sAMwawya_jAMca#sAMwawya_jAMca#noun#2#RM
control_block	niyaMwraNa_KaMdaka#niyaMwraNa_KaMdaka#noun#2#RM
control_bus	niyaMwraNa_basa#niyaMwraNa_basa#noun#2#RM
control_card	niyaMwraka_pawraka#niyaMwraka_pawraka#noun#2#RM
control_character	niyaMwraNa_saMprawIka#niyaMwraNa_saMprawIka#noun#2#RM
control_cycle	niyaMwraNa_cakra#niyaMwraNa_cakra#noun#2#RM
control_data	niyaMwraNa_AMkade#niyaMwraNa_AMkade#noun#2#RM
control_field	niyaMwraNa_kRewra#niyaMwraNa_kRewra#noun#2#RM
control_function	niyaMwraNa_Palana#niyaMwraNa_Palana#noun#2#RM
control_instruction	niyaMwraNa_anuxeSa#niyaMwraNa_anuxeSa#noun#2#RM
control_line	niyaMwraNa_lAina#niyaMwraNa_lAina#noun#2#RM
control_micro_programming	niyaMwraNa_sUkRma_kramAxeSa#niyaMwraNa_sUkRma_kramAxeSa#noun#3#RM
control_operators_terminal	niyaMwraNa_pracAlaka_aMwaka#niyaMwraNa_pracAlaka_aMwaka#noun#3#RM
control_panel	niyaMwraNa_pattikA#niyaMwraNa_pattikA#noun#2#RM
control_point	niyaMwraNa_viMxu#niyaMwraNa_viMxu#noun#2#RM
control_printing	niyaMwraNa_muxraNa#niyaMwraNa_muxraNa#noun#2#RM
control_program	niyaMwraNa_kramAxeSa#niyaMwraNa_kramAxeSa#noun#2#RM
control_register	niyaMwraNa_paMjI#niyaMwraNa_paMjI#noun#2#RM
control_sequence	niyaMwraNa_anukrama#niyaMwraNa_anukrama#noun#2#RM
control_station	niyaMwraNa_kenxra#niyaMwraNa_kenxra#noun#2#RM
control_switch	niyaMwraNa_svica#niyaMwraNa_svica#noun#2#RM
control_system	niyaMwraNa_waMwra#niyaMwraNa_waMwra#noun#2#RM
control_technique	niyaMwraNa_wakanIka#niyaMwraNa_wakanIka#noun#2#RM
control_transfer_statement	niyaMwraNa_sWAnAMwaraNa_kaWana#niyaMwraNa_sWAnAMwaraNa_kaWana#noun#3#RM
control_unit	niyaMwraNa_ekaka#niyaMwraNa_ekaka#noun#2#RM
controlled_storage_allocation	niyaMwriwa_BaMdAraNa_niyawana#niyaMwriwa_BaMdAraNa_niyawana#noun#3#RM
controlled_variable	niyaMwriwa_cara#niyaMwriwa_cara#noun#2#RM
conversational_algebric_language	saMvAxI_bIjIya_BARA#saMvAxI_bIjIya_BARA#noun#3#RM
conversational_computing	saMvAxI_aBikalana#saMvAxI_aBikalana#noun#2#RM
conversational_language	saMvAxI_BARA#saMvAxI_BARA#noun#2#RM
conversion_device	rUpAMwaraNa_yukwi#rUpAMwaraNa_yukwi#noun#2#RM
conversion_mode	rUpAMwaraNa_viXA#rUpAMwaraNa_viXA#noun#2#RM
coordinate_addressed_memory	nirxeSAMka_pawA_smqwi#nirxeSAMka_pawA_smqwi#noun#3#RM
coordinate_geomatry_language	nirxeSAMka_jyAmiwi_BARA#nirxeSAMka_jyAmiwi_BARA#noun#3#RM
coordinate_graphics	nirxeSAMka_AleKikI#nirxeSAMka_AleKikI#noun#2#RM
coputer_art	aBikaliwra_kalA#aBikaliwra_kalA#noun#2#RM
core_dump	kroda_sannikRepa#kroda_sannikRepa#noun#2#RM
core_image	kroda_prawibimba#kroda_prawibimba#noun#2#RM
core_memory	kroda_smqwi#kroda_smqwi#noun#2#RM
cost_analysis	lAgawa_viSleRaNa#lAgawa_viSleRaNa#noun#2#RM
country_code	xeSakUta#xeSakUta#noun#2#RM
critical_path_method	krAMwika_paWa_viXi#krAMwika_paWa_viXi#noun#3#RM
cross_bar_switch	krAsa_bAra_svica#krAsa_bAra_svica#noun#3#RM
cross_check	wiryaka_jAMca#wiryaka_jAMca#noun#2#RM
cross_compiler	vyawi_anuBARaka#vyawi_anuBARaka#noun#2#RM
cross_fire	aprAsaMgika_signala#aprAsaMgika_signala#noun#2#RM
cross_sectional_testing	anuparicCexa_parikRaNa#anuparicCexa_parikRaNa#noun#3#RM
cross_talk	aprAsaMgika_signala#aprAsaMgika_signala#noun#2#RM
cryptographic_algorithm	gUDAleKI_kalana_viXi#gUDAleKI_kalana_viXi#noun#2#RM
current_beam_position	XArApuMja_sWiwi#XArApuMja_sWiwi#noun#3#RM
current_instruction_register	varwamAna_anuxeSa_paMjI#varwamAna_anuxeSa_paMjI#noun#3#RM
current_loop	XArA_praspaMxa#XArA_praspaMxa#noun#2#RM
cursor_control_key	prasaMkewaka_niyaMwraNa_kuMjI#prasaMkewaka_niyaMwraNa_kuMjI#noun#3#RM
customer_information_control_system	grAhaka_sUcanA_niyaMwraNa_waMwra#grAhaka_sUcanA_niyaMwraNa_waMwra#noun#4#RM
cut_off	vicCexana#vicCexana#noun#2#RM
cycle_shift	cakrIya_visWApana#cakrIya_visWApana#noun#2#RM
cycle_time	cakra_kAla#cakra_kAla#noun#2#RM
daisy_chain	dejI_SrqMKalA#dejI_SrqMKalA#noun#2#RM
daisy_print_wheel	dejI_muxraNa_cakra#dejI_muxraNa_cakra#noun#3#RM
daisy_wheel	dejI_cakra#dejI_cakra#noun#2#RM
data_acquisition	AMkadA_arjana#AMkadA_arjana#noun#2#RM
data_acquisition_computer	AMkadA_arjana_aBikaliwra#AMkadA_arjana_aBikaliwra#noun#3#RM
data_admainistrator	AMkadA_praSAsaka#AMkadA_praSAsaka#noun#2#RM
data_area	AMkadA_kRewra#AMkadA_kRewra#noun#2#RM
data_array	AMkadA_saraNI#AMkadA_saraNI#noun#2#RM
data_attribute	AMkadA_guNa#AMkadA_guNa#noun#2#RM
data_bank	AMkadA_bEMka#AMkadA_bEMka#noun#2#RM
data_block	AMkadA_KaMdaka#AMkadA_KaMdaka#noun#2#RM
data_buffer_register	AMkadA_cayaka_paMjI#AMkadA_cayaka_paMjI#noun#3#RM
data_capture	AMkadA_pragrahaNa#AMkadA_pragrahaNa#noun#2#RM
data_channel	AMkadA_praNAla#AMkadA_praNAla#noun#2#RM
data_circuit	AMkadA_paripaWa#AMkadA_paripaWa#noun#2#RM
data_collection	AMkadA_saMgraha#AMkadA_saMgraha#noun#2#RM
data_communication	AMkadA_saMcAra#AMkadA_saMcAra#noun#2#RM
data_communication_equipment	AMkadA_saMcAra_upakaraNa#AMkadA_saMcAra_upakaraNa#noun#3#RM
data_communication_network	AMkadA_saMcAra_jAlakrama#AMkadA_saMcAra_jAlakrama#noun#3#RM
data_compression	AMkadA_saMpIdana#AMkadA_saMpIdana#noun#2#RM
data_control	AMkadA_niyaMwraNa#AMkadA_niyaMwraNa#noun#2#RM
data_control_block	AMkadA_niyaMwraNa_KaMdaka#AMkadA_niyaMwraNa_KaMdaka#noun#3#RM
data_conversion	AMkadA_rUpAMwaraNa#AMkadA_rUpAMwaraNa#noun#2#RM
data_declaration_statement	AMkadA_GoRaNA_kaWana#AMkadA_GoRaNA_kaWana#noun#3#RM
data_definition	AMkadA_pariBARA#AMkadA_pariBARA#noun#2#RM
data_dictionary	AMkadA_koRa#AMkadA_koRa#noun#2#RM
data_display_unit	AMkadA_praxarSa_ekaka#AMkadA_praxarSa_ekaka#noun#3#RM
data_distribution_system	AMkadA_viwaraNa_waMwra#AMkadA_viwaraNa_waMwra#noun#3#RM
data_element	AMkadA_avayava#AMkadA_avayava#noun#2#RM
data_entegrity	AMkadA_SuciwA#AMkadA_SuciwA#noun#2#RM
data_entry	AMkadA_praviRti#AMkadA_praviRti#noun#2#RM
data_entry_device	AMkadA_praviRti_yukwi#AMkadA_praviRti_yukwi#noun#3#RM
data_error	AMkadA_wruti#AMkadA_wruti#noun#2#RM
data_examination	AMkadA_parIkRaNa#AMkadA_parIkRaNa#noun#2#RM
data_field	AMkadA_kRewra#AMkadA_kRewra#noun#2#RM
data_file	AMkadA_saMcikA#AMkadA_saMcikA#noun#2#RM
data_flow	AMkadA_pravAha#AMkadA_pravAha#noun#2#RM
data_flow_chart	AMkadA_pravAha_saMciwra#AMkadA_pravAha_saMciwra#noun#3#RM
data_flow_dagram	AMkadA_pravAha_AreKa#AMkadA_pravAha_AreKa#noun#3#RM
data_format	AMkadA_saMrUpa#AMkadA_saMrUpa#noun#2#RM
data_handling_capacity	AMkadA_haswana_kRamawA#AMkadA_haswana_kRamawA#noun#3#RM
data_i/o_instruction	AMkadA_ni/ni_anuxeSa#AMkadA_ni/ni_anuxeSa#noun#3#RM
data_incryption_key	AMkadA_gUDaleKana_kuMjI#AMkadA_gUDaleKana_kuMjI#noun#3#RM
data_independence	AMkadA_svawaMwrawA#AMkadA_svawaMwrawA#noun#2#RM
data_item	AMkadA_maMxa#AMkadA_maMxa#noun#2#RM
data_library	AMkadA_kramAxeSa_saMgraha#AMkadA_kramAxeSa_saMgraha#noun#2#RM
data_link_layer	AMkadA_kadI_parawa#AMkadA_kadI_parawa#noun#3#RM
data_management	AMkadA_prabaMXa#AMkadA_prabaMXa#noun#2#RM
data_management_system	AMkadA_prabaMXa_paxXawi#AMkadA_prabaMXa_paxXawi#noun#3#RM
data_manipulating	AMkadA_prakalana#AMkadA_prakalana#noun#2#RM
data_masking	AMkadA_AcCAxana#AMkadA_AcCAxana#noun#2#RM
data_migration	AMkadA_pravAsa#AMkadA_pravAsa#noun#2#RM
data_move_instruction	AMkadA_cAla_anuxeSa#AMkadA_cAla_anuxeSa#noun#3#RM
data_origination	AMkadA_uxagamIkaraNa#AMkadA_uxagamIkaraNa#noun#2#RM
data_output	AMkadA_nirgama#AMkadA_nirgama#noun#2#RM
data_phone	detAPona#detAPona#noun#2#RM
data_processing	AMkadA_saMsAXana#AMkadA_saMsAXana#noun#2#RM
data_processing_centre	AMkadA_saMsAXana_kenxra#AMkadA_saMsAXana_kenxra#noun#3#RM
data_processing_machine	AMkadA_saMsAXana_yaMwra#AMkadA_saMsAXana_yaMwra#noun#3#RM
data_processing_station	AMkadA_saMsAXana_kenxra#AMkadA_saMsAXana_kenxra#noun#3#RM
data_protection	AMkadA_rakRaNa#AMkadA_rakRaNa#noun#2#RM
data_record	AMkadA_aBileKa#AMkadA_aBileKa#noun#2#RM
data_register	AMkadA_paMjI#AMkadA_paMjI#noun#2#RM
data_retrieval	AMkadA_prawinayana#AMkadA_prawinayana#noun#2#RM
data_security	AMkadA_surakRA#AMkadA_surakRA#noun#2#RM
data_set	AMkadA_samuccaya#AMkadA_samuccaya#noun#2#RM
data_set_organisation	AMkadA_samuccaya_saMgaTana#AMkadA_samuccaya_saMgaTana#noun#3#RM
data_signal	AMkadA_saMkewa#AMkadA_saMkewa#noun#2#RM
data_sink	AMkadA_aBigama#AMkadA_aBigama#noun#2#RM
data_source	AMkadA_srowa#AMkadA_srowa#noun#2#RM
data_structure	AMkadA_saMracanA#AMkadA_saMracanA#noun#2#RM
data_switching_centre	AMkadA_svicana#AMkadA_svicana#noun#3#RM
data_terminal_equipment	AMkadA_aMwaka_upakaraNa#AMkadA_aMwaka_upakaraNa#noun#3#RM
data_transcription	AMkadA_anuleKana#AMkadA_anuleKana#noun#2#RM
data_transfer	AMkadA_sWAnAMwaraNa#AMkadA_sWAnAMwaraNa#noun#2#RM
data_transfer_rate	AMkadA_sWAnAMwaraNa_xara#AMkadA_sWAnAMwaraNa_xara#noun#3#RM
data_transmission_channel	AMkadA_saMcaraNa_praNAlI#AMkadA_saMcaraNa_praNAlI#noun#3#RM
data_type	AMkadA_prakAra#AMkadA_prakAra#noun#2#RM
data_unit	AMkadA_ekaka#AMkadA_ekaka#noun#2#RM
database_administration	AMkadA_saMcaya_praSAsana#AMkadA_saMcaya_praSAsana#noun#2#RM
database_management	AMkadA_saMcaya_prabaMXa#AMkadA_saMcaya_prabaMXa#noun#2#RM
database_management_system	AMkadA_saMcaya_prabaMXa_paxXawi#AMkadA_saMcaya_prabaMXa_paxXawi#noun#3#RM
datagram_service	AMkadAreKa_sevA#AMkadAreKa_sevA#noun#2#RM
debug_statement	xoRamArjana_kaWana#xoRamArjana_kaWana#noun#2#RM
debugging_output	xoRamArjana_nirgama#xoRamArjana_nirgama#noun#2#RM
decimal_digit	xaSamalava_aMka#xaSamalava_aMka#noun#2#RM
decimal_numeral	xaSamalava_saMKyAMka#xaSamalava_saMKyAMka#noun#2#RM
decision_language	nirNaya_BARA#nirNaya_BARA#noun#2#RM
decision_table	nirNaya_sAraNI#nirNaya_sAraNI#noun#2#RM
decision_table_language	nirNaya_sAraNI_BARA#nirNaya_sAraNI_BARA#noun#3#RM
decoding_instruction	kUtavAcana_anuxeSa#kUtavAcana_anuxeSa#noun#2#RM
dedicated_channel	samarpiwa_praNAla#samarpiwa_praNAla#noun#2#RM
dedicated_circuit	samarpiwa_paripaWa#samarpiwa_paripaWa#noun#2#RM
dedicated_line	samarpiwa_lAina#samarpiwa_lAina#noun#2#RM
default_option	vyawikrama_vikalpa#vyawikrama_vikalpa#noun#2#RM
default_value	vyawikrama_mAna#vyawikrama_mAna#noun#2#RM
deflection_plate	vikRepaNa_pleta#vikRepaNa_pleta#noun#2#RM
degree_of_multi_programming	bahukramAxeSana_koti#bahukramAxeSana_koti#noun#4#RM
delay_counter	vilamba_gaNiwra#vilamba_gaNiwra#noun#2#RM
delay_element	vilamba_avayava#vilamba_avayava#noun#2#RM
delay_line	vilamba_lAina#vilamba_lAina#noun#2#RM
delete_character	vilopa_saMprawIka#vilopa_saMprawIka#noun#2#RM
delete_key	vilopa_kuMjI#vilopa_kuMjI#noun#2#RM
delivery_time	praxAna_kAla#praxAna_kAla#noun#2#RM
delta_modulation	deltA_mAdulana#deltA_mAdulana#noun#2#RM
demand_paging	mAMga_pqRTana#mAMga_pqRTana#noun#2#RM
demographic_application	janasAMKyikIya_anuprayoga#janasAMKyikIya_anuprayoga#noun#2#RM
dependency_theory	ASriwawA_sixXAMwa#ASriwawA_sixXAMwa#noun#2#RM
dependent_unit	ASriwa_ekaka#ASriwa_ekaka#noun#2#RM
descending_sort	avarohI_SAtana#avarohI_SAtana#noun#2#RM
desision_box	nirNaya_koRTa#nirNaya_koRTa#noun#2#RM
desk_calculator	deska_parikaliwra#deska_parikaliwra#noun#2#RM
desk_top_computer	deska_aBikaliwra#deska_aBikaliwra#noun#3#RM
destination_address	gaMwabya_pawA#gaMwabya_pawA#noun#2#RM
destination_file	gaMwabya_saMcikA#gaMwabya_saMcikA#noun#2#RM
destructive_read	vinASI_paTana#vinASI_paTana#noun#2#RM
deterministic_automata	nirXAraNAwmaka_svacala_prarUpa#nirXAraNAwmaka_svacala_prarUpa#noun#2#RM
deterministic_model	nirXAraNAwmaka_nixarSa#nirXAraNAwmaka_nixarSa#noun#2#RM
deterministic_process	nirXAraNAwmaka_prakrama#nirXAraNAwmaka_prakrama#noun#2#RM
deterministic_programming	nirXAraNAwmaka_kramAxeSa#nirXAraNAwmaka_kramAxeSa#noun#2#RM
development_system	vikAsa_waMwra#vikAsa_waMwra#noun#2#RM
development_tool	vikAsa_upakaraNa#vikAsa_upakaraNa#noun#2#RM
device_backup	yukwi_pUrwikara#yukwi_pUrwikara#noun#2#RM
device_control_unit	yukwi_niyaMwraNa_ekaka#yukwi_niyaMwraNa_ekaka#noun#3#RM
device_controller	yukwi_niyaMwraka#yukwi_niyaMwraka#noun#2#RM
device_media_control_language	yukwi_mAXyama_niyaMwraNa_BARA#yukwi_mAXyama_niyaMwraNa_BARA#noun#4#RM
device_queue	yukwi_paMkwi#yukwi_paMkwi#noun#2#RM
diagnostic_check	nixAnArWa_jAMca#nixAnArWa_jAMca#noun#2#RM
diagnostic_message	nixAna_saMxeSa#nixAna_saMxeSa#noun#2#RM
diagnostic_program	nixAna_kramAxeSa#nixAna_kramAxeSa#noun#2#RM
diagnostic_test	nixAnArWa_parIkRaNa#nixAnArWa_parIkRaNa#noun#2#RM
dial_exchange	dAyala_kenxra#dAyala_kenxra#noun#2#RM
dial_plus	dAyala_spaMxa#dAyala_spaMxa#noun#2#RM
dial_tone	dAyala_tona#dAyala_tona#noun#2#RM
dial_up	dAyalana#dAyalana#noun#2#RM
difference_engine	aMwara_iMjana#aMwara_iMjana#noun#2#RM
difference_operation	aMwara_saMkriyA#aMwara_saMkriyA#noun#2#RM
differential_modulation	pUrvASriwa_mAdulana#pUrvASriwa_mAdulana#noun#2#RM
digit_position	aMkasWiwi#aMkasWiwi#noun#2#RM
digit_to_analog_conversion	aMka_se_anurUpa_rUpAMwaraNa#aMka_se_anurUpa_rUpAMwaraNa#noun#4#RM
digital_block	aMkIya_KaMdaka#aMkIya_KaMdaka#noun#2#RM
digital_carrier_system	aMkIya_vAhaka_waMwra#aMkIya_vAhaka_waMwra#noun#3#RM
digital_computer	aMkIya_aBikaliwra#aMkIya_aBikaliwra#noun#2#RM
digital_filter	aMkIya_niRyaMxaka#aMkIya_niRyaMxaka#noun#2#RM
digital_multiplex_equipment	aMkIya_bahusaMkewana_upakaraNa#aMkIya_bahusaMkewana_upakaraNa#noun#3#RM
digital_optical_recording	aMkIya_prakASikIya_aBileKana#aMkIya_prakASikIya_aBileKana#noun#3#RM
digital_picture	aMkIya_ciwra#aMkIya_ciwra#noun#2#RM
digital_recorder	aMkIya_aBileKiwra#aMkIya_aBileKiwra#noun#2#RM
digital_signal	aMkIya_saMkewa#aMkIya_saMkewa#noun#2#RM
digital_switching	aMkIya_svicana#aMkIya_svicana#noun#2#RM
digital_to_analog_converter	aMka_se_anurUpa_rUpAMwariwra#aMka_se_anurUpa_rUpAMwariwra#noun#4#RM
dipole_antena	xviXruvI_eMtenA#xviXruvI_eMtenA#noun#2#RM
direct_access	prawyakRa_aBigama#prawyakRa_aBigama#noun#2#RM
direct_access_method	prawyakRa_aBigama_viXi#prawyakRa_aBigama_viXi#noun#3#RM
direct_access_storage	prawyakRa_aBigama_BaMdAraNa#prawyakRa_aBigama_BaMdAraNa#noun#3#RM
direct_address	prawyakRa_pawA#prawyakRa_pawA#noun#2#RM
direct_addressing	prawyakRa_pawABigamana#prawyakRa_pawABigamana#noun#2#RM
direct_coupling	prawyakRa_yugmana#prawyakRa_yugmana#noun#2#RM
direct_distance_dialling	prawyakRa_xUrI_dAyalana#prawyakRa_xUrI_dAyalana#noun#3#RM
direct_keying_device	prawyakRa_puMjIyana_yukwi#prawyakRa_puMjIyana_yukwi#noun#3#RM
direct_memory_access	prawyakRa_smqwi_aBigama#prawyakRa_smqwi_aBigama#noun#3#RM
direct_transmission_satelite	prawyakRa_saMcarana_upagraha#prawyakRa_saMcarana_upagraha#noun#3#RM
directed_beam_scan	xiRta_puMca_kramavIkRaNa#xiRta_puMca_kramavIkRaNa#noun#3#RM
directed_graph	xiRta_AleKa#xiRta_AleKa#noun#2#RM
directional_coupler	xiSika_yugmaka#xiSika_yugmaka#noun#2#RM
directory_device	nirxeSikA_yukwi#nirxeSikA_yukwi#noun#2#RM
disabling_signal	asamarWakArI_saMkewa#asamarWakArI_saMkewa#noun#2#RM
disaster_dump	vinASI_sannikRepa#vinASI_sannikRepa#noun#2#RM
discrete_data	asaMwawa_AMkade#asaMwawa_AMkade#noun#2#RM
discrete_device	asaMwawa_yukwi#asaMwawa_yukwi#noun#2#RM
discrete_representation	asaMwawa_nirUpaNa#asaMwawa_nirUpaNa#noun#2#RM
disk_accessing	cakrikA_aBigamana#cakrikA_aBigamana#noun#2#RM
disk_based_operating_system	cakrikA_AXAriwa_pracAlana_waMwra#cakrikA_AXAriwa_pracAlana_waMwra#noun#4#RM
disk_controller_card	cakrikA_niyaMwraka_pawraka#cakrikA_niyaMwraka_pawraka#noun#3#RM
disk_file	cakrikA_saMcikA#cakrikA_saMcikA#noun#2#RM
disk_operating_system	cakrikA_pracAlana_waMwra#cakrikA_pracAlana_waMwra#noun#3#RM
disk_pack	cakrikA_saMkula#cakrikA_saMkula#noun#2#RM
disk_sector	cakrikA_kRewraka#cakrikA_kRewraka#noun#2#RM
disk_storage	cakrikA_BaMdAraNa#cakrikA_BaMdAraNa#noun#2#RM
disk_storage_device	cakrikA_BaMdAraNa_yukwi#cakrikA_BaMdAraNa_yukwi#noun#3#RM
disk_unit	cakrikA_ekaka#cakrikA_ekaka#noun#2#RM
disk_volume	cakrikA_saMkula#cakrikA_saMkula#noun#2#RM
diskette_formatted_tape	namyikA_saMrUpiwa_tepa#namyikA_saMrUpiwa_tepa#noun#3#RM
diskette_storage	namyikA_BaMdAraNa#namyikA_BaMdAraNa#noun#2#RM
diskette_storage_device	namyikA_BaMdAraNa_yukwi#namyikA_BaMdAraNa_yukwi#noun#3#RM
display_attribute	praxarSa_guNa#praxarSa_guNa#noun#2#RM
display_command	praxarSa_samAxeSa#praxarSa_samAxeSa#noun#2#RM
display_console	praxarSa_kaMsola#praxarSa_kaMsola#noun#2#RM
display_device	praxarSa_yukwi#praxarSa_yukwi#noun#2#RM
display_foreground	praxarSa_agraBUmi#praxarSa_agraBUmi#noun#2#RM
display_image	praxarSa_prawibimba#praxarSa_prawibimba#noun#2#RM
display_panel	praxarSa_pattikA#praxarSa_pattikA#noun#2#RM
display_position	praxarSa_sWiwi#praxarSa_sWiwi#noun#2#RM
display_space	praxarSa_sWAna#praxarSa_sWAna#noun#2#RM
display_unit	praxarSa_ekaka#praxarSa_ekaka#noun#2#RM
distination_field	gaMwabya_kRewra#gaMwabya_kRewra#noun#2#RM
distributed_computing	viwariwa_aBikalana#viwariwa_aBikalana#noun#2#RM
distributed_data_processing	viwariwa_AMkadA_saMsAXana#viwariwa_AMkadA_saMsAXana#noun#3#RM
distributed_data_processing_network	viwariwa_AMkadA_saMsAXana_jAlakrama#viwariwa_AMkadA_saMsAXana_jAlakrama#noun#4#RM
distributed_intelligence	viwariwa_buxXi#viwariwa_buxXi#noun#2#RM
distributed_network	viwariwa_jAlakrama#viwariwa_jAlakrama#noun#2#RM
distributed_processing	viwariwa_saMsAXana#viwariwa_saMsAXana#noun#2#RM
distribution_cable	viwaraNa_kebala#viwaraNa_kebala#noun#2#RM
divide_check	viBAjana_jAMca#viBAjana_jAMca#noun#2#RM
division_remainder_method	viBAjana_SeRa_viXi#viBAjana_SeRa_viXi#noun#3#RM
document_handling	praleKa_haswana#praleKa_haswana#noun#2#RM
document_retrieval	praleKa_prawinayana#praleKa_prawinayana#noun#2#RM
documentation_program	praleKana_kramAxeSa#praleKana_kramAxeSa#noun#2#RM
domestic_satelite_carier	xeSIya_upagraha_vAhaka#xeSIya_upagraha_vAhaka#noun#3#RM
dot_character_printer	viMxu_saMprawIka_muxriwra#viMxu_saMprawIka_muxriwra#noun#3#RM
dot_matrix	viMxu_mEtriksa#viMxu_mEtriksa#noun#2#RM
double_density_recording	xvika_saGanawA_aBileKana#xvika_saGanawA_aBileKana#noun#3#RM
double_ended_queue	xvika_aMwa_paMkwi#xvika_aMwa_paMkwi#noun#3#RM
double_length_register	xvilaMbAI_paMjI#xvilaMbAI_paMjI#noun#3#RM
double_precision	xviguNa_pariSuxXawA#xviguNa_pariSuxXawA#noun#2#RM
double_precision_arithmetic	xviguNa_pariSuxXawA_aMkagaNiwa#xviguNa_pariSuxXawA_aMkagaNiwa#noun#3#RM
double_pulse_recording	xvispaMxa_aBileKana#xvispaMxa_aBileKana#noun#3#RM
double_sheet_detector	xviparNa_saMsUcaka#xviparNa_saMsUcaka#noun#3#RM
double_sheet_ejector	xviparNa_ukRepaka#xviparNa_ukRepaka#noun#3#RM
double_sided_disk	xvipArSva_cakrikA#xvipArSva_cakrikA#noun#3#RM
double_strike	xvika_taMkaNa#xvika_taMkaNa#noun#2#RM
down_link	aXa:_SrqMKalA#aXa:_SrqMKalA#noun#2#RM
down_time	acewa_kAlAvaXi#acewa_kAlAvaXi#noun#2#RM
downward_compatibility	aXomuKI_saMgawawA#aXomuKI_saMgawawA#noun#2#RM
drifting_character	apavAhI_saMprawIka#apavAhI_saMprawIka#noun#2#RM
drum_drive	drama_paricAlana#drama_paricAlana#noun#2#RM
drum_printer	drama_muxriwra#drama_muxriwra#noun#2#RM
drum_scanning	drama_kramavIkRaNa#drama_kramavIkRaNa#noun#2#RM
drum_unit	drama_ekaka#drama_ekaka#noun#2#RM
dual_density	xvEwa_saGanawA#xvEwa_saGanawA#noun#2#RM
dual_processor_system	xvEwa_saMsAXiwra_waMwra#xvEwa_saMsAXiwra_waMwra#noun#3#RM
dual_simplex_method	xvEwa_ekala_viXi#xvEwa_ekala_viXi#noun#3#RM
dumb_terminal	mUla_aMwaka#mUla_aMwaka#noun#2#RM
dummy_address	mUla_pawA#mUla_pawA#noun#2#RM
dummy_arguement	mUla_svawaMwra_cara#mUla_svawaMwra_cara#noun#2#RM
dummy_data_set	mUka_AMkadA_samuccaya#mUka_AMkadA_samuccaya#noun#3#RM
dummy_instruction	mUka_anuxeSa#mUka_anuxeSa#noun#2#RM
dummy_variable	mUka_cara#mUka_cara#noun#2#RM
dump_routine	sannikRepa_nemakA#sannikRepa_nemakA#noun#2#RM
duplex_channel	xvEXa_praNAla#xvEXa_praNAla#noun#2#RM
duplex_circuit	xvEXa_paripaWa#xvEXa_paripaWa#noun#2#RM
duplex_communication	xvEXa_saMcAra#xvEXa_saMcAra#noun#2#RM
duplex_transmission	xvEXa_saMcaraNa#xvEXa_saMcaraNa#noun#2#RM
duplicate_key	anulipi_kuMjI#anulipi_kuMjI#noun#2#RM
duplication_of_facilities	suviXA_guNana#suviXA_guNana#noun#3#RM
dynamic_address_translation	gawika_pawA_anuvAxa#gawika_pawA_anuvAxa#noun#3#RM
dynamic_allocation	gawika_niyawana#gawika_niyawana#noun#2#RM
dynamic_display_image	gawika_praxarSa_prawibimba#gawika_praxarSa_prawibimba#noun#3#RM
dynamic_instruction	gawika_anuxeSa#gawika_anuxeSa#noun#2#RM
dynamic_loading	gawika_BAraNa#gawika_BAraNa#noun#2#RM
dynamic_memory	gawika_smqwi#gawika_smqwi#noun#2#RM
dynamic_memory_allocation	gawika_smqwi_niyawana#gawika_smqwi_niyawana#noun#3#RM
dynamic_programming	gawika_kramAxeSana#gawika_kramAxeSana#noun#2#RM
dynamic_relocation	gawika_punaravasWApana#gawika_punaravasWApana#noun#2#RM
dynamic_storage	gawika_BaMdAraNa#gawika_BaMdAraNa#noun#2#RM
dynamic_virtual_memory_system	gawika_kalpiwa_smqwi_waMwra#gawika_kalpiwa_smqwi_waMwra#noun#4#RM
educational_technology	SEkRika_prOxyogikI#SEkRika_prOxyogikI#noun#2#RM
effective_instruction	praBAvI_anuxeSa#praBAvI_anuxeSa#noun#2#RM
effective_operand_address	praBAvI_saMkArya_pawA#praBAvI_saMkArya_pawA#noun#3#RM
effective_transmission_speed	praBAvI_saMcaraNa_cAla#praBAvI_saMcaraNa_cAla#noun#3#RM
eight-bit_byte	ATa_xvayaMka_bAita#ATa_xvayaMka_bAita#noun#2#RM
either-way_communication	pArasparika_saMcAra#pArasparika_saMcAra#noun#2#RM
eject_key	niRkAsana_kujI#niRkAsana_kujI#noun#2#RM
electomachenical_plotter	vixyuwa_yAMwrika_AleKiwra#vixyuwa_yAMwrika_AleKiwra#noun#2#RM
electomachenical_scanning	vixyuwa_yAMwrika_kramavIkRaNa#vixyuwa_yAMwrika_kramavIkRaNa#noun#2#RM
electomachenical_switching_system	vixyuwa_yAMwrikIya_svIcana_waMwra#vixyuwa_yAMwrikIya_svIcana_waMwra#noun#3#RM
electrical_accounting_machine	vixyuwa_leKA_yaMwra#vixyuwa_leKA_yaMwra#noun#3#RM
electromachenical_impact_printing	vixyuwa_yAMwrika_saMGataka_muxNa#vixyuwa_yAMwrika_saMGataka_muxNa#noun#3#RM
electromagnetic_relay	vixyuwa_cuMbakIya_rile#vixyuwa_cuMbakIya_rile#noun#2#RM
electrone-beam_recording	ilektrona_kiraNa_puMja_aBileKana#ilektrona_kiraNa_puMja_aBileKana#noun#2#RM
electronic_automatic_exchange	ilektronika_svacAliwa_telIPona_kenxra#ilektronika_svacAliwa_telIPona_kenxra#noun#3#RM
electronic_computer	ilektronika_parikaliwra#ilektronika_parikaliwra#noun#2#RM
electronic_data_processing	ilektronika_AMkadA_saMsAXana#ilektronika_AMkadA_saMsAXana#noun#3#RM
electronic_fund_transfer_system	ilektronika_niXi_sWAnAMwaraNa_waMwra#ilektronika_niXi_sWAnAMwaraNa_waMwra#noun#4#RM
electronic_mailing	ilektronika_dAka_sevA#ilektronika_dAka_sevA#noun#2#RM
electronic_printer	ilektronika_muxriwra#ilektronika_muxriwra#noun#2#RM
electronic_switch	ilektronika_svica#ilektronika_svica#noun#2#RM
electronic_switching_system	ilektronika_svicana_waMwra#ilektronika_svicana_waMwra#noun#3#RM
elementary_item	mUla_maxa#mUla_maxa#noun#2#RM
elemination_factor	vilopanAMka#vilopanAMka#noun#2#RM
else_clause	anyaWA_anucCexa#anyaWA_anucCexa#noun#2#RM
emitter_coupled_logic	uwsarjaka_yugmiwa_warka#uwsarjaka_yugmiwa_warka#noun#3#RM
empty_string	rikwa_rajju#rikwa_rajju#noun#2#RM
emulator_generation	yaMwrAnukaraNakArI_janana#yaMwrAnukaraNakArI_janana#noun#2#RM
enabled_module	samarWakqwa_prawirUpaka#samarWakqwa_prawirUpaka#noun#2#RM
end_around_borrow	paricakrIya_paScAMka#paricakrIya_paScAMka#noun#3#RM
end_around_carry	paricakrIya_hAsila#paricakrIya_hAsila#noun#3#RM
end_mark	aMwya_cinha#aMwya_cinha#noun#2#RM
end_of_address	pawAMwa#pawAMwa#noun#3#RM
end_of_block	KaMdaka_aMwa#KaMdaka_aMwa#noun#3#RM
end_of_data_indicator	AMkadA_aMwasUcaka#AMkadA_aMwasUcaka#noun#4#RM
end_of_file_mark	saMcikAMwa_cinha#saMcikAMwa_cinha#noun#4#RM
end_office	aMwya_kakRa#aMwya_kakRa#noun#2#RM
engineering_graphics	iMjIniyarI_AleKI#iMjIniyarI_AleKI#noun#2#RM
enter_key	praveSa_kuMjI#praveSa_kuMjI#noun#2#RM
entry_block	praviRti_KaMdaka#praviRti_KaMdaka#noun#2#RM
entry_instruction	praviRti_anuxeSa#praviRti_anuxeSa#noun#2#RM
entry_name	praviRti_nAma#praviRti_nAma#noun#2#RM
entry_time	praveSa_kAla#praveSa_kAla#noun#2#RM
entry_variable	praviRti_cara#praviRti_cara#noun#2#RM
environment_division	pariveSa_praBAga#pariveSa_praBAga#noun#2#RM
equipment_failure	upakaraNa_viPalawA#upakaraNa_viPalawA#noun#2#RM
equivalance_operation	wulyawA_saMkriyA#wulyawA_saMkriyA#noun#2#RM
erasable_programmable_read_only_memory_)	vyAmArjanIya_kramAxeSa_paTana_mAwra_smqwi#vyAmArjanIya_kramAxeSa_paTana_mAwra_smqwi#noun#5#RM
error_analysis	wruti_viSleRaNa#wruti_viSleRaNa#noun#2#RM
error_correcting_code	wruti_saMSoXana_kUta#wruti_saMSoXana_kUta#noun#3#RM
error_correction	wruti_saMSoXana#wruti_saMSoXana#noun#2#RM
error_detection	wruti_saMsUcana#wruti_saMsUcana#noun#2#RM
error_signal	wuti_saMkewa#wuti_saMkewa#noun#2#RM
escape_character	palAyana_saMprawIka#palAyana_saMprawIka#noun#2#RM
eulerian_path	Ayalara_paWa#Ayalara_paWa#noun#2#RM
eulers_method	Ayalara_viXi#Ayalara_viXi#noun#2#RM
even_parity_check	sama_samawA_jAMca#sama_samawA_jAMca#noun#3#RM
event_chain	GatanA_SrqMKalA#GatanA_SrqMKalA#noun#2#RM
event_control_block	GatanA_niyaMwraNa_KaMdaka#GatanA_niyaMwraNa_KaMdaka#noun#3#RM
event_start	GatanA_prAraMBa#GatanA_prAraMBa#noun#2#RM
except_gate=exclusive_or_gate_)	apavarjI_aWavA_xvAra#apavarjI_aWavA_xvAra#noun#4#RM
exception_error	apavAxa_wruti#apavAxa_wruti#noun#2#RM
exception_handling	apavAxa_haswana#apavAxa_haswana#noun#2#RM
exception_reporting	apavAxa_prawivexana#apavAxa_prawivexana#noun#2#RM
excess_notation	AXikya_aMkaNa_paxXawi#AXikya_aMkaNa_paxXawi#noun#2#RM
exchange_instruction	vinimaya_anuxeSa#vinimaya_anuxeSa#noun#2#RM
exchange_memory	vinimaya_smqwi#vinimaya_smqwi#noun#2#RM
exchange_sort	vinimaya_SAtana#vinimaya_SAtana#noun#2#RM
exchangeable_disk_storage	vinimeya_cakrikA_BaMdArana#vinimeya_cakrikA_BaMdArana#noun#3#RM
exclusion_nor	apavarjI_aWavA_pUraka#apavarjI_aWavA_pUraka#noun#2#RM
exclusive_or	apavarjI_aWavA#apavarjI_aWavA#noun#2#RM
exclusive_or_gate	apavarjI_aWavA_xvAra#apavarjI_aWavA_xvAra#noun#3#RM
executable_program	niRpAxya_kramAxeSa#niRpAxya_kramAxeSa#noun#2#RM
executable_statement	niRpAxya_kaWana#niRpAxya_kaWana#noun#2#RM
execute_statement	niRpAxana_kaWana#niRpAxana_kaWana#noun#2#RM
execution_cycle	niRpAxana_cakra#niRpAxana_cakra#noun#2#RM
execution_error_detection	niRpAxana_wruti_saMsUcana#niRpAxana_wruti_saMsUcana#noun#3#RM
execution_time	niRpAxana_kAla#niRpAxana_kAla#noun#2#RM
expert_system	viSeRajFa_praNAlI#viSeRajFa_praNAlI#noun#2#RM
exponent_part	GAwAMkI_BAga#GAwAMkI_BAga#noun#2#RM
extension_memory	viswAra_smqwi#viswAra_smqwi#noun#2#RM
external_call	bAhqya_AhavAna#bAhqya_AhavAna#noun#2#RM
external_delay	bAhqya_vilaMba#bAhqya_vilaMba#noun#2#RM
external_error	bAhqya_wruti#bAhqya_wruti#noun#2#RM
external_function	bAhqya_Palana#bAhqya_Palana#noun#2#RM
external_interrupt_inhibit	bAhqya_aMwarAyana_saMxamana#bAhqya_aMwarAyana_saMxamana#noun#3#RM
external_memory	bAhqya_smqwi#bAhqya_smqwi#noun#2#RM
external_merge	bAhqya_vilaya#bAhqya_vilaya#noun#2#RM
external_modem	bAhqya_modema#bAhqya_modema#noun#2#RM
external_program_parameter	bAhqya_kramAxeSa_prAcala#bAhqya_kramAxeSa_prAcala#noun#3#RM
external_schema	bAhqya_vivaraNikA#bAhqya_vivaraNikA#noun#2#RM
external_sorting	bAhqya_sAtana#bAhqya_sAtana#noun#2#RM
external_storage	bAhqya_BaMdAraNa#bAhqya_BaMdAraNa#noun#2#RM
face_character_printer	Palaka_saMprawIka_muxriwra#Palaka_saMprawIka_muxriwra#noun#3#RM
facsmile_i/o_device	prawikqwi_ni/ni_yukwi#prawikqwi_ni/ni_yukwi#noun#3#RM
facsmile_system	prawikqwi_waMwra#prawikqwi_waMwra#noun#2#RM
factor_analysis	upAxAna_viSleRaNa#upAxAna_viSleRaNa#noun#2#RM
failure_analysis	viPalawA_viSleRaNa#viPalawA_viSleRaNa#noun#2#RM
failure_rate	viPalawA_xara#viPalawA_xara#noun#2#RM
failure_recovery	viPalowwara_puna:_prApwi#viPalowwara_puna:_prApwi#noun#2#RM
false_code	miWyA_kUta#miWyA_kUta#noun#2#RM
false_error	miWyA_wruti#miWyA_wruti#noun#2#RM
fan-fold_paper	valiwa_kAgaja#valiwa_kAgaja#noun#2#RM
fast_access_storage	xruwa_aBigama_BaMdAraNa#xruwa_aBigama_BaMdAraNa#noun#3#RM
fatal_error	GAtaka_wruti#GAtaka_wruti#noun#2#RM
fault-tolerant_system	BraMSa_sahiRNu_waMwra#BraMSa_sahiRNu_waMwra#noun#2#RM
fault_time	BraMSa_kAla#BraMSa_kAla#noun#2#RM
fault_tolerance	BraSa_sahyawA#BraSa_sahyawA#noun#2#RM
fault_tolerant	BraMSa_sahiRNu#BraMSa_sahiRNu#noun#2#RM
fdnfrequency_division_multiplex_)	Avqwwi_viBAjana_bahusaMkewa#Avqwwi_viBAjana_bahusaMkewa#noun#3#RM
feasibility_study	susaMgawawA_aXyayana#susaMgawawA_aXyayana#noun#2#RM
feasible_solution	susaMgawa_hala#susaMgawa_hala#noun#2#RM
feed_punch	BaraNa_Cixiwra#BaraNa_Cixiwra#noun#2#RM
feedback_control	punarBaraNa_niyaMwraNa#punarBaraNa_niyaMwraNa#noun#2#RM
feedback_loop	punarBaraNa_pASa#punarBaraNa_pASa#noun#2#RM
feedback_system	punarBaraNa_waMwra#punarBaraNa_waMwra#noun#2#RM
feeder_cable	Baraka_kebila#Baraka_kebila#noun#2#RM
ferrite_core_memory	PerAita_koda_smqwi#PerAita_koda_smqwi#noun#3#RM
fetch_data	Anayana_AMkade#Anayana_AMkade#noun#2#RM
fetching_instruction	Anayana_anuxeSa#Anayana_anuxeSa#noun#2#RM
fibonaccy_search	PibonASI_Koja#PibonASI_Koja#noun#2#RM
fibonaccy_series	PibonASI_SreNI#PibonASI_SreNI#noun#2#RM
fibre-optics_transmission_system	waMwu_prakASikI_saMcaraNa_waMwra#waMwu_prakASikI_saMcaraNa_waMwra#noun#3#RM
fibre_optics	waMwu_prakASikI#waMwu_prakASikI#noun#2#RM
field_length	kRewra_xErGya#kRewra_xErGya#noun#2#RM
field_mark	kRewra_cinha#kRewra_cinha#noun#2#RM
field_selection	kRewra_varaNa#kRewra_varaNa#noun#2#RM
field_upgrading	kRewra_waloccana#kRewra_waloccana#noun#2#RM
fifth_generation_computer	paMcama_pIDI_aBikaliwra#paMcama_pIDI_aBikaliwra#noun#3#RM
file_access_method	saMcikA_aBigama_viXi#saMcikA_aBigama_viXi#noun#3#RM
file_activity_ratio	saMcikA_sakriyawA_anupAwa#saMcikA_sakriyawA_anupAwa#noun#3#RM
file_attribute	saMcikA_guNa#saMcikA_guNa#noun#2#RM
file_cleanup	saMcikA_pariSoXana#saMcikA_pariSoXana#noun#2#RM
file_composition	saMcikAyana#saMcikAyana#noun#2#RM
file_control	saMcikA_niyaMwraNa#saMcikA_niyaMwraNa#noun#2#RM
file_control_system	saMcikA_niyaMwraNa_waMwra#saMcikA_niyaMwraNa_waMwra#noun#3#RM
file_conversion	saMcikA_rUpAMwara#saMcikA_rUpAMwara#noun#2#RM
file_copying	saMcikA_prawilipikaraNa#saMcikA_prawilipikaraNa#noun#2#RM
file_description	saMcikA_vivaraNa#saMcikA_vivaraNa#noun#2#RM
file_event	saMcikA_GatanA#saMcikA_GatanA#noun#2#RM
file_information_retrieval	saMcikA_sUcanA_prawinayana#saMcikA_sUcanA_prawinayana#noun#3#RM
file_label	saMcikA_lebala#saMcikA_lebala#noun#2#RM
file_layout	saMcikA_vinyAsa#saMcikA_vinyAsa#noun#2#RM
file_length	saMcikA_xErGya#saMcikA_xErGya#noun#2#RM
file_maintainance	saMcikA_anurakRaNa#saMcikA_anurakRaNa#noun#2#RM
file_management	saMcikA_prabaMXa#saMcikA_prabaMXa#noun#2#RM
file_merge	saMcikA_vilaya#saMcikA_vilaya#noun#2#RM
file_name	saMcikA_nAma#saMcikA_nAma#noun#2#RM
file_organization	saMcikA_saMgaTana#saMcikA_saMgaTana#noun#2#RM
file_processing	saMcikA_saMsAXana#saMcikA_saMsAXana#noun#2#RM
file_protection	saMcikA_rakRaNa#saMcikA_rakRaNa#noun#2#RM
file_recovery	saMcikA_puna:_prApwi#saMcikA_puna:_prApwi#noun#2#RM
file_search	saMcikA_Koja#saMcikA_Koja#noun#2#RM
file_security	saMcikA_surakRA#saMcikA_surakRA#noun#2#RM
file_selection	saMcikA_varaNa#saMcikA_varaNa#noun#2#RM
file_storage	saMcikA_BaMdAraNa#saMcikA_BaMdAraNa#noun#2#RM
file_storage_unit	saMcikA_BaMdAraNa_ekaka#saMcikA_BaMdAraNa_ekaka#noun#3#RM
file_structure	saMcikA_saMracanA#saMcikA_saMracanA#noun#2#RM
file_updating	saMcikA_axyawanIkaraNa#saMcikA_axyawanIkaraNa#noun#2#RM
file_variable	saMcikA_cara#saMcikA_cara#noun#2#RM
film_frame	Pilma_Prema#Pilma_Prema#noun#2#RM
film_scanner	Pilma_kramavIkRaka#Pilma_kramavIkRaka#noun#2#RM
film_storage	Pilma_BaMdAraNa#Pilma_BaMdAraNa#noun#2#RM
final_copy	aMwima_prawilipi#aMwima_prawilipi#noun#2#RM
finder_beam	anveRI_kiraNa_puMja#anveRI_kiraNa_puMja#noun#2#RM
fine_sort	pariRkqwa_CAMta#pariRkqwa_CAMta#noun#2#RM
finite_element_method	parimiwa_avayava_viXi#parimiwa_avayava_viXi#noun#3#RM
finite_state_machine	parimiwa_avasWA_yaMwra#parimiwa_avasWA_yaMwra#noun#3#RM
first_generation_computer	praWama_pIDI_aBikaliwra#praWama_pIDI_aBikaliwra#noun#3#RM
five_level_code	paMca_swara_kUta#paMca_swara_kUta#noun#3#RM
fixed_block	niyawa_KaMdaka#niyawa_KaMdaka#noun#2#RM
fixed_decimal	niyawa_xaSamalava#niyawa_xaSamalava#noun#2#RM
fixed_format_massage	niyawa_saMrUpa_saMxeSa#niyawa_saMrUpa_saMxeSa#noun#3#RM
fixed_image_graphics	niyawa_prawibimba_AleKikI#niyawa_prawibimba_AleKikI#noun#3#RM
fixed_length_block	niyawa_xErGya_KaMdaka#niyawa_xErGya_KaMdaka#noun#3#RM
fixed_length_record	niyawa_xErGya_aBileKa#niyawa_xErGya_aBileKa#noun#3#RM
fixed_point_arithmatic	niyawa_viMxu_parikalana#niyawa_viMxu_parikalana#noun#3#RM
fixed_point_constant	niyawa_viMxU_acara#niyawa_viMxU_acara#noun#3#RM
fixed_point_number	niyawa_viMxU_saMKyA#niyawa_viMxU_saMKyA#noun#3#RM
fixed_point_representation_system	niyawa_viMxU_nirUpaNa_waMwra#niyawa_viMxU_nirUpaNa_waMwra#noun#4#RM
fixed_radix_numeration_system	niyawa_mUlAMka_saMKyAna_waMwra#niyawa_mUlAMka_saMKyAna_waMwra#noun#4#RM
fixed_satelite	niyawa_upagraha#niyawa_upagraha#noun#2#RM
fixed_word_lengt_computer	niyawa_Sabxa_xErGya_aBikaliwra#niyawa_Sabxa_xErGya_aBikaliwra#noun#4#RM
flag_indicator	cihnaka_sUcaka#cihnaka_sUcaka#noun#2#RM
flag_sequence	cihnaka_anukrama#cihnaka_anukrama#noun#2#RM
flat_bed_plotter	cipita_wala_AleKiwra#cipita_wala_AleKiwra#noun#3#RM
flat_bed_scanner	cipita_wala_kramavIkRaka#cipita_wala_kramavIkRaka#noun#3#RM
flexible_disk	namyikA#namyikA#noun#2#RM
flip_flop	xvimAniwra#xvimAniwra#noun#2#RM
floating_point_arithmatic	cala_biMxU_parikalana#cala_biMxU_parikalana#noun#3#RM
floating_point_arithmatic_instruction	cala_biMxU_parikalana_anuxeSa#cala_biMxU_parikalana_anuxeSa#noun#4#RM
floating_point_arithmatic_unit	cala_biMxU_parikalana_ekaka#cala_biMxU_parikalana_ekaka#noun#4#RM
floating_point_number	cala_biMxU_saMKyA#cala_biMxU_saMKyA#noun#3#RM
floating_point_precision	cala_biMxu_pariSuxXawA#cala_biMxu_pariSuxXawA#noun#3#RM
floating_point_radix	cala_biMxu_mUlAMka#cala_biMxu_mUlAMka#noun#3#RM
floating_point_register	cala_biMxu_paMjI#cala_biMxu_paMjI#noun#3#RM
floating_point_representation	cala_biMxu_nirUpaNa#cala_biMxu_nirUpaNa#noun#3#RM
floppy_disk	namyikA#namyikA#noun#2#RM
floppy_disk_controller	namyikA_niyaMwraka#namyikA_niyaMwraka#noun#3#RM
flow_of_control	niyaMwraNa_pravAha#niyaMwraNa_pravAha#noun#3#RM
flowchart_symbol	pravAha_saMciwra_prawIka#pravAha_saMciwra_prawIka#noun#2#RM
flowchart_technique	pravAha_saciwra_wakanIka#pravAha_saciwra_wakanIka#noun#2#RM
fly_back	prawiXAva#prawiXAva#noun#2#RM
flying_spot_scan	xruwa_biMxu_kramavIkRaNa#xruwa_biMxu_kramavIkRaNa#noun#3#RM
folding_ratio	valana_anupAwa#valana_anupAwa#noun#2#RM
foreground_display_image	agraBUmi_praxarSa_prawibimba#agraBUmi_praxarSa_prawibimba#noun#3#RM
foreground_job	agraBUmikArya#agraBUmikArya#noun#2#RM
foreground_processing	agraBUmi_saMsAXana#agraBUmi_saMsAXana#noun#2#RM
form_feed	pqRTa_BaraNa#pqRTa_BaraNa#noun#2#RM
form_feed_character	pqRTa_BaraNa_saMprawIka#pqRTa_BaraNa_saMprawIka#noun#3#RM
form_overlay	pqRTa_aXyAropaNa#pqRTa_aXyAropaNa#noun#2#RM
formal_language	OpacArika_BARA#OpacArika_BARA#noun#2#RM
formal_logic	OpacArika_warka#OpacArika_warka#noun#2#RM
format_description_statement	saMrUpa_vivaraNa_kaWana#saMrUpa_vivaraNa_kaWana#noun#3#RM
format_list	saMrUpa_sUci#saMrUpa_sUci#noun#2#RM
format_selection	saMrUpa_varaNa#saMrUpa_varaNa#noun#2#RM
formatted_display	saMrUpiwa_praxarSa#saMrUpiwa_praxarSa#noun#2#RM
formatted_recrd	saMrUpiwa_aBileKa#saMrUpiwa_aBileKa#noun#2#RM
formatted_systems_services	saMrUpiwa_waMwra_sevA#saMrUpiwa_waMwra_sevA#noun#3#RM
formula_manipulation	sUwra_prakalana#sUwra_prakalana#noun#2#RM
fortran_programming	PortrAna_kramAxeSana#PortrAna_kramAxeSana#noun#2#RM
forward_bias	agra_aBinawi#agra_aBinawi#noun#2#RM
forward_channel	agra_praNAla#agra_praNAla#noun#2#RM
forward_difference_method	agrAMwara_viXi#agrAMwara_viXi#noun#3#RM
forward_scan	agra_kramavIkRaNa#agra_kramavIkRaNa#noun#2#RM
four-bit_byte	cAraxvayI_aMka_bAita#cAraxvayI_aMka_bAita#noun#2#RM
four-way_interleaving	cawuRpaWI_aMwa:pawraNa#cawuRpaWI_aMwa:pawraNa#noun#2#RM
four-wire_circuit	cAra_wAra_paripaWa#cAra_wAra_paripaWa#noun#2#RM
fox_message	PAksa_(parIkRaNa)saMxeSa#PAksa_(parIkRaNa)saMxeSa#noun#2#RM
frame_grabber	Prema_grAhI#Prema_grAhI#noun#2#RM
framing_bits	Premana_xvayaMka#Premana_xvayaMka#noun#2#RM
free_from	mukwa_saMrUpa#mukwa_saMrUpa#noun#2#RM
free_storage	rikwa_BaMdAraNa#rikwa_BaMdAraNa#noun#2#RM
frequency-division_multiplexing	Avqwwi_viBAjana_bahusaMkewana#Avqwwi_viBAjana_bahusaMkewana#noun#2#RM
frequency-shift_keying	Avqwwi_visWApana_kuMjIyana#Avqwwi_visWApana_kuMjIyana#noun#2#RM
front-end_computer	agrAMwa_aBikaliwra#agrAMwa_aBikaliwra#noun#2#RM
front-end_processor	agrAMwa_saMsAXiwra#agrAMwa_saMsAXiwra#noun#2#RM
front_end	agrAMwa#agrAMwa#noun#2#RM
front_panel	agrapattikA#agrapattikA#noun#2#RM
full-screen_editing	pUrNa_prapatta_saMpAxana#pUrNa_prapatta_saMpAxana#noun#2#RM
full_adder	pUrNayojaka#pUrNayojaka#noun#2#RM
full_duplex	pUrNa_xvEXa#pUrNa_xvEXa#noun#2#RM
full_subtracter	pUrNa_vyavakalaka#pUrNa_vyavakalaka#noun#2#RM
function_declaration_statement	prakArya_GoRaNA_kaWana#prakArya_GoRaNA_kaWana#noun#3#RM
function_generator	Palana_janaka#Palana_janaka#noun#2#RM
function_key	prakArya_kuMjI#prakArya_kuMjI#noun#2#RM
function_name	Palana_nAma#Palana_nAma#noun#2#RM
function_reference	Palana_saMxarBa#Palana_saMxarBa#noun#2#RM
function_subprogram	Palana_upakramAxeSa#Palana_upakramAxeSa#noun#2#RM
function_table	Palana_sAraNI#Palana_sAraNI#noun#2#RM
functional_design	prakArya_aBikalpanA#prakArya_aBikalpanA#noun#2#RM
fuzzy_set	aspaRta_seta#aspaRta_seta#noun#2#RM
gap_character	aMwarAlI_saMprawIka#aMwarAlI_saMprawIka#noun#2#RM
garbage_collection	kacarA_saMgrahaNa#kacarA_saMgrahaNa#noun#2#RM
garbage_in_garbage_outgigo_)	kacarA_aMxara_kacarA_bAhara#kacarA_aMxara_kacarA_bAhara#noun#4#RM
general_program	vyApaka_kramAxeSa#vyApaka_kramAxeSa#noun#2#RM
general_purpose_computer	vyApaka_uxxeSya_aBikaliwra#vyApaka_uxxeSya_aBikaliwra#noun#3#RM
general_purpose_language	vyApaka_uxxeSya_BARA#vyApaka_uxxeSya_BARA#noun#3#RM
general_purpose_operating_system	vyApaka_uxxeSya_saMkriyA_praNAlI#vyApaka_uxxeSya_saMkriyA_praNAlI#noun#4#RM
general_purpose_register	vyApaka_uxxeSya_paMjI#vyApaka_uxxeSya_paMjI#noun#3#RM
general_register	vyApaka_paMjI#vyApaka_paMjI#noun#2#RM
generalized_subroutine	vyApakIkqwa_upanemakA#vyApakIkqwa_upanemakA#noun#2#RM
generated_carry	janiwa_haswaMgawa#janiwa_haswaMgawa#noun#2#RM
generated_error	janiwa_wruti#janiwa_wruti#noun#2#RM
generated_function	janana_Palana#janana_Palana#noun#2#RM
generation_data_set	janana_AMkadA_samuccaya#janana_AMkadA_samuccaya#noun#3#RM
generic_name	varga_nAma#varga_nAma#noun#2#RM
global_code	sArvawrika_kUta#sArvawrika_kUta#noun#2#RM
global_lock	sArvawrika_wAlA#sArvawrika_wAlA#noun#2#RM
global_variable	sArvawrika_cara#sArvawrika_cara#noun#2#RM
glossary_function	Sabxa_saMgraha_prakArya#Sabxa_saMgraha_prakArya#noun#2#RM
graceful_degradation	svIkqwa_nimnIkaraNa#svIkqwa_nimnIkaraNa#noun#2#RM
graphic_character	AleKa_saMprawIka#AleKa_saMprawIka#noun#2#RM
graphic_data_structure	AleKI_AMkadA_saMracanA#AleKI_AMkadA_saMracanA#noun#3#RM
graphic_display_program	AleKI_praxarSa_kramAxeSa#AleKI_praxarSa_kramAxeSa#noun#3#RM
graphic_display_resolution	AleKI_praxarSa_viBexana#AleKI_praxarSa_viBexana#noun#3#RM
graphic_display_unit	AleKI_praxarSa_ekaka#AleKI_praxarSa_ekaka#noun#3#RM
graphic_job_processor	AleKI_kArya_saMsAXiwra#AleKI_kArya_saMsAXiwra#noun#3#RM
graphic_language	AleKI_BARA#AleKI_BARA#noun#2#RM
graphic_panel	AleKI_pattikA#AleKI_pattikA#noun#2#RM
graphic_plotter	AleKI_AleKiwra#AleKI_AleKiwra#noun#2#RM
gray_code	gre_kUta#gre_kUta#noun#2#RM
greed_chart	grIda_saMciwra#grIda_saMciwra#noun#2#RM
group_addressing	samUha_pawABigamana#samUha_pawABigamana#noun#2#RM
group_name	samUha_nAma#samUha_nAma#noun#2#RM
guard_bank	rakRaka_bEMka#rakRaka_bEMka#noun#2#RM
half-duplex_channel	arxXa-xvEXa_praNAla#arxXa-xvEXa_praNAla#noun#2#RM
half-duplex_service	arxXa-xvEXa_sevA#arxXa-xvEXa_sevA#noun#2#RM
half_intensity	arxXa-wIvrawA#arxXa-wIvrawA#noun#2#RM
halftone_plotting	hAPatona_AleKana#hAPatona_AleKana#noun#2#RM
hamming_code	hEmiMga_kUta#hEmiMga_kUta#noun#2#RM
hamming_distance	hEmriga_xUrI#hEmriga_xUrI#noun#2#RM
hand-held_calculator	parikaliwra#parikaliwra#noun#2#RM
hand_wiring	sWAyI_wAra_saMbaMXana#sWAyI_wAra_saMbaMXana#noun#2#RM
hard-copy_video_interface	saMpaTanIya_vIdIyo_aMwarApqRTa#saMpaTanIya_vIdIyo_aMwarApqRTa#noun#3#RM
hard_copy	saMpaTanIya_prawilipi#saMpaTanIya_prawilipi#noun#2#RM
hard_disk	anamyikA#anamyikA#noun#2#RM
hard_error	kaTora_wruti#kaTora_wruti#noun#2#RM
hard_sectoring	kaTora_wrijya_KaMda#kaTora_wrijya_KaMda#noun#2#RM
hardware_check	yaMwra_sAmagrI_jAMca#yaMwra_sAmagrI_jAMca#noun#2#RM
hardware_error_recovery	yaMwra_sAmagrI_wruti_puna:_prApwi#yaMwra_sAmagrI_wruti_puna:_prApwi#noun#3#RM
hashing_function	xruwAnveRaNa_Palana#xruwAnveRaNa_Palana#noun#2#RM
hashing_technique	xruwAnveRaNa_wakanIka#xruwAnveRaNa_wakanIka#noun#2#RM
head_gap	SIrRa_aMwarAla#SIrRa_aMwarAla#noun#2#RM
header_level	praveSikA_levala#praveSikA_levala#noun#2#RM
hetrogeneous_network	viRmAMgI_jAlakrama#viRmAMgI_jAlakrama#noun#2#RM
heuristic_method	svanuBavika_viXi#svanuBavika_viXi#noun#2#RM
hexadecimal_constant	RodaSa_AXArI_niyawAMka#RodaSa_AXArI_niyawAMka#noun#2#RM
hexadecimal_notation	RodaSa_AXArI_aMkaNa_paxXawi#RodaSa_AXArI_aMkaNa_paxXawi#noun#2#RM
hidden_line	aprawyakRa_reKA#aprawyakRa_reKA#noun#2#RM
hierarchical_computer_network	paxAnukramika_aBikaliwra_jAlakrama#paxAnukramika_aBikaliwra_jAlakrama#noun#3#RM
hierarchical_structure	paxAnukramika_saMracanA#paxAnukramika_saMracanA#noun#2#RM
hierarchy_of_operations	saMkriyA_paxAnukrama#saMkriyA_paxAnukrama#noun#3#RM
high_byte	ucca_bAita#ucca_bAita#noun#2#RM
high_density	ucca_saGanawA#ucca_saGanawA#noun#2#RM
high_level_assembler	ucca_swara_kodAMwaraka#ucca_swara_kodAMwaraka#noun#3#RM
high_level_compiler	ucca_swara_anuBARaka#ucca_swara_anuBARaka#noun#3#RM
high_level_source_code	ucca_swara_srowa_kUta#ucca_swara_srowa_kUta#noun#4#RM
high_lighting	ucca_mahawvIkaraNa#ucca_mahawvIkaraNa#noun#2#RM
high_pass	ucca_pAraka#ucca_pAraka#noun#2#RM
hit_ratio	lakRya_veXana_anupAwa#lakRya_veXana_anupAwa#noun#2#RM
hold_instruction	XAraNa_anuxeSa#XAraNa_anuxeSa#noun#2#RM
hold_pattern	XAraNa_prawirUpa#XAraNa_prawirUpa#noun#2#RM
holding_beam	XAraka_kiraNa_puMja#XAraka_kiraNa_puMja#noun#2#RM
hollerith_card	holeriWa_pawraka#holeriWa_pawraka#noun#2#RM
home_address	mUla_sWAna_pawA#mUla_sWAna_pawA#noun#2#RM
home_position	mUla_sWiwi#mUla_sWiwi#noun#2#RM
homogeneous_network	samAMgI_jAlakrama#samAMgI_jAlakrama#noun#2#RM
horizontal_feed	kREwija_BaraNa#kREwija_BaraNa#noun#2#RM
horizontal_system	kREwija_paxXawi#kREwija_paxXawi#noun#2#RM
host_computer	praXAna_aBikaliwra#praXAna_aBikaliwra#noun#2#RM
hybrid_computer	SaMkara_aBikaliwra#SaMkara_aBikaliwra#noun#2#RM
hybrid_programming	SaMkara_kramAxeSana#SaMkara_kramAxeSana#noun#2#RM
hybrid_system	SaMkara_waMwra#SaMkara_waMwra#noun#2#RM
identity_operation	wawsamaka_saMkriyA#wawsamaka_saMkriyA#noun#2#RM
idle_character	akriya_saMprawIka#akriya_saMprawIka#noun#2#RM
idle_link	akriya_kadI#akriya_kadI#noun#2#RM
if-and-only-if_operation	yaxi_Ora_kevala_yaxi_saMkriyA#yaxi_Ora_kevala_yaxi_saMkriyA#noun#2#RM
if-then_operation	yaxi_waxA_saMkriyA#yaxi_waxA_saMkriyA#noun#2#RM
if_statement	yaxi_kaWana#yaxi_kaWana#noun#2#RM
image_area	prawibimba_kRewra#prawibimba_kRewra#noun#2#RM
image_printer	prawibimba_muxriwra#prawibimba_muxriwra#noun#2#RM
image_processing	prawibimba_saMsAXana#prawibimba_saMsAXana#noun#2#RM
image_sensor	prawibimba_saMvexiwra#prawibimba_saMvexiwra#noun#2#RM
immediate_access	wAwkAlika_aBigamana#wAwkAlika_aBigamana#noun#2#RM
immediate_address	wAwkAlika_pawA#wAwkAlika_pawA#noun#2#RM
impact_printer	saMGatata_muxriwra#saMGatata_muxriwra#noun#2#RM
imperative_statement	AxeSa_sUcaka_kaWana#AxeSa_sUcaka_kaWana#noun#2#RM
implicit_address	aspaRta_pawA#aspaRta_pawA#noun#2#RM
improved_mobile_telephone_service	unnawa_cala_telIPona_sevA#unnawa_cala_telIPona_sevA#noun#4#RM
in_line_processing	paMkwibaxXa_saMsAXana#paMkwibaxXa_saMsAXana#noun#3#RM
inactive_node	niRkriya_AsaMXi#niRkriya_AsaMXi#noun#2#RM
inclusive_nor_operation	aMwarveSiwa_aWavA_pUraka_saMkriyA#aMwarveSiwa_aWavA_pUraka_saMkriyA#noun#3#RM
inclusive_or_gate	aMwarveSiwa_aWavA_xvAra#aMwarveSiwa_aWavA_xvAra#noun#3#RM
incoming_massage	Agamana_saMxeSa#Agamana_saMxeSa#noun#2#RM
index_data_item	sUcaka_AMkadA_maxa#sUcaka_AMkadA_maxa#noun#3#RM
index_hole	sUcaka_vivara#sUcaka_vivara#noun#2#RM
index_register	sUcaka_paMjI#sUcaka_paMjI#noun#2#RM
index_sequential_file	sUcaka_anukramika_saMcikA#sUcaka_anukramika_saMcikA#noun#3#RM
indexed_file	sUciwa_saMcikA#sUciwa_saMcikA#noun#2#RM
indexed_sequential_access_method	sUciwa_anukramika_aBigama_viXi#sUciwa_anukramika_aBigama_viXi#noun#4#RM
indexed_sequential_organization	sUciwa_anukramika_saMgaTana#sUciwa_anukramika_saMgaTana#noun#3#RM
indirect_addressing	parokRa_pawABigamana#parokRa_pawABigamana#noun#2#RM
indirect_instruction	parokRa_anuxeSa#parokRa_anuxeSa#noun#2#RM
infix_notation	maXyaprawyaya_saMkewana_paxXawi#maXyaprawyaya_saMkewana_paxXawi#noun#2#RM
information_bit	sUcanA_xvayaMka#sUcanA_xvayaMka#noun#2#RM
information_flow_analysis	sUcanA_pravAha_viSleRaNa#sUcanA_pravAha_viSleRaNa#noun#3#RM
information_hit_back_system	sUcanA_punarBaraNa_waMwra#sUcanA_punarBaraNa_waMwra#noun#4#RM
information_interchange	sUcanA_vinimaya#sUcanA_vinimaya#noun#2#RM
information_processing	sUcanA_saMsAXana#sUcanA_saMsAXana#noun#2#RM
information_retrieval	sUcanA_prawinayana#sUcanA_prawinayana#noun#2#RM
information_source	sUcanA_srowa#sUcanA_srowa#noun#2#RM
information_technology	sUcanA_prOxyogikI#sUcanA_prOxyogikI#noun#2#RM
information_theory	sUcanA_sixXAMwa#sUcanA_sixXAMwa#noun#2#RM
inherited_error	nihiwa_wruti#nihiwa_wruti#noun#2#RM
inhibit_pulse	saMxamana_spaMxa#saMxamana_spaMxa#noun#2#RM
inhouse_system	GarelU_waMwra#GarelU_waMwra#noun#2#RM
initial_address	prAraMBika_pawA#prAraMBika_pawA#noun#2#RM
initiator_procedure	prAraMBaka_prakriyA#prAraMBaka_prakriyA#noun#2#RM
inkjet_printer	syAhI_praXAra_muxriwra#syAhI_praXAra_muxriwra#noun#2#RM
inner_code	aMwa:_kUta#aMwa:_kUta#noun#2#RM
inoperable_time	apracAlanIya_kArya#apracAlanIya_kArya#noun#2#RM
input_buffer_register	niveSI_cayaka_paMjI#niveSI_cayaka_paMjI#noun#3#RM
input_job_stream	niveSI_kArya_SrqMKalA#niveSI_kArya_SrqMKalA#noun#3#RM
input_output_(_i/o_)	niveSa_nirgama#niveSa_nirgama#noun#4#RM
input_output_buffer	niveSa_nirgama_cayaka#niveSa_nirgama_cayaka#noun#3#RM
input_output_controller	niveSa_nirgama_niyaMwraNa#niveSa_nirgama_niyaMwraNa#noun#3#RM
input_output_cycle	niveSa_nirgama_cakra#niveSa_nirgama_cakra#noun#3#RM
input_output_device	niveSa_nirgama_yukwi#niveSa_nirgama_yukwi#noun#3#RM
input_output_processor	niveSa_nirgama_saMsAXiwra#niveSa_nirgama_saMsAXiwra#noun#3#RM
input_output_register	niveSa_nirgama_paMjI#niveSa_nirgama_paMjI#noun#3#RM
input_output_statement	niveSa_nirgama_kaWana#niveSa_nirgama_kaWana#noun#3#RM
input_output_unit	niveSa_nirgama_ekaka#niveSa_nirgama_ekaka#noun#3#RM
input_storage	niveSa_BaMdAraNa#niveSa_BaMdAraNa#noun#2#RM
input_unit	niveSa_ekaka#niveSa_ekaka#noun#2#RM
input_validation	niveSa_mAnyakaraNa#niveSa_mAnyakaraNa#noun#2#RM
inquiry_trasaction	pUCawACa_saMcAlana#pUCawACa_saMcAlana#noun#2#RM
insertion_sort	niveSana_CAMta#niveSana_CAMta#noun#2#RM
installation_tape_number	aXiRTApana_tepa_kramAMka#aXiRTApana_tepa_kramAMka#noun#3#RM
installation_time	aXiRTApana_kAla#aXiRTApana_kAla#noun#2#RM
instruction_address_register	anuxeSa_pawA_paMjI#anuxeSa_pawA_paMjI#noun#3#RM
instruction_code	anuxeSa_kUta#anuxeSa_kUta#noun#2#RM
instruction_counter	anuxeSa_gaNiwra#anuxeSa_gaNiwra#noun#2#RM
instruction_register	anuxeSa_paMjI#anuxeSa_paMjI#noun#2#RM
instruction_set	anuxeSa_samuccaya#anuxeSa_samuccaya#noun#2#RM
integer_constant	pUrNAMka_acara#pUrNAMka_acara#noun#2#RM
integer_programming	pUrNAMka_progrAmana#pUrNAMka_progrAmana#noun#2#RM
integer_variable	pUrNAMka_cara#pUrNAMka_cara#noun#2#RM
integrated_communication_adapter	ekIkqwa_saMcAra_anukUliwra#ekIkqwa_saMcAra_anukUliwra#noun#3#RM
integrated_data_processing	ekIkqwa_AMkadA_saMsAXana#ekIkqwa_AMkadA_saMsAXana#noun#3#RM
integrated_emulator	ekIkqwa_yaMwrAnukArI#ekIkqwa_yaMwrAnukArI#noun#2#RM
integrated_modem	ekIkqwa_modema#ekIkqwa_modema#noun#2#RM
intelligent_controller	aBijFa_niyaMwraka#aBijFa_niyaMwraka#noun#2#RM
intelligent_terminal	aBijFa_aMwaka#aBijFa_aMwaka#noun#2#RM
inter_exchange_channel	aMwarA_kenxrIya_praNAla#aMwarA_kenxrIya_praNAla#noun#3#RM
interactive_graphics	anyonya_kriyA_AleKikI#anyonya_kriyA_AleKikI#noun#2#RM
interactive_keyboard_printer	anyonya_kriyA_kuMjIpatala_muxriwra#anyonya_kriyA_kuMjIpatala_muxriwra#noun#3#RM
interactive_routine	anyonya_kriyA_nemakA#anyonya_kriyA_nemakA#noun#2#RM
interactive_system	anyonya_kriyA_waMwra#anyonya_kriyA_waMwra#noun#2#RM
interblock_gap	aMwarA_KaMdaka_aMwarAla#aMwarA_KaMdaka_aMwarAla#noun#2#RM
intercom_service	anyonya_saMcAra_sevA#anyonya_saMcAra_sevA#noun#2#RM
intercommunication_system	anyonya_saMcArI_waMwra#anyonya_saMcArI_waMwra#noun#2#RM
interconnecting_unit	paraspara_saMbaMXaka_ekaka#paraspara_saMbaMXaka_ekaka#noun#2#RM
interleaved_subscript	aMwa:pawriwa_pAxAkRara#aMwa:pawriwa_pAxAkRara#noun#2#RM
intermediate_buffer	maXyavarwI_cayaka#maXyavarwI_cayaka#noun#2#RM
intermediate_node	maXyavarwI_AsaMXi#maXyavarwI_AsaMXi#noun#2#RM
intermittent_error	aMwarAyika_wruti#aMwarAyika_wruti#noun#2#RM
internal_block	AMwarika_KaMdaka#AMwarika_KaMdaka#noun#2#RM
internal_format	AMwarika_saMrUpa#AMwarika_saMrUpa#noun#2#RM
internal_fragmentation	AMwarika_KaMdana#AMwarika_KaMdana#noun#2#RM
internal_memory	AMwarika_smqwi#AMwarika_smqwi#noun#2#RM
internal_schema	AMwarika_vivaraNikA#AMwarika_vivaraNikA#noun#2#RM
internal_sort	AMwarika_sArtana#AMwarika_sArtana#noun#2#RM
internal_timer	AMwarika_kAlaxa#AMwarika_kAlaxa#noun#2#RM
international_direction_distance_dialling	aMwarrARtrIya_sIXA_dAyalana#aMwarrARtrIya_sIXA_dAyalana#noun#4#RM
interpretive_program	nirvacanAwmaka_kramAxeSa#nirvacanAwmaka_kramAxeSa#noun#2#RM
interrecord_gap	aMwarA_aBileKa_aMwarAla#aMwarA_aBileKa_aMwarAla#noun#2#RM
interrupt_handler	aMwarAya_haswaka#aMwarAya_haswaka#noun#2#RM
interrupt_mask	aMwarAyaNa_AcCaxa#aMwarAyaNa_AcCaxa#noun#2#RM
interrupt_vector	aMwarAyaNa_saxiSa#aMwarAyaNa_saxiSa#noun#2#RM
inventory_master_file	wAlikA_muKya_saMcikA#wAlikA_muKya_saMcikA#noun#3#RM
inverted_file	prawilomiwa_saMcikA#prawilomiwa_saMcikA#noun#2#RM
iso_international_organization_for_standardization	aMwarrARtrIya_mAnakIkaraNa(Aiso)#aMwarrARtrIya_mAnakIkaraNa(Aiso)#noun#5#RM
iso_standard	AIso_mAnaka#AIso_mAnaka#noun#2#RM
item_count	maxa_gaNanA#maxa_gaNanA#noun#2#RM
iterative_do_group	punarAvqwwi_kurU_samUha#punarAvqwwi_kurU_samUha#noun#3#RM
job_control	kArya_niyaMwraNa#kArya_niyaMwraNa#noun#2#RM
job_control_language	kArya_AKyApana_BARA#kArya_AKyApana_BARA#noun#3#RM
job_control_statement	kArya_niyaMwraNa_kaWana#kArya_niyaMwraNa_kaWana#noun#3#RM
job_flow_control	kArya_pravAha_niyaMwraNa#kArya_pravAha_niyaMwraNa#noun#3#RM
job_input_file	kArya_niveSa_saMcikA#kArya_niveSa_saMcikA#noun#3#RM
job_input_stream	kArya_niveSa_XArA#kArya_niveSa_XArA#noun#3#RM
job_management	kArya_prabaMXa#kArya_prabaMXa#noun#2#RM
job_oriented_language	kAryonmuKa_BARA#kAryonmuKa_BARA#noun#3#RM
job_output_file	kArya_nigAma_saMcikA#kArya_nigAma_saMcikA#noun#3#RM
job_priority	kArya_prAWamikawA#kArya_prAWamikawA#noun#2#RM
job_processing	kArya_saMsAXana#kArya_saMsAXana#noun#2#RM
job_stream	kArya_XArA#kArya_XArA#noun#2#RM
jump_instruction	JaMpaka_anuxeSa#JaMpaka_anuxeSa#noun#2#RM
justified_margin	uciwa_upAMwa#uciwa_upAMwa#noun#2#RM
karnaugh_map	kAranAPa_prawiciwra#kAranAPa_prawiciwra#noun#2#RM
key_click	kuMjI_taka#kuMjI_taka#noun#2#RM
key_driven	kuMjI_paricAliwra#kuMjI_paricAliwra#noun#2#RM
key_pad	kuMjI_pEda#kuMjI_pEda#noun#2#RM
key_phrase	muKya_vAkyAMSa#muKya_vAkyAMSa#noun#2#RM
key_pulse	kuMjI_spaMxa#kuMjI_spaMxa#noun#2#RM
key_punch	kuMjI_Cixriwra#kuMjI_Cixriwra#noun#2#RM
key_sorting	kuMjI_sArtana#kuMjI_sArtana#noun#2#RM
key_stoke	kuMjI_AGAwa#kuMjI_AGAwa#noun#2#RM
key_to_floppy	kuMjI_se_namyikA#kuMjI_se_namyikA#noun#3#RM
kipskiloinstructions-per_second_)	kipsa#kipsa#noun#2#RM
landline_facility	Wala_lAina_suviXA#Wala_lAina_suviXA#noun#2#RM
language_interpreter	BARA_nirvacaka#BARA_nirvacaka#noun#2#RM
language_processor	BARA_saMsAXaka#BARA_saMsAXaka#noun#2#RM
language_subset	BARA_upasamuccaya#BARA_upasamuccaya#noun#2#RM
language_translator	BARA_anuvAxaka#BARA_anuvAxaka#noun#2#RM
large_scale_itegration	viSAla_ekIkaraNa#viSAla_ekIkaraNa#noun#3#RM
laser_communication	lesara_saMcAra#lesara_saMcAra#noun#2#RM
laserjet_printer	lesara_praXAra_muxriwra#lesara_praXAra_muxriwra#noun#2#RM
lateral_revearsal	pArSva_uwkramaNa#pArSva_uwkramaNa#noun#2#RM
leading_decision	praXAna_nirNaya#praXAna_nirNaya#noun#2#RM
leading_zero	agraga_SUnya#agraga_SUnya#noun#2#RM
leased_channel	pattAyiwa_praNAla#pattAyiwa_praNAla#noun#2#RM
leased_line	pattAyiwa_lAina#pattAyiwa_lAina#noun#2#RM
least_significant_character	alpawama_sArWaka_saMprawIka#alpawama_sArWaka_saMprawIka#noun#3#RM
least_significant_digit	alpawama_sArWaka_aMka#alpawama_sArWaka_aMka#noun#3#RM
left_justification	vAma_Ociwya#vAma_Ociwya#noun#2#RM
length_specification	laMbAI_vinirxeSa#laMbAI_vinirxeSa#noun#2#RM
letter_quality	akRara_guNawA#akRara_guNawA#noun#2#RM
level_indicator	swara_sUcaka#swara_sUcaka#noun#2#RM
library_program	kramAxeSa_saMgraha_kramAxeSa#kramAxeSa_saMgraha_kramAxeSa#noun#2#RM
library_routine	kramAxeSa_saMgraha_nemakA#kramAxeSa_saMgraha_nemakA#noun#2#RM
library_subroutine	kramAxeSa_saMgraha_upanemakA#kramAxeSa_saMgraha_upanemakA#noun#2#RM
licensed_publication	lAiseMsa_prApwa_prakASana#lAiseMsa_prApwa_prakASana#noun#2#RM
light_emitting_diode	prakASa_uwsarjaka_dAyoda#prakASa_uwsarjaka_dAyoda#noun#3#RM
light_emitting_diode_display	prakASa_uwsarjaka_dAyoda_praxarSa#prakASa_uwsarjaka_dAyoda_praxarSa#noun#4#RM
light_gun	prakASa_gana#prakASa_gana#noun#2#RM
light_pen	prakASa_leKani#prakASa_leKani#noun#2#RM
light_pen_tracking	prakASa_leKani_paWa_reKA#prakASa_leKani_paWa_reKA#noun#3#RM
line_adapter	lAina_anukUliwra#lAina_anukUliwra#noun#2#RM
line_at_a_time_printer	reKAmuxriwra#reKAmuxriwra#noun#5#RM
line_control_block	lAina_niyaMwraNa_KaMdaka#lAina_niyaMwraNa_KaMdaka#noun#3#RM
line_counter	reKAgaNiwra#reKAgaNiwra#noun#2#RM
line_delete_symbol	reKA_vilopana_prawIka#reKA_vilopana_prawIka#noun#3#RM
line_editing	reKA_saMpAxana#reKA_saMpAxana#noun#2#RM
line_end_zone	reKAMwa_kRewra#reKAMwa_kRewra#noun#3#RM
line_feed	reKA_BaraNa#reKA_BaraNa#noun#2#RM
line_feed_character	reKA_BaraNa_saMprawIka#reKA_BaraNa_saMprawIka#noun#3#RM
line_generator	reKA_janiwra#reKA_janiwra#noun#2#RM
line_impedance	lAina_prawibAXA#lAina_prawibAXA#noun#2#RM
line_link_pulsing	lAina_SrqMKalana_spaMxana#lAina_SrqMKalana_spaMxana#noun#3#RM
line_mode_switching	lAina_viXA_svIcana#lAina_viXA_svIcana#noun#3#RM
line_printer	reKA_muxriwra#reKA_muxriwra#noun#2#RM
line_speed	lAina_cAla#lAina_cAla#noun#2#RM
line_surge	lAina_prowkarRa#lAina_prowkarRa#noun#2#RM
linear_distortion	rEKika_virUpana#rEKika_virUpana#noun#2#RM
linear_optimization	rEKika_iRtawamikaraNa#rEKika_iRtawamikaraNa#noun#2#RM
linear_programming	rEKika_progrAmana#rEKika_progrAmana#noun#2#RM
linear_search	rEKika_Koja#rEKika_Koja#noun#2#RM
link_attached_terminal	kadIbaxXa_aMwaka#kadIbaxXa_aMwaka#noun#3#RM
link_by_link_signaling	kadIvAra_saMkewana#kadIvAra_saMkewana#noun#4#RM
link_control	kadI_niyaMwraNa#kadI_niyaMwraNa#noun#2#RM
linkage_editor	SrqMKalana_saMpAxaka#SrqMKalana_saMpAxaka#noun#2#RM
linked_sequential_file	SrqMKaliwa_anukramika_saMcikA#SrqMKaliwa_anukramika_saMcikA#noun#3#RM
lisplist_processing_)	lispa/sUci_saMsAXana#lispa/sUci_saMsAXana#noun#2#RM
list_directed_transmission	sUci_xqRta_saMcaraNa#sUci_xqRta_saMcaraNa#noun#3#RM
list_processing	sUci_saMsAXana#sUci_saMsAXana#noun#2#RM
list_structure	sUci_saMracanA#sUci_saMracanA#noun#2#RM
literal_search	AkRara_Koja#AkRara_Koja#noun#2#RM
load_balancing	BAra_saMwulana#BAra_saMwulana#noun#2#RM
load_module	BAra_prawirUpaka#BAra_prawirUpaka#noun#2#RM
load_on_call	AhavAnI_BAraNa#AhavAnI_BAraNa#noun#3#RM
load_sharing	BAra_BAgI#BAra_BAgI#noun#2#RM
loading_error	BAraNa_wruti#BAraNa_wruti#noun#2#RM
loading_routine	BAraNa_nemakA#BAraNa_nemakA#noun#2#RM
local_access	sWAnIya_aBigama#sWAnIya_aBigama#noun#2#RM
local_area_network	sWAnIya_jAlakrama#sWAnIya_jAlakrama#noun#3#RM
local_exchange	sWAnIya_kenxra#sWAnIya_kenxra#noun#2#RM
local_line	sWAnIya_lAina#sWAnIya_lAina#noun#2#RM
local_loop	sWAnIya_pASa#sWAnIya_pASa#noun#2#RM
local_mode	sWAnIya_viXA#sWAnIya_viXA#noun#2#RM
local_service_area	sWAnIya_sevA_kRewra#sWAnIya_sevA_kRewra#noun#3#RM
local_switching_facility	sWAnIya_svicana_suviXA#sWAnIya_svicana_suviXA#noun#3#RM
locally_attached_station	sWAnawa:_baxXa_kenxra#sWAnawa:_baxXa_kenxra#noun#3#RM
location_counter	sWAna_nirXAraNa_paMjI#sWAna_nirXAraNa_paMjI#noun#2#RM
locator_variable	sWAna_nirXAraka_cara#sWAna_nirXAraka_cara#noun#2#RM
lock_up_table	uxroXa_sAraNI#uxroXa_sAraNI#noun#3#RM
locked_page	wAlakiwa_pqRTa#wAlakiwa_pqRTa#noun#2#RM
locked_record	wAlakiwa_aBileKa#wAlakiwa_aBileKa#noun#2#RM
loder_program	BAraka#BAraka#noun#2#RM
log_in=_log_on_)	sawrAraMBa#sawrAraMBa#noun#4#RM
log_off=_log_out_)	sawrAMwa#sawrAMwa#noun#4#RM
log_on	sawrAraMBa#sawrAraMBa#noun#2#RM
logic_analyzer	warka_viSleRiwra#warka_viSleRiwra#noun#2#RM
logic_chart=_flow_chart_)	warka_saMciwra/pravAha_saMciwra#warka_saMciwra/pravAha_saMciwra#noun#4#RM
logic_design	warka_aBikalpanA#warka_aBikalpanA#noun#2#RM
logic_function	warka_Palana#warka_Palana#noun#2#RM
logic_instruction	warka_anuxeSa#warka_anuxeSa#noun#2#RM
logic_operation	warka_saMkriyA#warka_saMkriyA#noun#2#RM
logic_shift	warka_saMgawa_visWApana#warka_saMgawa_visWApana#noun#2#RM
logic_state	warka_sWiwi#warka_sWiwi#noun#2#RM
logic_unit	warka_ekaka#warka_ekaka#noun#2#RM
logical_add	warkasaMgawa_yoga#warkasaMgawa_yoga#noun#2#RM
logical_analysis	warka_viSleRaNa#warka_viSleRaNa#noun#2#RM
logical_comparoson	warkasaMgawa_wulanA#warkasaMgawa_wulanA#noun#2#RM
logical_constant	warkasaMgawa_acara#warkasaMgawa_acara#noun#2#RM
logical_data_structure	warkasaMgawa_AMkadA_saMracanA#warkasaMgawa_AMkadA_saMracanA#noun#3#RM
logical_design	warkasaMgawa_aBikalpanA#warkasaMgawa_aBikalpanA#noun#2#RM
logical_diagram	warkasaMgawa_AreKa#warkasaMgawa_AreKa#noun#2#RM
logical_expression	warkasaMgawa_vyaMjaka#warkasaMgawa_vyaMjaka#noun#2#RM
logical_flow_chart	pravAha_saMciwra#pravAha_saMciwra#noun#3#RM
logical_if	warkasaMgawa_yaxi#warkasaMgawa_yaxi#noun#2#RM
logical_multiply	warkasaMgawa_guNA#warkasaMgawa_guNA#noun#2#RM
logical_operation	warkasaMgawa_saMkriyA#warkasaMgawa_saMkriyA#noun#2#RM
logical_operator	warkasaMgawa_saMkAraka#warkasaMgawa_saMkAraka#noun#2#RM
logical_page_number	warkasaMgawa_pqRTasaMKyA#warkasaMgawa_pqRTasaMKyA#noun#3#RM
logical_record	warkasaMgawa_aBileKa#warkasaMgawa_aBileKa#noun#2#RM
logical_record_block	warkasaMgawa_aBileKa_KaMdaka#warkasaMgawa_aBileKa_KaMdaka#noun#3#RM
logical_relation	warkasaMgawa_saMbaMXa#warkasaMgawa_saMbaMXa#noun#2#RM
logical_shift	warkasaMgawa_visWApana#warkasaMgawa_visWApana#noun#2#RM
logical_structure	warkasaMgawa_saMracanA#warkasaMgawa_saMracanA#noun#2#RM
logical_switch	warkasaMgawa_svica#warkasaMgawa_svica#noun#2#RM
logical_symbol	warkasaMgawa_prawIka#warkasaMgawa_prawIka#noun#2#RM
logical_unit	warkasaMgawa_ekaka#warkasaMgawa_ekaka#noun#2#RM
logical_variable	warkasaMgawa_cara#warkasaMgawa_cara#noun#2#RM
longitudinal_balance	anuxErXya_saMwulana#anuxErXya_saMwulana#noun#2#RM
longitudinal_induction_noise	anuxErXya_preraNa_rava#anuxErXya_preraNa_rava#noun#3#RM
look_ahead	axrAvalokaNa#axrAvalokaNa#noun#2#RM
look_ahead_carry	axrAvalokaNa_haswaMgawa#axrAvalokaNa_haswaMgawa#noun#3#RM
look_up	avalokaNa#avalokaNa#noun#2#RM
loop-back_test	pASa_vApasI_parIkRaNa#pASa_vApasI_parIkRaNa#noun#2#RM
loop_check	pASa_jAMca#pASa_jAMca#noun#2#RM
loop_complition	pASa_samApana#pASa_samApana#noun#2#RM
loop_control	pASa_niyaMwraNa#pASa_niyaMwraNa#noun#2#RM
loop_counter	pASa_gaNiwra#pASa_gaNiwra#noun#2#RM
loop_feed_back_signal	pASa_paSca_BaraNa_saMkewa#pASa_paSca_BaraNa_saMkewa#noun#4#RM
loop_initialization	pASa_prAraMBaNa#pASa_prAraMBaNa#noun#2#RM
loop_modification	pASa_Aparivarwana#pASa_Aparivarwana#noun#2#RM
loop_network	pASa_jAlakrama#pASa_jAlakrama#noun#2#RM
loop_self_checking	pASa_svajAMca#pASa_svajAMca#noun#3#RM
loop_start	pASa_prAraMBana#pASa_prAraMBana#noun#2#RM
loop_termination	pASAvasAna#pASAvasAna#noun#2#RM
loosely_coupled	SiWilawa:_yugmiwa#SiWilawa:_yugmiwa#noun#2#RM
loss_of_significance	sArWakawA_hAni#sArWakawA_hAni#noun#3#RM
low_byte	nimna_bAita#nimna_bAita#noun#2#RM
low_order	nimna_krama#nimna_krama#noun#2#RM
low_pass_filter	nimna_pAraka_niRyaMxaka#nimna_pAraka_niRyaMxaka#noun#3#RM
low_speed_storage	nimna_cAla_BaMdAraNa#nimna_cAla_BaMdAraNa#noun#3#RM
lower_bound	nimna_paribaMXa#nimna_paribaMXa#noun#2#RM
machenical_calculator	yAMwrika_parikaliwra#yAMwrika_parikaliwra#noun#2#RM
machine_address	yaMwra_pawA#yaMwra_pawA#noun#2#RM
machine_check_interruption	yaMwra_jAMca_wruti_bAXA#yaMwra_jAMca_wruti_bAXA#noun#3#RM
machine_code	yaMwra_kUta#yaMwra_kUta#noun#2#RM
machine_cycle	yaMwra_cakra#yaMwra_cakra#noun#2#RM
machine_dependent_language	yaMwrASriwa_BARA#yaMwrASriwa_BARA#noun#3#RM
machine_error	yaMwra_wruti#yaMwra_wruti#noun#2#RM
machine_idle_time	yaMwra_anupayoga_kAla#yaMwra_anupayoga_kAla#noun#3#RM
machine_independent	yaMwra_nirapekRa#yaMwra_nirapekRa#noun#2#RM
machine_independent_language	yaMwra_nirapekRa_BARA#yaMwra_nirapekRa_BARA#noun#3#RM
machine_independent_software	yaMwra_nirapekRa_prakriyA_sAmagrI#yaMwra_nirapekRa_prakriyA_sAmagrI#noun#3#RM
machine_instruction_code	yaMwra_anuxeSa_kUta#yaMwra_anuxeSa_kUta#noun#3#RM
machine_oriented_language	yaMwramUlaka_BARA#yaMwramUlaka_BARA#noun#3#RM
machine_readable	yaMwra_paTanIya#yaMwra_paTanIya#noun#2#RM
machine_tool_control	yaMwra_OjAra_niyaMwraNa#yaMwra_OjAra_niyaMwraNa#noun#3#RM
macro_assembler	sWUla_kodAMwaraka#sWUla_kodAMwaraka#noun#2#RM
macro_code	sWUla_kUta#sWUla_kUta#noun#2#RM
macro_command	sWUla_samAxeSa#sWUla_samAxeSa#noun#2#RM
macro_declaration	sWUla_GoRaNA#sWUla_GoRaNA#noun#2#RM
macro_definition	sWUla_pariBARA#sWUla_pariBARA#noun#2#RM
macro_definition_library	sWUla_pariBARA_kramAxeSa_saMgraha#sWUla_pariBARA_kramAxeSa_saMgraha#noun#3#RM
macrogenerating_program	sWUla_janaka_kramAxeSa#sWUla_janaka_kramAxeSa#noun#2#RM
macrolanguage_(_macrol_)	sWUla_BARA#sWUla_BARA#noun#3#RM
macroprocessing_instruction	sWUla_saMsAXana_anuxeSa#sWUla_saMsAXana_anuxeSa#noun#2#RM
magnetic_bubble_memory	cumbakIya_buxabuxa_smqwi#cumbakIya_buxabuxa_smqwi#noun#3#RM
magnetic_card_reader	cumbakIya_pawraka_paTiwra#cumbakIya_pawraka_paTiwra#noun#3#RM
magnetic_cell	cumbakIya_koRTikA#cumbakIya_koRTikA#noun#2#RM
magnetic_character	cumbakIya_saMprawIka#cumbakIya_saMprawIka#noun#2#RM
magnetic_core_storage	cumbakIya_kroda_BaMdAraNa#cumbakIya_kroda_BaMdAraNa#noun#3#RM
magnetic_disk	cumbakIya_cakrikA#cumbakIya_cakrikA#noun#2#RM
magnetic_disk_memory	cumbakIya_cakrikA_smqwi#cumbakIya_cakrikA_smqwi#noun#3#RM
magnetic_disk_storage	cumbakIya_cakrikA_BaMdAraNa#cumbakIya_cakrikA_BaMdAraNa#noun#3#RM
magnetic_disk_unit	cumbakIya_cakrikA_ekaka#cumbakIya_cakrikA_ekaka#noun#3#RM
magnetic_drum_storage	cumbakIya_drama_BaMdAraNa#cumbakIya_drama_BaMdAraNa#noun#3#RM
magnetic_drum_unit	cumbakIya_drama_ekaka#cumbakIya_drama_ekaka#noun#3#RM
magnetic_hand_scanner	cumbakIya_haswakramavIkRaka#cumbakIya_haswakramavIkRaka#noun#3#RM
magnetic_ink	cumbakIya_masi#cumbakIya_masi#noun#2#RM
magnetic_ink_character_sorter	cumbakIya_masi_saMprawIka_sAtiwra#cumbakIya_masi_saMprawIka_sAtiwra#noun#4#RM
magnetic_ink_scanner	cumbakIya_masi_kramavIkRaka#cumbakIya_masi_kramavIkRaka#noun#3#RM
magnetic_memory	cumbakIya_smqwi#cumbakIya_smqwi#noun#2#RM
magnetic_reading	cumbakIya_paTana#cumbakIya_paTana#noun#2#RM
magnetic_recording	cumbakIya_aBileKana#cumbakIya_aBileKana#noun#2#RM
magnetic_storage	cumbakIya_BaMdAraNa#cumbakIya_BaMdAraNa#noun#2#RM
magnetic_strip	cumbakIya_pattI#cumbakIya_pattI#noun#2#RM
magnetic_strip_reader	cumbakIya_pattI_paTiwra#cumbakIya_pattI_paTiwra#noun#3#RM
magnetic_tape_cartridge	cumbakIya_tepa_AgutikA#cumbakIya_tepa_AgutikA#noun#3#RM
magnetic_tape_cassete	cumbakIya_tepa_kEsata#cumbakIya_tepa_kEsata#noun#3#RM
magnetic_tape_drive	cumbakIya_tepa_cAliwra#cumbakIya_tepa_cAliwra#noun#3#RM
magnetic_tape_storage	cumbakIya_tepa_BaMdAraNa#cumbakIya_tepa_BaMdAraNa#noun#3#RM
magnetic_tape_unit	cumbakIya_tepa_ekaka#cumbakIya_tepa_ekaka#noun#3#RM
magnetic_thin_film	cumbakIya_wanu_parawa#cumbakIya_wanu_parawa#noun#3#RM
magnetic_thin_film_storage	cumbakIya_wanu_parawa_BaMdAraNa#cumbakIya_wanu_parawa_BaMdAraNa#noun#4#RM
magnetic_track	cumbakIya_paWa#cumbakIya_paWa#noun#2#RM
magneto-optic_disk_storage	cumbaka_prakASIya_cakrikA#cumbaka_prakASIya_cakrikA#noun#3#RM
magnetographic_printer	cumbakawva_leKI_muxiwra#cumbakawva_leKI_muxiwra#noun#2#RM
mail_box	dAka_bAksa#dAka_bAksa#noun#2#RM
mail_mergefile_merge_)	saMcikA_vilaya#saMcikA_vilaya#noun#3#RM
main_control_unit	muKya_niyaMwraNa_ekaka#muKya_niyaMwraNa_ekaka#noun#3#RM
main_distributing_frame	muKya_lAina_viwaraNa_Prema#muKya_lAina_viwaraNa_Prema#noun#3#RM
main_frame	aXi_saMsAXiwra/vqhawa_aBikaliwra#aXi_saMsAXiwra/vqhawa_aBikaliwra#noun#2#RM
main_frame_computer	vqhawa_aBikaliwra#vqhawa_aBikaliwra#noun#3#RM
main_memory	muKya_smqwi#muKya_smqwi#noun#2#RM
main_memory_mapping	muKya_smqwi_prawiciwraNa#muKya_smqwi_prawiciwraNa#noun#3#RM
main_path	muKya_paWa#muKya_paWa#noun#2#RM
main_program	muKya_kramAxeSa#muKya_kramAxeSa#noun#2#RM
main_switch	muKya_svica#muKya_svica#noun#2#RM
maintainance_panel	anurakRaNa_pattikA#anurakRaNa_pattikA#noun#2#RM
major_cycle	muKya_cakra#muKya_cakra#noun#2#RM
major_key	muKya_kuMjI#muKya_kuMjI#noun#2#RM
major_state	muKya_avasWA#muKya_avasWA#noun#2#RM
major_task	muKya_kArya#muKya_kArya#noun#2#RM
majority_element	bahusaMKyaka_avayava#bahusaMKyaka_avayava#noun#2#RM
majority_gatemajority_element_)	bahusaMKyaka_avayava#bahusaMKyaka_avayava#noun#3#RM
make_up_time	prawipUrwi_kAla#prawipUrwi_kAla#noun#3#RM
man_machine_simulation	mAnava_yaMwra_anukAra#mAnava_yaMwra_anukAra#noun#3#RM
management_information_system	prabaMXa_sUcanA_waMwra#prabaMXa_sUcanA_waMwra#noun#3#RM
manchester_coding	menacestara_kUta_leKana#menacestara_kUta_leKana#noun#2#RM
mandatory_cryptographic_session	anivArya_gUDaleKI_sawra#anivArya_gUDaleKI_sawra#noun#3#RM
manual_analysis	haswena_viSleRaNa#haswena_viSleRaNa#noun#2#RM
manual_calling	haswena_AhavAna#haswena_AhavAna#noun#2#RM
manual_exchange	haswacAliwa_kenxra#haswacAliwa_kenxra#noun#2#RM
manual_input	haswena_niveSa#haswena_niveSa#noun#2#RM
many_to_one_decoder	anekaka_kUtavAcaka#anekaka_kUtavAcaka#noun#4#RM
map_method	prawiciwra_viXi#prawiciwra_viXi#noun#2#RM
mapped_buffer	prawiciwriwa_cayaka#prawiciwriwa_cayaka#noun#2#RM
mapping_error	prawiciwraNa_wruti#prawiciwraNa_wruti#noun#2#RM
margin_punched_card	upAMwa_Cixriwa_pawraka#upAMwa_Cixriwa_pawraka#noun#3#RM
marginal_error	upAMwIya_wruti#upAMwIya_wruti#noun#2#RM
mark_matching	uccaga_sumelana#uccaga_sumelana#noun#2#RM
mark_scanning	cihna_kramavIkRaNa#cihna_kramavIkRaNa#noun#2#RM
markov_chain	mArkova_SrqMKalA#mArkova_SrqMKalA#noun#2#RM
mask_bit	AcCaxa_xviyaMka#AcCaxa_xviyaMka#noun#2#RM
mask_matching	AcCaxa_sumelana#AcCaxa_sumelana#noun#2#RM
mask_programmable_device	AcCaxa_kramAxeSya_yukwi#AcCaxa_kramAxeSya_yukwi#noun#3#RM
mask_register	AcCaxa_paMjI#AcCaxa_paMjI#noun#2#RM
mask_storage	vipula_BaMdAraNa#vipula_BaMdAraNa#noun#2#RM
mask_storage_online	yugpawa_vipula_BaMdAraNa#yugpawa_vipula_BaMdAraNa#noun#3#RM
maskable_interrupt	AcCAxanaNIla_aMwarAyaNa#AcCAxanaNIla_aMwarAyaNa#noun#2#RM
massage_block	saMxeSa_KaMdaka#saMxeSa_KaMdaka#noun#2#RM
massage_control_flag	saMxeSa_niyaMwraNa_pawAkA#saMxeSa_niyaMwraNa_pawAkA#noun#3#RM
massage_display_console	saMxeSa_praxarSa_kaMsola#saMxeSa_praxarSa_kaMsola#noun#3#RM
massage_error_record	saMxeSa_wruti_aBileKa#saMxeSa_wruti_aBileKa#noun#3#RM
massage_queue	saMxeSa_paMkwi#saMxeSa_paMkwi#noun#2#RM
massage_routine	saMxeSa_anumArgana#saMxeSa_anumArgana#noun#2#RM
massage_source	saMxeSa_srowa#saMxeSa_srowa#noun#2#RM
massage_switching	saMxeSa_svicana#saMxeSa_svicana#noun#2#RM
massage_switching_network	saMxeSa_svicana_jAlakrama#saMxeSa_svicana_jAlakrama#noun#3#RM
master/slave_device	praXAna/aXIna_yukwi#praXAna/aXIna_yukwi#noun#2#RM
master/slave_multiprogramming	praXAna/aXIna_bahukramAxeSana#praXAna/aXIna_bahukramAxeSana#noun#2#RM
master/slave_system	praXAna/aXIna_waMwra#praXAna/aXIna_waMwra#noun#2#RM
master_clock_frequency	niyaMwraka_GadI_bAraMbArawA#niyaMwraka_GadI_bAraMbArawA#noun#3#RM
master_console	praXAna_kaMsola#praXAna_kaMsola#noun#2#RM
master_file	praXAna_saMcikA#praXAna_saMcikA#noun#2#RM
master_file_inventory	praXAna_saMcikA_wAlikA#praXAna_saMcikA_wAlikA#noun#3#RM
master_library_tape	praXAna_kramAxeSa_saMgraha_tepa#praXAna_kramAxeSa_saMgraha_tepa#noun#3#RM
master_processor	praXAna_saMsAXiwra#praXAna_saMsAXiwra#noun#2#RM
master_program_file	praXAna_kramAxeSa_saMcikA#praXAna_kramAxeSa_saMcikA#noun#3#RM
master_record	praXAna_aBileKa#praXAna_aBileKa#noun#2#RM
mathematical_function	gaNiwIya_Palana#gaNiwIya_Palana#noun#2#RM
mathematical_logic	gaNiwIya_warka#gaNiwIya_warka#noun#2#RM
mathematical_model	gaNiwIya_nirxeSa#gaNiwIya_nirxeSa#noun#2#RM
mathematicl_simulation	gaNiwIya_anukAra#gaNiwIya_anukAra#noun#2#RM
matrix_printer	mEtriksa_muxriwra#mEtriksa_muxriwra#noun#2#RM
matrix_table	mEtriksa_sAraNI#mEtriksa_sAraNI#noun#2#RM
maximum_operating_frequency	aXikawama_pracAlana_Avqwwi#aXikawama_pracAlana_Avqwwi#noun#3#RM
mean_entropy	mAXya_iMtropI#mAXya_iMtropI#noun#2#RM
mean_repair_time	mAXya_marammawa_kAla#mAXya_marammawa_kAla#noun#3#RM
mean_time_of_failure	viPalawA_mAXya_kAla#viPalawA_mAXya_kAla#noun#4#RM
mean_time_to_repair	marammawa_mAXya_kAla#marammawa_mAXya_kAla#noun#4#RM
meantime_between_failures	aMwarviPalawA_mAXya_kAla#aMwarviPalawA_mAXya_kAla#noun#3#RM
measure_of_information	sUcanA_mApa#sUcanA_mApa#noun#3#RM
media_resident_software	mAXyama_sWiwi_prakriyA_sAmagrI#mAXyama_sWiwi_prakriyA_sAmagrI#noun#3#RM
memory_address_register	smqwi_pawA_paMjI#smqwi_pawA_paMjI#noun#3#RM
memory_allocation	smqwi_niyawana#smqwi_niyawana#noun#2#RM
memory_array	smqwi_sAraNI#smqwi_sAraNI#noun#2#RM
memory_buffer_register	smqwi_cayaka_paMjI#smqwi_cayaka_paMjI#noun#3#RM
memory_bus	smqwi_basa#smqwi_basa#noun#2#RM
memory_cell	smqwi_koRTikA#smqwi_koRTikA#noun#2#RM
memory_core	smqwi_kroda#smqwi_kroda#noun#2#RM
memory_data_register	smqwi_AMkadA_paMjI#smqwi_AMkadA_paMjI#noun#3#RM
memory_disable_signal	smqwi_niRkriyana_saMkewa#smqwi_niRkriyana_saMkewa#noun#3#RM
memory_enable_signal	smqwi_sakriyana_saMkewa#smqwi_sakriyana_saMkewa#noun#3#RM
memory_guard	smqwi_rakRaka#smqwi_rakRaka#noun#2#RM
memory_mapped_i/o	smqwi_prawiciwriwa_ni/ni#smqwi_prawiciwriwa_ni/ni#noun#3#RM
memory_mapped_video	smqwi_prawiciwriwa_vidiyo#smqwi_prawiciwriwa_vidiyo#noun#3#RM
memory_page	smqwi_pqRTa#smqwi_pqRTa#noun#2#RM
memory_protection	smqwi_rakRaNa#smqwi_rakRaNa#noun#2#RM
memory_reference_instruction	smqwi_saMxarBa_anuxeSa#smqwi_saMxarBa_anuxeSa#noun#3#RM
memory_register	smqwi_paMjI#smqwi_paMjI#noun#2#RM
memory_unit	smqwi_ekaka#smqwi_ekaka#noun#2#RM
memory_workspace	smqwi_kAryasWala#smqwi_kAryasWala#noun#2#RM
menu_selection	prasUci_varaNa#prasUci_varaNa#noun#2#RM
merge_sort	vilaya_sArtana#vilaya_sArtana#noun#2#RM
meta_assembler	aXikoda_aMwaraka#aXikoda_aMwaraka#noun#2#RM
meta_language	aXiBARA#aXiBARA#noun#2#RM
micro_electronics	sUkRma_ilektronikI#sUkRma_ilektronikI#noun#2#RM
micro_instruction	sUkRma_anuxeSa#sUkRma_anuxeSa#noun#2#RM
microcircuit_isolation	sUkRma_paripaWa_vilagana#sUkRma_paripaWa_vilagana#noun#2#RM
microcomputer_development_system	sUkRma_aBikaliwra_vikAsa_waMwra#sUkRma_aBikaliwra_vikAsa_waMwra#noun#3#RM
microcomputer_word_processing	sUkRma_aBikaliwra_Sabxa_saMsAXana#sUkRma_aBikaliwra_Sabxa_saMsAXana#noun#3#RM
microinstruction_sequence	sUkRma_anuxeSa_anukrama#sUkRma_anuxeSa_anukrama#noun#2#RM
microprocessor_architecture	sUkRma_saMsAXiwra_vAswukalA#sUkRma_saMsAXiwra_vAswukalA#noun#2#RM
microprocessor_chip	sUkRma_saMsAXiwra_patalikA#sUkRma_saMsAXiwra_patalikA#noun#2#RM
microprocessor_compiler	sUkRma_saMsAXiwra_anuBARaka#sUkRma_saMsAXiwra_anuBARaka#noun#2#RM
microprocessor_memory_interface	sUkRma_saMsAXiwra_smqwi_aMwarApqRTa#sUkRma_saMsAXiwra_smqwi_aMwarApqRTa#noun#3#RM
microprogram_control_logic	sUkRmAxeSIka_niyaMwraNa_warka#sUkRmAxeSIka_niyaMwraNa_warka#noun#3#RM
microprogram_instruction_set	sUkRmAxeSa_anuxeSa_samuccaya#sUkRmAxeSa_anuxeSa_samuccaya#noun#3#RM
microprogram_sequencer	sUkRmAxeSa_anukramaka#sUkRmAxeSa_anukramaka#noun#2#RM
microweb_link	sUkRma_waraMga_kadI#sUkRma_waraMga_kadI#noun#2#RM
migration_path	pravAsana_paWa#pravAsana_paWa#noun#2#RM
mini_diskette	laGu_namyikA#laGu_namyikA#noun#2#RM
minimal_tree	alpiRta_warU#alpiRta_warU#noun#2#RM
minimax_procedure	alpa_mahiRTa_kriyAviXi#alpa_mahiRTa_kriyAviXi#noun#2#RM
minimum_cost_spanning_tree	nimnawama_lAgawa_viwAna_warU#nimnawama_lAgawa_viwAna_warU#noun#4#RM
minimum_distance_code	alpawama_xUrI_kUta#alpawama_xUrI_kUta#noun#3#RM
minimum_latency_coding	alpawama_prasUkwi_kUtaleKana#alpawama_prasUkwi_kUtaleKana#noun#3#RM
mismanagement_information_system_)	misa(prabaMXa_sUcanA_waMwra)#misa(prabaMXa_sUcanA_waMwra)#noun#3#RM
mixed_mode_expression	miSriwa_viXA_vyaMjaka#miSriwa_viXA_vyaMjaka#noun#3#RM
mixed_type_expression	miSriwa_prakAra_vyaMjaka#miSriwa_prakAra_vyaMjaka#noun#3#RM
mnemonic_symbol	smaraka_prawIka#smaraka_prawIka#noun#2#RM
modem_incryption_device	modema_gUDaleKana_yukwi#modema_gUDaleKana_yukwi#noun#3#RM
modifier_register	Aparivarwaka_paMjI#Aparivarwaka_paMjI#noun#2#RM
modular_programming	prawirUpaka_kramAxeSana#prawirUpaka_kramAxeSana#noun#2#RM
modulator_demodulater	mAdulaka_vimAdulaka#mAdulaka_vimAdulaka#noun#2#RM
monitor_console	monitara_kaMsola#monitara_kaMsola#noun#2#RM
monitor_program	monitara_kramAxeSa#monitara_kramAxeSa#noun#2#RM
monolythic_technology	ekAXAra_prOxyogikI#ekAXAra_prOxyogikI#noun#2#RM
most_significant_character	sArWakawama_saMprawIka#sArWakawama_saMprawIka#noun#3#RM
most_significent_bit	sArWakawama_xviyaMka#sArWakawama_xviyaMka#noun#3#RM
mount_attribute	Aroha_guNa#Aroha_guNa#noun#2#RM
multiaccess_system	bahu_aBigama_waMwra#bahu_aBigama_waMwra#noun#2#RM
multidimensional_array	bahuvima_sAraNI#bahuvima_sAraNI#noun#2#RM
multidimensional_language	bahuvima_BARA#bahuvima_BARA#noun#2#RM
multidomain_network	bahuprAMwa_jAlakrama#bahuprAMwa_jAlakrama#noun#2#RM
multilayer_device	bahuparawa_yukwi#bahuparawa_yukwi#noun#2#RM
multilevel_security	bahuswara_surakRA#bahuswara_surakRA#noun#2#RM
multimedia_mail	bahumAXyama_dAka#bahumAXyama_dAka#noun#2#RM
multiple_address_instruction	bahu_pawA_anuxeSa#bahu_pawA_anuxeSa#noun#3#RM
multiple_connecter	bahu_saMbaMXaka#bahu_saMbaMXaka#noun#2#RM
multiple_job_processing	bahu_kArya_saMsAXana#bahu_kArya_saMsAXana#noun#3#RM
multiple_operation	bahu_saMkriyA#bahu_saMkriyA#noun#2#RM
multiple_programming	bahu_kramAxeSana#bahu_kramAxeSana#noun#2#RM
multiplex_data_terminal	bahu_saMkewana_AMkadA_aMwaka#bahu_saMkewana_AMkadA_aMwaka#noun#3#RM
multiplex_mode	bahuBAgI_viXA#bahuBAgI_viXA#noun#2#RM
multiplexed_bus	bahu_saMkewiwa_basa#bahu_saMkewiwa_basa#noun#2#RM
multiprocessing_system	bahusaMsAXana_paxXawi#bahusaMsAXana_paxXawi#noun#2#RM
multiprogramming_system	bahu_kramAxeSana_paxXawi#bahu_kramAxeSana_paxXawi#noun#2#RM
multiuser_system	bahuupayokwA_paxXawi#bahuupayokwA_paxXawi#noun#2#RM
multivalued_logic	bahumAnI_warka#bahumAnI_warka#noun#2#RM
multiway_search_tree	bahuXA_Koja_warU#bahuXA_Koja_warU#noun#3#RM
mutual_exclusion	paraspara_apavarjana#paraspara_apavarjana#noun#2#RM
nand_operation	waWApUraka_saMkriyA#waWApUraka_saMkriyA#noun#2#RM
nano_processor	nEno_saMsAXiwra#nEno_saMsAXiwra#noun#2#RM
nano_program_store	nEno_kramAxeSa_BaMdAra#nEno_kramAxeSa_BaMdAra#noun#3#RM
narrow_brand	saMkIrNa_bEMda#saMkIrNa_bEMda#noun#2#RM
native_code	prAkqwa_kUta#prAkqwa_kUta#noun#2#RM
native_compiler	prAkqwa_anuBARaka#prAkqwa_anuBARaka#noun#2#RM
natural_language	prAkqwika_BARA#prAkqwika_BARA#noun#2#RM
negative_feedback	qNAwmaka_punarBaraNa#qNAwmaka_punarBaraNa#noun#2#RM
neither_-_nor_operationnor_operation_)	aWavA_pUraka_saMkriyA#aWavA_pUraka_saMkriyA#noun#5#RM
nested_macros	nidiwa_sWUlAxeSa#nidiwa_sWUlAxeSa#noun#2#RM
net_structure	jAlakrama_saMracanA#jAlakrama_saMracanA#noun#2#RM
network_access_control	jAlakrama_aBigama_niyaMwraNa#jAlakrama_aBigama_niyaMwraNa#noun#3#RM
network_access_machine	jAlakrama_aBigama_yaMwra#jAlakrama_aBigama_yaMwra#noun#3#RM
network_application	jAlakrama_anuprayoga#jAlakrama_anuprayoga#noun#2#RM
network_architecture	jAlakrama_sWApawya_kalA#jAlakrama_sWApawya_kalA#noun#2#RM
network_component	jAlakrama_Gataka#jAlakrama_Gataka#noun#2#RM
network_control_program_generation	jAlakrama_niyaMwraNa_kramAxeSa_janana#jAlakrama_niyaMwraNa_kramAxeSa_janana#noun#4#RM
network_database_system	jAlakrama_AMkadA_saMcaya_praNAlI#jAlakrama_AMkadA_saMcaya_praNAlI#noun#3#RM
network_interconnection	jAlakrama_aMwa:saMbaMXana#jAlakrama_aMwa:saMbaMXana#noun#2#RM
network_layer	jAlakrama_parawa#jAlakrama_parawa#noun#2#RM
network_node	jAlakrama_AsaMXi#jAlakrama_AsaMXi#noun#2#RM
network_toplogy	jAlakrama_sAMsWiwikI#jAlakrama_sAMsWiwikI#noun#2#RM
network_virtual_terminal	jAlakrama_kalpiwa_aMwaka#jAlakrama_kalpiwa_aMwaka#noun#3#RM
neutral_ground	uxAsIna_BUmiyana#uxAsIna_BUmiyana#noun#2#RM
newline_character	naI_paMkwi_saMprawIka#naI_paMkwi_saMprawIka#noun#2#RM
nines_compliment	navapUraka#navapUraka#noun#2#RM
noise_characteristics	rava_aBilakRaNa#rava_aBilakRaNa#noun#2#RM
noise_level	rava_swara#rava_swara#noun#2#RM
noise_source	rava_srowa#rava_srowa#noun#2#RM
noiseless_coding	ravahIna_kUtaleKana#ravahIna_kUtaleKana#noun#2#RM
non-coherent_modulation_system	asaMsakwa_mAdulana_waMwra#asaMsakwa_mAdulana_waMwra#noun#3#RM
non-contiguous_item	anAsanna_maxa#anAsanna_maxa#noun#2#RM
non-destructive_read	avinASakArI_paTana#avinASakArI_paTana#noun#2#RM
non-destructive_read_out	avinASakArI_paTana#avinASakArI_paTana#noun#3#RM
non-determinasic_automata	anirXAraNAwmaka_svacala_prarUpa#anirXAraNAwmaka_svacala_prarUpa#noun#2#RM
non-erasable_medium	avyAmArjanIya_mAXyama#avyAmArjanIya_mAXyama#noun#2#RM
non-erasable_programmable_device	avyAmArjanIya_kramAxeSya_saMyukwa#avyAmArjanIya_kramAxeSya_saMyukwa#noun#3#RM
non-executable_statement	aniRpAxq_kaWana#aniRpAxq_kaWana#noun#2#RM
non-impact_printer	asaMGatata_muxriwra#asaMGatata_muxriwra#noun#2#RM
non-linear_distortion	arEKika_virUpaNa#arEKika_virUpaNa#noun#2#RM
non-linear_programming	arEKika_progrAmana#arEKika_progrAmana#noun#2#RM
non-mapping_mode	aprawiciwraNa_viXA#aprawiciwraNa_viXA#noun#2#RM
non-programmed_halt	akramAxeSiwa_virAma#akramAxeSiwa_virAma#noun#2#RM
non-real-time_processing	vAswavika_kAlewara_saMsAXana#vAswavika_kAlewara_saMsAXana#noun#2#RM
non-recoverable_error	puna:_aprApya_wruti#puna:_aprApya_wruti#noun#2#RM
non-resident_position	apravAsI_BAga#apravAsI_BAga#noun#2#RM
non-terminal_mode	aMkewara_AsaMXi#aMkewara_AsaMXi#noun#2#RM
non-transparent_mode	apAragamya_viXA#apAragamya_viXA#noun#2#RM
non-volatile_memory	ahrAsI_smqwi#ahrAsI_smqwi#noun#2#RM
non-volatile_storage	ahrAsI_BaMdAraNa#ahrAsI_BaMdAraNa#noun#2#RM
non_character_string	rikwa_saMprawIka_rajju#rikwa_saMprawIka_rajju#noun#3#RM
nop_instruction	saMkriyAhIna_anuxeSa#saMkriyAhIna_anuxeSa#noun#2#RM
nor_element	aWavApUraka_avyaya#aWavApUraka_avyaya#noun#2#RM
nor_gate	aWavApUraka_xvAra#aWavApUraka_xvAra#noun#2#RM
normalized_device_coordinate	prasAmAnyIkqwa_yukwi_nirxeSAMka#prasAmAnyIkqwa_yukwi_nirxeSAMka#noun#3#RM
not-both_operationnon_conjuction_)	waWApUraka_saMkriyA#waWApUraka_saMkriyA#noun#3#RM
not-if_then_element	apavarjana_avayava#apavarjana_avayava#noun#3#RM
not_element	pUraka_avayava#pUraka_avayava#noun#2#RM
null_character	rikwa_saMprawIka#rikwa_saMprawIka#noun#2#RM
null_line	SUnya_reKA#SUnya_reKA#noun#2#RM
null_record	rikwa_aBileKa#rikwa_aBileKa#noun#2#RM
number_cruncher	saMKyA_kraMcara#saMKyA_kraMcara#noun#2#RM
number_representation_system	saMKyA_nirUpaNa_waMwra#saMKyA_nirUpaNa_waMwra#noun#3#RM
numbering_plan	aMkaNa_yojanA#aMkaNa_yojanA#noun#2#RM
numeric_character_data	saMKyAMka_saMprawIka_AMkade#saMKyAMka_saMprawIka_AMkade#noun#3#RM
numeric_character_set	saMKyAMka_saMprawIka_samuccaya#saMKyAMka_saMprawIka_samuccaya#noun#3#RM
numeric_code	sAMKyAMka_kUta#sAMKyAMka_kUta#noun#2#RM
numeric_pad	sAMKyAMka_pEda#sAMKyAMka_pEda#noun#2#RM
numeric_string	sAMKyAMka_rajjU#sAMKyAMka_rajjU#noun#2#RM
numerical_code	saMKyAwmaka_kUta#saMKyAwmaka_kUta#noun#2#RM
numerical_control	saMKyAwmaka_niyaMwraNa#saMKyAwmaka_niyaMwraNa#noun#2#RM
numerical_data	saMKyAwmaka_AMkade#saMKyAwmaka_AMkade#noun#2#RM
object_code	aBilakRya_kUta#aBilakRya_kUta#noun#2#RM
object_computer	aBilakRyI_aBikaliwra#aBilakRyI_aBikaliwra#noun#2#RM
object_language	aBilakRa_BARA#aBilakRa_BARA#noun#2#RM
object_module	aBilakRa_prawirUpaka#aBilakRa_prawirUpaka#noun#2#RM
object_oriented_architecture	aBilakRyI_sWApawya_kalA#aBilakRyI_sWApawya_kalA#noun#3#RM
object_oriented_language	aBilakRyI_BARA#aBilakRyI_BARA#noun#3#RM
object_program	aBilakRya_kramAxeSa#aBilakRya_kramAxeSa#noun#2#RM
objective_function	uxxeSya_Palana#uxxeSya_Palana#noun#2#RM
octal_digit	aRtAXArI_aMka#aRtAXArI_aMka#noun#2#RM
octal_number_system	aRtAXArI_saMKyA_paxXawi#aRtAXArI_saMKyA_paxXawi#noun#3#RM
odd_parity	viRama_samawA#viRama_samawA#noun#2#RM
odd_parity_check	viRama_samawA_jAMca#viRama_samawA_jAMca#noun#3#RM
off-line_mode	lAinewara_viXA#lAinewara_viXA#noun#2#RM
off-line_processing	lAinewara_saMsAXana#lAinewara_saMsAXana#noun#2#RM
off-line_storage	lAinewara_BaMdAraNa#lAinewara_BaMdAraNa#noun#2#RM
office_automation	kAryAlaya_svacAlana#kAryAlaya_svacAlana#noun#2#RM
offset_stacker	APaseta_ciwikara#APaseta_ciwikara#noun#2#RM
on-chip_control_logic	patalikA_ArUDa_niyaMwraNa_warka#patalikA_ArUDa_niyaMwraNa_warka#noun#3#RM
on-line_communication	lAina_ArUDa_saMcAra#lAina_ArUDa_saMcAra#noun#2#RM
on-line_diagnostics	lAina_ArUDa_nixAnikI#lAina_ArUDa_nixAnikI#noun#2#RM
on-line_equipment	lAina_ArUDa_upakaraNa#lAina_ArUDa_upakaraNa#noun#2#RM
on-line_input	yugapawa_niveSa#yugapawa_niveSa#noun#2#RM
on-line_plotter	lAina_ArUDa_AleKiwra#lAina_ArUDa_AleKiwra#noun#2#RM
on-line_processing	lAina_ArUDa_saMsAXana#lAina_ArUDa_saMsAXana#noun#2#RM
on-line_programming	lAina_ArUDa_kramAxeSana#lAina_ArUDa_kramAxeSana#noun#2#RM
on-line_searching	yugapawa_Koja#yugapawa_Koja#noun#2#RM
on-line_system	yugapawa_waMwra#yugapawa_waMwra#noun#2#RM
on-line_testing	yugapawa_parIkRaNa#yugapawa_parIkRaNa#noun#2#RM
on_demand_system	mAMga_waMwra#mAMga_waMwra#noun#3#RM
one-level_address	eka_swara_pawA#eka_swara_pawA#noun#2#RM
one-step_operation	eka_caraNa_saMkriyA#eka_caraNa_saMkriyA#noun#2#RM
one_to_one_assembler	ekEka_kodAMwaraNa#ekEka_kodAMwaraNa#noun#4#RM
one_to_one_function	ekEka_Palana#ekEka_Palana#noun#4#RM
one_way_communication	ekaxiSika_saMcAra#ekaxiSika_saMcAra#noun#3#RM
one_way_linked_list	ekaxiSika_SrqMKaliwa_sUci#ekaxiSika_SrqMKaliwa_sUci#noun#4#RM
one_way_transmission	ekaxiSiwa_saMcaraNa#ekaxiSiwa_saMcaraNa#noun#3#RM
onto_function	AcCAxaka_Palana#AcCAxaka_Palana#noun#2#RM
op_register	saMkriyA_paMjI#saMkriyA_paMjI#noun#2#RM
open_collector	vivqwa_saMgrAhI#vivqwa_saMgrAhI#noun#2#RM
open_file	vivqwa_saMcikA#vivqwa_saMcikA#noun#2#RM
open_loop_system	vivqwa_pASa_waMwra#vivqwa_pASa_waMwra#noun#3#RM
open_routine	vivqwa_nemakA#vivqwa_nemakA#noun#2#RM
open_shop_operation	svayaMsevI_pracAlana#svayaMsevI_pracAlana#noun#3#RM
open_system	vivqwa_waMwra#vivqwa_waMwra#noun#2#RM
open_system_interworking	vivqwa_waMwra_Anwara_pracAlana#vivqwa_waMwra_Anwara_pracAlana#noun#3#RM
open_wire	KulA_wAra/nagna_wAra#KulA_wAra/nagna_wAra#noun#2#RM
operate_mode	pracAlana_viXA#pracAlana_viXA#noun#2#RM
operater_control_panel	pracAlana_niyaMwraNa_pattikA#pracAlana_niyaMwraNa_pattikA#noun#3#RM
operating_invironment	pracAlana_pariveSa#pracAlana_pariveSa#noun#2#RM
operating_system	pracAlana_waMwra#pracAlana_waMwra#noun#2#RM
operating_system_function	pracAlana_waMwra_Palana#pracAlana_waMwra_Palana#noun#3#RM
operating_time	pracAlana_avaXi#pracAlana_avaXi#noun#2#RM
operation_code	saMkriyA_kUta#saMkriyA_kUta#noun#2#RM
operation_cycle	pracAlana_cakra#pracAlana_cakra#noun#2#RM
operation_part	saMkriyA_BAga#saMkriyA_BAga#noun#2#RM
operation_time	pracAlana_kAla#pracAlana_kAla#noun#2#RM
operational_unit	pracAlanI_ekaka#pracAlanI_ekaka#noun#2#RM
operator_console	pracAlaka_kaMsola#pracAlaka_kaMsola#noun#2#RM
operator_massage	Aparetara_saMxeSa#Aparetara_saMxeSa#noun#2#RM
optical_character_recognition	prakASika_saMprawIka_aBijFA#prakASika_saMprawIka_aBijFA#noun#3#RM
optical_fibre	prakASika_PAibara#prakASika_PAibara#noun#2#RM
optical_mark_reading	prakASika_cinha_pATyAMka#prakASika_cinha_pATyAMka#noun#3#RM
optical_reader	prakASiya_paTiwra#prakASiya_paTiwra#noun#2#RM
optical_scanner	prakASika_kramavIkRaka#prakASika_kramavIkRaka#noun#2#RM
optimum_coding	iRtawama_kUtaleKana#iRtawama_kUtaleKana#noun#2#RM
option_list	vikalpa_sUci#vikalpa_sUci#noun#2#RM
optional_pause_instruction	vEkalpika_viSrAma_anuxeSa#vEkalpika_viSrAma_anuxeSa#noun#3#RM
opto_electronic_technology	Apto_ilektrionikIya_prOxyogikI#Apto_ilektrionikIya_prOxyogikI#noun#3#RM
or_circuit	aWavA_paripaWa#aWavA_paripaWa#noun#2#RM
or_gate	aWavA_xvAra#aWavA_xvAra#noun#2#RM
ordered_tree	kramiwa_warU#kramiwa_warU#noun#2#RM
ordering_relation	krama_saMvAxa#krama_saMvAxa#noun#2#RM
ordinary_symbol	sAXAraNa_prawIka#sAXAraNa_prawIka#noun#2#RM
oscillating_sort	xolanI_SAtana#xolanI_SAtana#noun#2#RM
out_degree	bAhya_koti#bAhya_koti#noun#2#RM
output_area	nirgama_kRewra#nirgama_kRewra#noun#2#RM
output_capacity	nirgama_kRamawA#nirgama_kRamawA#noun#2#RM
output_channel	nirgama_praNAla#nirgama_praNAla#noun#2#RM
output_data	nirgama_AMkade#nirgama_AMkade#noun#2#RM
output_device	nirgama_yukwi#nirgama_yukwi#noun#2#RM
output_file	nirgama_saMcikA#nirgama_saMcikA#noun#2#RM
output_limited_system	nirgama_sImiwa_waMwra#nirgama_sImiwa_waMwra#noun#3#RM
output_module	nirgama_prawirUpaka#nirgama_prawirUpaka#noun#2#RM
output_queue	nirgama_paMkwi#nirgama_paMkwi#noun#2#RM
output_register	nirgama_paMjI#nirgama_paMjI#noun#2#RM
output_register_buffer	nirgama_paMjI_cayaka#nirgama_paMjI_cayaka#noun#3#RM
output_routine	nirgama_nemakA#nirgama_nemakA#noun#2#RM
output_statement	nirgama_kaWana#nirgama_kaWana#noun#2#RM
output_unit	nirgama_ekaka#nirgama_ekaka#noun#2#RM
output_work_queue	nirgama_kArya_paMkwi#nirgama_kArya_paMkwi#noun#3#RM
overflow_check	aXipravAha_jAMca#aXipravAha_jAMca#noun#2#RM
overflow_condition	aXipravAha_xaSA#aXipravAha_xaSA#noun#2#RM
overflow_error	aXipravAha_wruti#aXipravAha_wruti#noun#2#RM
packed_array	saMkuliwa_saraNI#saMkuliwa_saraNI#noun#2#RM
packet_format	pEkata_saMrUpa#pEkata_saMrUpa#noun#2#RM
packet_layer_protocol	pEketa_parawa_saMxeSAcAra#pEketa_parawa_saMxeSAcAra#noun#3#RM
packet_radio	pEkata_rediyo#pEkata_rediyo#noun#2#RM
packet_switching	pEkata_svicana#pEkata_svicana#noun#2#RM
page_addressing	pqRTa_pawABigamana#pqRTa_pawABigamana#noun#2#RM
page_display	pqRTa_praxarSa#pqRTa_praxarSa#noun#2#RM
page_frame	pqRTa_Prema#pqRTa_Prema#noun#2#RM
page_in	aMwargawa_pqRTa#aMwargawa_pqRTa#noun#2#RM
page_out	bahirgawa_pqRTa#bahirgawa_pqRTa#noun#2#RM
page_swapping	pqRTa_vinimaya#pqRTa_vinimaya#noun#2#RM
page_table	pqRTa_sAraNI#pqRTa_sAraNI#noun#2#RM
paged_memory	pqRTiwa_smqwi#pqRTiwa_smqwi#noun#2#RM
paged_memory_management	pqRTiwa_smqwibaMXa#pqRTiwa_smqwibaMXa#noun#3#RM
paged_segmentation	pqRTiwa_viBAjana#pqRTiwa_viBAjana#noun#2#RM
paging_device	pqRTana_yukwi#pqRTana_yukwi#noun#2#RM
paging_technique	pqRTana_wakanIka#pqRTana_wakanIka#noun#2#RM
panel_data_set	pattikA_AMkadA_samuccaya#pattikA_AMkadA_samuccaya#noun#3#RM
paper_advance_unit	kAgaja_agrima_ekaka#kAgaja_agrima_ekaka#noun#3#RM
paper_jam	kAgaja_avaroXa#kAgaja_avaroXa#noun#2#RM
paper_senser	kAgaja_saMvexiwra#kAgaja_saMvexiwra#noun#2#RM
paper_sensing	kAgaja_saMvexana#kAgaja_saMvexana#noun#2#RM
paper_skip	kAgaja_xruwa_GUrNana#kAgaja_xruwa_GUrNana#noun#2#RM
paper_tape	kAgaja_tepa#kAgaja_tepa#noun#2#RM
paper_tape_output_device	kAgaja_tepa_nirgama_yukwi#kAgaja_tepa_nirgama_yukwi#noun#4#RM
paper_tape_reader	kAgaja_tepa_paTiwra#kAgaja_tepa_paTiwra#noun#3#RM
paper_tape_recorder	kAgaja_tepa_aBileKiwra#kAgaja_tepa_aBileKiwra#noun#3#RM
paragraph_header	pErAgrAPa_praveSikA#pErAgrAPa_praveSikA#noun#2#RM
parallel_access	yugapawa_aBigama#yugapawa_aBigama#noun#2#RM
parallel_algorithm	yugapawa_kalana_viXi#yugapawa_kalana_viXi#noun#2#RM
parallel_bianary_adder	yugapawa_xviAXArI_yojaka#yugapawa_xviAXArI_yojaka#noun#3#RM
parallel_bit_transmission	yugapawa/xviyaMka_saMcaraNa#yugapawa/xviyaMka_saMcaraNa#noun#3#RM
parallel_computer	yugapawa_aBikaliwra#yugapawa_aBikaliwra#noun#2#RM
parallel_input/output	yugapawa_niveSa_nirgama#yugapawa_niveSa_nirgama#noun#2#RM
parallel_interface	yugapawa_aMwarApqRTa#yugapawa_aMwarApqRTa#noun#2#RM
parallel_operation	yugapawa_saMkriyA#yugapawa_saMkriyA#noun#2#RM
parallel_processing_computer	yugapawa_saMsAXana_aBikaliwra#yugapawa_saMsAXana_aBikaliwra#noun#3#RM
parallel_programming	yugapawa_kramAxeSana#yugapawa_kramAxeSana#noun#2#RM
parallel_search_storage	yugapawa_Koja_BaMdAraNa#yugapawa_Koja_BaMdAraNa#noun#3#RM
parameter_passing	prAcala_pAraNa#prAcala_pAraNa#noun#2#RM
parameter_testing	prAcala_parIkRaNa#prAcala_parIkRaNa#noun#2#RM
parity_bit	samawA_xviaMka#samawA_xviaMka#noun#2#RM
parity_check	samawA_jAMca#samawA_jAMca#noun#2#RM
parity_check_code	samawA_jAMca_kUta#samawA_jAMca_kUta#noun#3#RM
parity_flag	samawA_pawAkA#samawA_pawAkA#noun#2#RM
parse_tree	paxa_vyAKyA_warU#paxa_vyAKyA_warU#noun#2#RM
partial_ordering	AMSika_kramaNa#AMSika_kramaNa#noun#2#RM
pascal_plus	pAskalaplasa#pAskalaplasa#noun#2#RM
passband_channel	pAraNa_bEMda_praNAla#pAraNa_bEMda_praNAla#noun#2#RM
passive_graphics	niRikraya_AleKikI#niRikraya_AleKikI#noun#2#RM
passive_mode	niRkriya_viXA#niRkriya_viXA#noun#2#RM
patch_routine	yaWecCa_yojaka_nemakA#yaWecCa_yojaka_nemakA#noun#2#RM
path_analysis	paWa_viSleRaNa#paWa_viSleRaNa#noun#2#RM
pattern_recognition	prawirUpa_aBijFAna#prawirUpa_aBijFAna#noun#2#RM
pause_instruction	viSrAma_anuxeSa#viSrAma_anuxeSa#noun#2#RM
pc_junior	bAlasUkRma_aBikaliwra#bAlasUkRma_aBikaliwra#noun#2#RM
peak_load	SiKara_loda#SiKara_loda#noun#2#RM
peer_to_peer	samaswara#samaswara#noun#3#RM
peer_to_peer_comunication	samaswara_saMcAra#samaswara_saMcAra#noun#4#RM
perforated_tape	avaCixriwa_tepa#avaCixriwa_tepa#noun#2#RM
performance_analysis_and_evalution	niRpAxana_viSleRaNa_Ora_mUlyAMkaNa#niRpAxana_viSleRaNa_Ora_mUlyAMkaNa#noun#4#RM
performance_evalution	niRpAxana_mUlyAMkaNa#niRpAxana_mUlyAMkaNa#noun#2#RM
performance_objective	niRpAxana_uxxeSya#niRpAxana_uxxeSya#noun#2#RM
performance_requirement	niRpAxana_AvaSyakawA#niRpAxana_AvaSyakawA#noun#2#RM
peripheral_bus	upAMwIya_basa#upAMwIya_basa#noun#2#RM
peripheral_control_unit	upAMwIya_niyaMwrana_ekaka#upAMwIya_niyaMwrana_ekaka#noun#3#RM
peripheral_device	upAMwIya_yukwi#upAMwIya_yukwi#noun#2#RM
peripheral_mode	upAMwIya_AsaMXi#upAMwIya_AsaMXi#noun#2#RM
peripheral_processor	upAMwIya_saMsAXiwra#upAMwIya_saMsAXiwra#noun#2#RM
permanent_error	sWAyI_wruti#sWAyI_wruti#noun#2#RM
permanent_memory	sWAyI_smqwi#sWAyI_smqwi#noun#2#RM
permanent_storage	sWAyI_BaMdAraNa#sWAyI_BaMdAraNa#noun#2#RM
personal_computer	vEyakwika_aBikaliwra#vEyakwika_aBikaliwra#noun#2#RM
petri_net	petrI_jAla#petrI_jAla#noun#2#RM
phase_distortion	kalA_virUpaNa#kalA_virUpaNa#noun#2#RM
phase_inversion_modulation	kalA_prawilomaNa_mAdulana#kalA_prawilomaNa_mAdulana#noun#3#RM
phonetic_system	svana_waMwra#svana_waMwra#noun#2#RM
photo_lithography	prakASa_aSma_leKana#prakASa_aSma_leKana#noun#2#RM
photo_micrography	sUkRmaxarSIya_PotogrAPI#sUkRmaxarSIya_PotogrAPI#noun#2#RM
photo_sensor	prakASa_saMvexiwra#prakASa_saMvexiwra#noun#2#RM
physical_block	BOwika_KaMdaka#BOwika_KaMdaka#noun#2#RM
physical_connection	BOwika_saMbaMXana#BOwika_saMbaMXana#noun#2#RM
physical_main_storage	Bowika_muKya_BaMdAraNa#Bowika_muKya_BaMdAraNa#noun#3#RM
physical_record_block	BOwika_aBileKa_KaMdaka#BOwika_aBileKa_KaMdaka#noun#3#RM
physical_segment	BOwika_KaMda#BOwika_KaMda#noun#2#RM
physical_volume	BOwika_Ayawana#BOwika_Ayawana#noun#2#RM
pico_second	piko_sekaNda#piko_sekaNda#noun#2#RM
picture_element	ciwra_alpAMSa#ciwra_alpAMSa#noun#2#RM
picture_processing	ciwra_saMsAXana#ciwra_saMsAXana#noun#2#RM
piggy_back_hardware	pqcCalagna_yaMwra_sAmagrI#pqcCalagna_yaMwra_sAmagrI#noun#3#RM
pilot_model	mArgaxarSI_nixarSa#mArgaxarSI_nixarSa#noun#2#RM
pipeline_processing	saMpaMkwi_saMsAXana#saMpaMkwi_saMsAXana#noun#2#RM
planar_graph	samawalI_AleKa#samawalI_AleKa#noun#2#RM
plasma_panel	plAjmA_pattikA#plAjmA_pattikA#noun#2#RM
plotting_head	AleKana_SIrRa#AleKana_SIrRa#noun#2#RM
pneunatic_logic	vAwIya_warka#vAwIya_warka#noun#2#RM
pocket_sorting	saMcayikA_sAtana#saMcayikA_sAtana#noun#2#RM
point_to_point_connection	viMxuSa:_saMbaMXana#viMxuSa:_saMbaMXana#noun#4#RM
point_to_point_transmission	viMxuSa:_saMcaraNa#viMxuSa:_saMcaraNa#noun#4#RM
pointer_variable	sUcaka_cara#sUcaka_cara#noun#2#RM
polar_operation	XruvI_pracAlana#XruvI_pracAlana#noun#2#RM
polar_signal	XruvI_saMkewa#XruvI_saMkewa#noun#2#RM
polling_character	kramavaraNa_saMprawIka#kramavaraNa_saMprawIka#noun#2#RM
polynomial_code	bahupaxakUta#bahupaxakUta#noun#2#RM
polynomial_equation	bahupaxa_samIkaraNa#bahupaxa_samIkaraNa#noun#2#RM
pooling_block	pUraNaKaMdaka#pUraNaKaMdaka#noun#2#RM
pop-push_instruction	saMkarRa_saMBara_anuxeSa#saMkarRa_saMBara_anuxeSa#noun#2#RM
port_circuit	saMxvAra_paripaWa#saMxvAra_paripaWa#noun#2#RM
positional_notation	sWiwimUlaka_aMkaNa_paxXawi#sWiwimUlaka_aMkaNa_paxXawi#noun#2#RM
positional_parameter	sWiwimUlaka_prAcala#sWiwimUlaka_prAcala#noun#2#RM
positional_representation_system	sWiwi_mUlaka_panarUpaNa_paxXawi#sWiwi_mUlaka_panarUpaNa_paxXawi#noun#3#RM
positioning_time	sWiwi_nirXAraNa_samaya#sWiwi_nirXAraNa_samaya#noun#2#RM
positive_logic	sakArAwmaka_warka#sakArAwmaka_warka#noun#2#RM
post_condition	paSca_avasWA#paSca_avasWA#noun#2#RM
post_fix_notation=suffix_notation_)	anulagna_saMkewaka#anulagna_saMkewaka#noun#4#RM
post_order_traversal	paSca_kramI_paWakramaNa#paSca_kramI_paWakramaNa#noun#3#RM
power_failed_recovery	vixyuwa_BaMga_puna:prApwi#vixyuwa_BaMga_puna:prApwi#noun#3#RM
power_set	GAwa_samuccaya#GAwa_samuccaya#noun#2#RM
precedence_code	pUrvawA_kUta#pUrvawA_kUta#noun#2#RM
precompiler_program	anuBARakapUrva_kramAxeSa#anuBARakapUrva_kramAxeSa#noun#2#RM
predicate_calculus	nirXAraka_kalana#nirXAraka_kalana#noun#2#RM
prefix_code	pUrvalagna_kUta#pUrvalagna_kUta#noun#2#RM
prefix_notation	pUrvalagna_saMkewana#pUrvalagna_saMkewana#noun#2#RM
presentation_layer	praswuwi_parawa#praswuwi_parawa#noun#2#RM
preventive_maintainance	niroXaka_anurakRaNa#niroXaka_anurakRaNa#noun#2#RM
primary_file	prAWamika_saMcikA#prAWamika_saMcikA#noun#2#RM
primary_index	prAWamika_sUcakAMka#prAWamika_sUcakAMka#noun#2#RM
primary_key	prAWamika_kuMjI#prAWamika_kuMjI#noun#2#RM
primary_memory	prAWamika_sWiwi#prAWamika_sWiwi#noun#2#RM
primary_storage	prAWamika_BaMdAraNa#prAWamika_BaMdAraNa#noun#2#RM
prime_shift	muKya_visWApana#muKya_visWApana#noun#2#RM
primitive_data_type	pUrvaga_AMkadA_prakAra#pUrvaga_AMkadA_prakAra#noun#3#RM
primitive_recursive_function	pUrvaga_punarAvqwwi_Palana#pUrvaga_punarAvqwwi_Palana#noun#3#RM
print_bar	muxraNa_xaMda#muxraNa_xaMda#noun#2#RM
print_control_character	muxraNa_niyaMwraNa_saMprawIka#muxraNa_niyaMwraNa_saMprawIka#noun#3#RM
print_data_set	muxraNa_AMkadA_samuccaya#muxraNa_AMkadA_samuccaya#noun#3#RM
print_format	muxraNa_saMrUpa#muxraNa_saMrUpa#noun#2#RM
print_record	muxraNa_aBileKa#muxraNa_aBileKa#noun#2#RM
print_wheel	muxraNa_cakrikA#muxraNa_cakrikA#noun#2#RM
printed_circuit_board	muxriwa_paripaWa_patta#muxriwa_paripaWa_patta#noun#3#RM
printer_plotter	muxriwra_AleKiwra#muxriwra_AleKiwra#noun#2#RM
printer_speed	muxriwra_cAla#muxriwra_cAla#noun#2#RM
priority_indicator	varIyawA_sUcaka#varIyawA_sUcaka#noun#2#RM
priority_interrupt	varIyawA_aMwarAyaNa#varIyawA_aMwarAyaNa#noun#2#RM
priority_processing	varIyawA_saMsAXana#varIyawA_saMsAXana#noun#2#RM
priority_queue	varIyawA_paMkwi#varIyawA_paMkwi#noun#2#RM
priority_scheduling_system	varIyawA_niyojana_waMwra#varIyawA_niyojana_waMwra#noun#3#RM
private_automatic_exchange	nijI_svacAliwa_telIPona_kenxra#nijI_svacAliwa_telIPona_kenxra#noun#3#RM
private_branch_exchange	nijI_SAKA_telIPona_kenxra#nijI_SAKA_telIPona_kenxra#noun#3#RM
private_library	nijI_kramAxeSa_saMgraha#nijI_kramAxeSa_saMgraha#noun#2#RM
privilege_instruction	viSeRAXikAra_anuxeSa#viSeRAXikAra_anuxeSa#noun#2#RM
probability_calculas	prAyikawA_kalana#prAyikawA_kalana#noun#2#RM
problem_diagnosis	samasyA_nixAna#samasyA_nixAna#noun#2#RM
problem_oriented_language	samasyA_mUlaka_BARA#samasyA_mUlaka_BARA#noun#3#RM
problem_state	samasyA_sWiwi#samasyA_sWiwi#noun#2#RM
procedural_language	prakriyAwmaka_BARA#prakriyAwmaka_BARA#noun#2#RM
procedure_division	prakriyA_viBAga#prakriyA_viBAga#noun#2#RM
procedure_oriented_language	prakriyAmUlaka_BARA#prakriyAmUlaka_BARA#noun#3#RM
procedure_reference	prakriyA_saMxarBa#prakriyA_saMxarBa#noun#2#RM
procedure_subprogram	prakriyA_upakramAxeSa#prakriyA_upakramAxeSa#noun#2#RM
process_control	prakrama_niyaMwraNa#prakrama_niyaMwraNa#noun#2#RM
process_management	prakrama_prabaMXa#prakrama_prabaMXa#noun#2#RM
processing_capacity	saMsAXana_kRamawA#saMsAXana_kRamawA#noun#2#RM
processing_unit	saMsAXana_ekaka#saMsAXana_ekaka#noun#2#RM
processor_basic_instruction	saMsAXiwra_AXAraBUwa_anuxeSa#saMsAXiwra_AXAraBUwa_anuxeSa#noun#3#RM
processor_interface	saMsAXiwra_aMwarApqRTa#saMsAXiwra_aMwarApqRTa#noun#2#RM
product_area	guNanaPala_kRewra#guNanaPala_kRewra#noun#2#RM
production_time	uwpAxana_kAla#uwpAxana_kAla#noun#2#RM
progra_execution_time	kramAxeSa_niRpAxana_kAla#kramAxeSa_niRpAxana_kAla#noun#3#RM
program_access	kramAxeSa_aBigama#kramAxeSa_aBigama#noun#2#RM
program_block	kramAxeSa_KaMdaka#kramAxeSa_KaMdaka#noun#2#RM
program_break_point	kramAxeSa_vicCexa_viMxu#kramAxeSa_vicCexa_viMxu#noun#3#RM
program_chaining	kramAxeSa_SrqMKalana#kramAxeSa_SrqMKalana#noun#2#RM
program_compilation	kramAxeSa_anuBARaNa#kramAxeSa_anuBARaNa#noun#2#RM
program_control_data	kramAxeSa_niyaMwraNa_AMkadA#kramAxeSa_niyaMwraNa_AMkadA#noun#3#RM
program_control_unit	kramAxeSa_niyaMwraNa_ekaka#kramAxeSa_niyaMwraNa_ekaka#noun#3#RM
program_counter	kramAxeSa_gaNiwra#kramAxeSa_gaNiwra#noun#2#RM
program_crash	kramAxeSa_BaMga#kramAxeSa_BaMga#noun#2#RM
program_debugging	kramAxeSa_xoRamArjana#kramAxeSa_xoRamArjana#noun#2#RM
program_design	kramAxeSa_aBikalpanA#kramAxeSa_aBikalpanA#noun#2#RM
program_documentation	kramAxeSa_praleKana#kramAxeSa_praleKana#noun#2#RM
program_error	kramAxeSa_wruti#kramAxeSa_wruti#noun#2#RM
program_execution	kramAxeSa_niRpAxana#kramAxeSa_niRpAxana#noun#2#RM
program_fetch_time	kramAxeSa_Anayana_kAla#kramAxeSa_Anayana_kAla#noun#3#RM
program_file	kramAxeSa_saMcikA#kramAxeSa_saMcikA#noun#2#RM
program_flowchart	kramAxeSa_pravAha_saMciwra#kramAxeSa_pravAha_saMciwra#noun#2#RM
program_function_key	kramAxeSa_prakArya_kuMjI#kramAxeSa_prakArya_kuMjI#noun#3#RM
program_generator	kramAxeSa_janaka#kramAxeSa_janaka#noun#2#RM
program_halt	kramAxeSa_virAma#kramAxeSa_virAma#noun#2#RM
program_instruction	kramAnuxeSa#kramAnuxeSa#noun#2#RM
program_interruption	kramAxeSa_bAXA#kramAxeSa_bAXA#noun#2#RM
program_library	kramAxeSa_saMgraha#kramAxeSa_saMgraha#noun#2#RM
program_linking	kramAxeSa_SrqMKalana#kramAxeSa_SrqMKalana#noun#2#RM
program_logic_array	kramAxeSa_warka_sAraNI#kramAxeSa_warka_sAraNI#noun#3#RM
program_modification	kramAxeSa_aparivarwana#kramAxeSa_aparivarwana#noun#2#RM
program_module	kramAxeSa_prawirUpaka#kramAxeSa_prawirUpaka#noun#2#RM
program_parameter	kramAxeSa_prAcala#kramAxeSa_prAcala#noun#2#RM
program_register	kramAxeSa_paMjI#kramAxeSa_paMjI#noun#2#RM
program_run	kramAxeSa_XAva#kramAxeSa_XAva#noun#2#RM
program_segmenting	kramAxeSa_KaMdana#kramAxeSa_KaMdana#noun#2#RM
program_selection	kramAxeSa_varaNa#kramAxeSa_varaNa#noun#2#RM
program_sensitive_malfunction	kramAxeSa_sugrAhI_kusaMkriyA#kramAxeSa_sugrAhI_kusaMkriyA#noun#3#RM
program_statement	kramAnuxeSa#kramAnuxeSa#noun#2#RM
program_storage	kramAnuxeSa_BaMdAraNa#kramAnuxeSa_BaMdAraNa#noun#2#RM
program_structure	kramAxeSa_saMracanA#kramAxeSa_saMracanA#noun#2#RM
program_testing	kramAxeSa_parIkRaNa#kramAxeSa_parIkRaNa#noun#2#RM
program_testing_time	kramAxeSa_parIkRaNa_kAla#kramAxeSa_parIkRaNa_kAla#noun#3#RM
program_tracing	kramAxeSa_anureKana#kramAxeSa_anureKana#noun#2#RM
program_translation	kramAxeSa_anuvAxa#kramAxeSa_anuvAxa#noun#2#RM
programmable_data_control_unit	kramAxeSa_AMkadA_niyaMwraNa_ekaka#kramAxeSa_AMkadA_niyaMwraNa_ekaka#noun#4#RM
programmable_function_key	kramAxeSya_prakArya_kuMjI#kramAxeSya_prakArya_kuMjI#noun#3#RM
programmable_input_output_device	kramAxeSya_niveSa_nirgama_yukwi#kramAxeSya_niveSa_nirgama_yukwi#noun#4#RM
programmable_peripheral_interface	kramAxeSya_upasAXana_aMwarApqRTa#kramAxeSya_upasAXana_aMwarApqRTa#noun#3#RM
programmable_read_only_memory	kramAxeSya_paTana_mAwra_smqwi#kramAxeSya_paTana_mAwra_smqwi#noun#4#RM
programmable_terminal	kramAxeSya_aMwaka#kramAxeSya_aMwaka#noun#2#RM
programmed_computer	kramAxeSiwa_aBikaliwra#kramAxeSiwa_aBikaliwra#noun#2#RM
programmed_logic	kramAxeSiwa_warka#kramAxeSiwa_warka#noun#2#RM
programming_environment	kramAxeSana_pariveSa#kramAxeSana_pariveSa#noun#2#RM
programming_flow_diagram	kramAxeSana_pravAha_AreKa#kramAxeSana_pravAha_AreKa#noun#3#RM
programming_module	kramAxeSana_prawirUpaka#kramAxeSana_prawirUpaka#noun#2#RM
programming_theory	kramAxeSana_sixXAMwa#kramAxeSana_sixXAMwa#noun#2#RM
progressive_carry	pragAmI_haswaMgawa#pragAmI_haswaMgawa#noun#2#RM
projection_function	prakRepa_Palana#prakRepa_Palana#noun#2#RM
propagated_error	saMcariwa_wruti#saMcariwa_wruti#noun#2#RM
propagation_constant	saMcaraNa_sWirAMka#saMcaraNa_sWirAMka#noun#2#RM
propagation_delay	saMcaraNa_vilaMba#saMcaraNa_vilaMba#noun#2#RM
propositional_calculus	sAXyAwmaka_kalana#sAXyAwmaka_kalana#noun#2#RM
propreitary_software	svAmiwva_prakriyA_sAmagrI#svAmiwva_prakriyA_sAmagrI#noun#2#RM
protected_field	rakRiwa_kRewra#rakRiwa_kRewra#noun#2#RM
protected_file	rakRiwa_saMcikA#rakRiwa_saMcikA#noun#2#RM
protected_memory	rakRiwa_smqwi#rakRiwa_smqwi#noun#2#RM
protection_key	rakRaNa_kuMjI#rakRaNa_kuMjI#noun#2#RM
protection_mechanism	rakRaNa_kriyAviXi#rakRaNa_kriyAviXi#noun#2#RM
protocol_hierarchy	saMxeSAcAra_paxAnukrama#saMxeSAcAra_paxAnukrama#noun#2#RM
prototype_program	Axi_prarUpa_kramAxeSa#Axi_prarUpa_kramAxeSa#noun#2#RM
prototype_statement	AxiprarUpa_kaWana#AxiprarUpa_kaWana#noun#2#RM
pseudo_code	Caxma_kUta#Caxma_kUta#noun#2#RM
pseudo_instruction	Caxma_anuxeSa#Caxma_anuxeSa#noun#2#RM
pseudo_language	Caxma_BARA#Caxma_BARA#noun#2#RM
pseudo_operation	Caxma_saMkriyA#Caxma_saMkriyA#noun#2#RM
pseudo_variable	Caxma_cara#Caxma_cara#noun#2#RM
public_data_network	jana_AMkadA_jAlakrama#jana_AMkadA_jAlakrama#noun#3#RM
public_network	sArvajanika_jAlakrama#sArvajanika_jAlakrama#noun#2#RM
pull_down_resister	aXokarRaNa_prawiroXaka#aXokarRaNa_prawiroXaka#noun#3#RM
pull_up_resister	uwkarRaNa_prawiroXaka#uwkarRaNa_prawiroXaka#noun#3#RM
pulse_amplitude	spaMxa_AyAma#spaMxa_AyAma#noun#2#RM
pulse_code_pulse_duratin	spaMxa_kUta#spaMxa_kUta#noun#4#RM
pulse_rate	spaMxa_avaXi#spaMxa_avaXi#noun#2#RM
pulse_string	spaMxa_xara#spaMxa_xara#noun#2#RM
pulse_triggered_flipflop	spaMxa_rajjU#spaMxa_rajjU#noun#3#RM
punch_card	spaMxa_pravarwiwa_xivamAmiwra#spaMxa_pravarwiwa_xivamAmiwra#noun#2#RM
punch_tape	CixraNa_tepa#CixraNa_tepa#noun#2#RM
punched_card_reader	Cixriwa_pawraka_paTiwra#Cixriwa_pawraka_paTiwra#noun#3#RM
punched_tape_reader	Cixriwa_tepa_paTiwra#Cixriwa_tepa_paTiwra#noun#3#RM
punching_position	CixraNa_sWiwi#CixraNa_sWiwi#noun#2#RM
pure_machine_aided_translation	SuxXa_yaMwra_sahAya_anuvAxa#SuxXa_yaMwra_sahAya_anuvAxa#noun#4#RM
push_button_dialling	xAba_batana_dAyalana#xAba_batana_dAyalana#noun#3#RM
push_down	aXosaMBara#aXosaMBara#noun#2#RM
push_down_list	aXosaMBara_sUci#aXosaMBara_sUci#noun#3#RM
push_down_stack	aXosaMBara_ciwi#aXosaMBara_ciwi#noun#3#RM
push_down_storage	aXosaMBara_BaMdAraNa#aXosaMBara_BaMdAraNa#noun#3#RM
push_instruction	saMBara_anuxeSa#saMBara_anuxeSa#noun#2#RM
quad_density	cawu:_Ganawva#cawu:_Ganawva#noun#2#RM
quantization_error	kvAntamIkaraNa_wruti#kvAntamIkaraNa_wruti#noun#2#RM
quantization_noise	kvAntamIkaraNa_rava#kvAntamIkaraNa_rava#noun#2#RM
quantizing_error	kvAntamIkaraNa_wruti#kvAntamIkaraNa_wruti#noun#2#RM
quantum_clock	kvAMtama_GadI#kvAMtama_GadI#noun#2#RM
quantum_time	kvAMtama_kAlAMSa#kvAMtama_kAlAMSa#noun#2#RM
quasi_instruction	Caxma_anuxeSa#Caxma_anuxeSa#noun#2#RM
query_processing	pqcCA_saMsAXana#pqcCA_saMsAXana#noun#2#RM
queue_element	paMkwi_avayava#paMkwi_avayava#noun#2#RM
queued_index_sequential_method	paMkwibaxXa_sUciwa_anukramika_viXi#paMkwibaxXa_sUciwa_anukramika_viXi#noun#4#RM
queuing_analysis	paMkwi_viSleRaNa#paMkwi_viSleRaNa#noun#2#RM
queuing_theory	paMkwi_sixXAMwa#paMkwi_sixXAMwa#noun#2#RM
quick_access_memory	xruwa_aBigama_smqwi#xruwa_aBigama_smqwi#noun#3#RM
quinary_system	paMcAXArI_paxXawi#paMcAXArI_paxXawi#noun#2#RM
racerandom_access_computer_equipment_)	yAxqcCika_aBigama_aBikaliwra_upakaraNa#yAxqcCika_aBigama_aBikaliwra_upakaraNa#noun#4#RM
radial_transfer	wrijya_sWAnAMwaraNa#wrijya_sWAnAMwaraNa#noun#2#RM
radio_relay_system	rediyo_rile_waMwra#rediyo_rile_waMwra#noun#3#RM
radix_exchange	mulAMka_vinimaya#mulAMka_vinimaya#noun#2#RM
radix_notation	mUlAMka_aMkaNa_paxXawi#mUlAMka_aMkaNa_paxXawi#noun#2#RM
radix_sorting	mUlAMka_SAtana#mUlAMka_SAtana#noun#2#RM
ram_loader	rEma_BAraka#rEma_BAraka#noun#2#RM
ramrandum_access_memory_)	rEma_(yAxqcCika_aBigama_smqwi)#rEma_(yAxqcCika_aBigama_smqwi)#noun#3#RM
random_access_memory	yAxqcCika_aBigama_smqwi#yAxqcCika_aBigama_smqwi#noun#3#RM
random_access_storage	yAxqcCika_aBigama_BaMdAraNa#yAxqcCika_aBigama_BaMdAraNa#noun#3#RM
random_data_set	yAxqcCika_AMkadA_samuccya#yAxqcCika_AMkadA_samuccya#noun#3#RM
random_logic	yAxqcCika_warka#yAxqcCika_warka#noun#2#RM
random_number	yAxqcCika_saMKyA#yAxqcCika_saMKyA#noun#2#RM
random_number_generator	yAxqcCika_saMKyA_janaka#yAxqcCika_saMKyA_janaka#noun#3#RM
random_processing	yAxqcCika_saMsAXana#yAxqcCika_saMsAXana#noun#2#RM
random_scan	yAxqcCika_kramavIkRaNa#yAxqcCika_kramavIkRaNa#noun#2#RM
rapid_access	xruwa_aBigama#xruwa_aBigama#noun#2#RM
raster_display_service	reKA_puMja_praxarSa_sevA#reKA_puMja_praxarSa_sevA#noun#3#RM
raster_graphics	reKA_puMja#reKA_puMja#noun#2#RM
raster_plotter	reKApuMja_AleKiwra#reKApuMja_AleKiwra#noun#2#RM
raster_scan	reKApuMja_kramavIkRaNa#reKApuMja_kramavIkRaNa#noun#2#RM
rate_pulse	xara_spaMxa#xara_spaMxa#noun#2#RM
rational_language	saMgawa_BARA#saMgawa_BARA#noun#2#RM
read-only_memory	paTana_smqwi#paTana_smqwi#noun#2#RM
read/write_channel	paTana/leKana_praNAla#paTana/leKana_praNAla#noun#2#RM
read/write_cycle	paTana/leKana_cakra#paTana/leKana_cakra#noun#2#RM
read/write_storage	paTana/leKana_BaMdAraNa#paTana/leKana_BaMdAraNa#noun#2#RM
read_cycle_time	paTana_cakra_kAla#paTana_cakra_kAla#noun#3#RM
read_head	paTana_SIrRa#paTana_SIrRa#noun#2#RM
read_instruction	paTana_anuxeSa#paTana_anuxeSa#noun#2#RM
read_screen	paTana_prapata#paTana_prapata#noun#2#RM
reader_sorter	paTiwra-SAtiwra#paTiwra-SAtiwra#noun#2#RM
reading_access_time	paTana_aBigama_kAla#paTana_aBigama_kAla#noun#3#RM
reading_head=head_)	paTana_SIrRa#paTana_SIrRa#noun#2#RM
readout_device	paTana_xarSa_yukwi#paTana_xarSa_yukwi#noun#2#RM
readtime_clock	paTana_kAla_GadI#paTana_kAla_GadI#noun#2#RM
ready_light	wawpara_avasWA_bawwI#wawpara_avasWA_bawwI#noun#2#RM
ready_state	wawpara_avasWA#wawpara_avasWA#noun#2#RM
real_address	vAswavika_pawA#vAswavika_pawA#noun#2#RM
real_constant	vAswavika_acara#vAswavika_acara#noun#2#RM
real_storage	vAswavika_BaMdAraNa#vAswavika_BaMdAraNa#noun#2#RM
real_time	saxya_anukriyA#saxya_anukriyA#noun#2#RM
real_time_clock_module	saxya_anukriyA_GadI_prawirUpaka#saxya_anukriyA_GadI_prawirUpaka#noun#4#RM
real_time_operation	saxya_anukriyA_saMkriya#saxya_anukriyA_saMkriya#noun#3#RM
real_time_processing	saxya_anukriyA_saMsAXana#saxya_anukriyA_saMsAXana#noun#3#RM
real_time_satellite_computer	saxya_anukriyA_upagraha_aBikaliwra#saxya_anukriyA_upagraha_aBikaliwra#noun#4#RM
receiver_signal	aBigrAhI_saMkewa#aBigrAhI_saMkewa#noun#2#RM
recgnition_character	aBijFAna_saMprawIka#aBijFAna_saMprawIka#noun#2#RM
recoding_medium	aBileKana_mAXyama#aBileKana_mAXyama#noun#2#RM
record_gap	aBileKa_aMwarAla#aBileKa_aMwarAla#noun#2#RM
record_layout	aBileKa_vinyAsa#aBileKa_vinyAsa#noun#2#RM
record_length	aBileKa_laMbAI#aBileKa_laMbAI#noun#2#RM
record_medium	aBileKa_mAXyama#aBileKa_mAXyama#noun#2#RM
record_number	aBileKa_saMKyA#aBileKa_saMKyA#noun#2#RM
record_type	aBileKa_prakAra#aBileKa_prakAra#noun#2#RM
recorder_tone	punarAxeSI_tona#punarAxeSI_tona#noun#2#RM
recording_density	aBileKana_Ganawva#aBileKana_Ganawva#noun#2#RM
recoverable_error	puna:_prApya_wruti#puna:_prApya_wruti#noun#2#RM
recursion_theorem	punarAvarwana_prameya#punarAvarwana_prameya#noun#2#RM
recursive_function	punarAvarwana_kalana#punarAvarwana_kalana#noun#2#RM
recursive_process	punarAvarwana_prakrama#punarAvarwana_prakrama#noun#2#RM
recursive_routine	punarAvarwana_nemakA#punarAvarwana_nemakA#noun#2#RM
redundancy_check_bit	awirikwawA_jAMca_xvayaMka#awirikwawA_jAMca_xvayaMka#noun#3#RM
redundancy_of_data	AMkadA_awirikwawA#AMkadA_awirikwawA#noun#3#RM
reenterable_program	puna:_praveSya_kramAxeSa#puna:_praveSya_kramAxeSa#noun#2#RM
reenterable_subroutine	puna:_praveSya_upanemakA#puna:_praveSya_upanemakA#noun#2#RM
reentry_point	puna:_praveSa_praNAlI#puna:_praveSa_praNAlI#noun#2#RM
reference_clock	nirxeSa_GadI#nirxeSa_GadI#noun#2#RM
reference_file	saMxarBa_saMcikA#saMxarBa_saMcikA#noun#2#RM
reference_list	nirxeSa_sUci#nirxeSa_sUci#noun#2#RM
reference_time	nirxeSa_samaya#nirxeSa_samaya#noun#2#RM
reflective_scan	parAvarwanI_kramavIkRaNa#parAvarwanI_kramavIkRaNa#noun#2#RM
reflexive_relation	svawulya_saMbaMXa#svawulya_saMbaMXa#noun#2#RM
regenerative_memory	punaryojI_smqwi#punaryojI_smqwi#noun#2#RM
regional_centre	praxeSI_kenxra#praxeSI_kenxra#noun#2#RM
regional_computer_network	praxeSI_aBikaliwra_jAlakrama#praxeSI_aBikaliwra_jAlakrama#noun#3#RM
register_input_buffer	paMjI_niveSa_cayaka#paMjI_niveSa_cayaka#noun#3#RM
register_length	paMjI_laMbAI#paMjI_laMbAI#noun#2#RM
register_pointer	paMjI_sUcaka#paMjI_sUcaka#noun#2#RM
regular_expression	niyamiwa_vyaMjaka#niyamiwa_vyaMjaka#noun#2#RM
regular_grammer	niyamiwa_vyAkaraNa#niyamiwa_vyAkaraNa#noun#2#RM
regular_language	niyamiwa_BARA#niyamiwa_BARA#noun#2#RM
relational_database	saMbaMXaparaka_AMkadA_saMcaya#saMbaMXaparaka_AMkadA_saMcaya#noun#2#RM
relational_expression	saMbaMXaparaka_vyaMjaka#saMbaMXaparaka_vyaMjaka#noun#2#RM
relational_operator	saMbaMXaparaka_saMkAraka#saMbaMXaparaka_saMkAraka#noun#2#RM
relative_address	sApekRa_pawA#sApekRa_pawA#noun#2#RM
relatively_prime	sApekRawa:_aBAjya#sApekRawa:_aBAjya#noun#2#RM
remote_batch_processing	suxUra_pracaya_saMsAXana#suxUra_pracaya_saMsAXana#noun#3#RM
remote_console	suxUra_kaMsola#suxUra_kaMsola#noun#2#RM
remote_host	suxUra_AwiWeya#suxUra_AwiWeya#noun#2#RM
remote_job_entry	xUra_kArya_niviRti#xUra_kArya_niviRti#noun#3#RM
remote_massage_processing	suxUra_saMxeSa_saMsAXana#suxUra_saMxeSa_saMsAXana#noun#3#RM
remote_printing	suxUra_muxraNa#suxUra_muxraNa#noun#2#RM
remote_remote_access_data_processing	suxUra_aBigama_AMkadA_saMsAXana#suxUra_aBigama_AMkadA_saMsAXana#noun#5#RM
remote_sensing	suxUra_saMvexana#suxUra_saMvexana#noun#2#RM
remote_switch	suxUra_svica#suxUra_svica#noun#2#RM
repair_time	marammawa_kAla#marammawa_kAla#noun#2#RM
requirement_analysis	AvaSyakawA_viSleRaNa#AvaSyakawA_viSleRaNa#noun#2#RM
rerun_mode	punarXAva_viXA#punarXAva_viXA#noun#2#RM
reserved_word	ArakRiwa_Sabxa#ArakRiwa_Sabxa#noun#2#RM
reset_cycle	puna:_AraMBana_cakra#puna:_AraMBana_cakra#noun#2#RM
reset_mode	puna:_AraMBana_viXA#puna:_AraMBana_viXA#noun#2#RM
reset_pulse	puna:_AraMBana_spaMxa#puna:_AraMBana_spaMxa#noun#2#RM
resident_control_program	smqwivAsI_niyaMwraNa_kramAxeSa#smqwivAsI_niyaMwraNa_kramAxeSa#noun#3#RM
resident_macroassembler	smqwivAsI_sWUla_kodAMwaraka#smqwivAsI_sWUla_kodAMwaraka#noun#2#RM
resident_program	smqwivAsI_kramAxeSa#smqwivAsI_kramAxeSa#noun#2#RM
residual_error	avaSiRta_wruti#avaSiRta_wruti#noun#2#RM
resisdent_module	smqwivAsI_prawirUpaka#smqwivAsI_prawirUpaka#noun#2#RM
resistor_transistor_logic	prawiroXaka_trAMjistara_warka#prawiroXaka_trAMjistara_warka#noun#3#RM
resolution_error	mAwraka_wruti#mAwraka_wruti#noun#2#RM
resource_allocation	sAXana_niyawana#sAXana_niyawana#noun#2#RM
resource_management	sAXana_prabaMXa#sAXana_prabaMXa#noun#2#RM
resource_sharing	sAXana_sahaBAjana#sAXana_sahaBAjana#noun#2#RM
response_function	anukriyA_Palana#anukriyA_Palana#noun#2#RM
response_time	anukriyA_kAla#anukriyA_kAla#noun#2#RM
restart_condition	puna:_prAraMBa_sWiwi#puna:_prAraMBa_sWiwi#noun#2#RM
restart_instruction	puna:_prAraMBa_anuxeSa#puna:_prAraMBa_anuxeSa#noun#2#RM
return_address	prawigamana_pawA#prawigamana_pawA#noun#2#RM
returned_value	prawigamiwa_mAna#prawigamiwa_mAna#noun#2#RM
reusable_program	puna:prayojya_kramAxeSa#puna:prayojya_kramAxeSa#noun#2#RM
reversable_process	uwkramaNIya_prakrama#uwkramaNIya_prakrama#noun#2#RM
reverse_channel	uwkrama_praNAla#uwkrama_praNAla#noun#2#RM
reverse_clipping	uwkrama_karwana#uwkrama_karwana#noun#2#RM
reverse_direction_flow	uwkrama_xiSA_pravAha#uwkrama_xiSA_pravAha#noun#3#RM
reverse_indexing	uwkrama_sUcikaraNa#uwkrama_sUcikaraNa#noun#2#RM
reverse_video	uwkrama_vIdiyo#uwkrama_vIdiyo#noun#2#RM
rewind_key	prawigAmI_kuMjI#prawigAmI_kuMjI#noun#2#RM
right_justify	xakRiNa_Ociwya#xakRiNa_Ociwya#noun#2#RM
right_shift	xakRiNa_vyavasWApana#xakRiNa_vyavasWApana#noun#2#RM
ring_network	valaya_jAlakrama#valaya_jAlakrama#noun#2#RM
ringback_tone	prawivAxana_tona#prawivAxana_tona#noun#2#RM
risk_assesment	joKima_nirXAraNa#joKima_nirXAraNa#noun#2#RM
roll_back	punarAvarwana#punarAvarwana#noun#2#RM
rotary_dial	GurnI_dAyala#GurnI_dAyala#noun#2#RM
rotational_position_sensing	GUrNana_sWiwi_saMvexana#GUrNana_sWiwi_saMvexana#noun#3#RM
rounding_error	pUraka_wruti#pUraka_wruti#noun#2#RM
routing_key	anumArgana_kuMjI#anumArgana_kuMjI#noun#2#RM
routing_test	nemakA_parIkRaNa#nemakA_parIkRaNa#noun#2#RM
row_scanning	paMkwi_kramavIkRaNa#paMkwi_kramavIkRaNa#noun#2#RM
row_vector	paMkwi_saxiSa#paMkwi_saxiSa#noun#2#RM
run_diagram	XAva_AreKa#XAva_AreKa#noun#2#RM
run_duration	XAva_avaXi#XAva_avaXi#noun#2#RM
run_more	XAva_viXA#XAva_viXA#noun#2#RM
run_schedule	XAva_anusUci#XAva_anusUci#noun#2#RM
run_timeexecution_time_)	niRpAxana_kAla/XAva_kAla#niRpAxana_kAla/XAva_kAla#noun#3#RM
salar_variable	axiSa_cara#axiSa_cara#noun#2#RM
samsequential_access_method_)	anukramika_aBigama_viXi#anukramika_aBigama_viXi#noun#3#RM
satellite_computer	upagraha_aBikaliwra#upagraha_aBikaliwra#noun#2#RM
satellite_relay	upagraha_rile#upagraha_rile#noun#2#RM
saturation_testing	saMwqpwi_parIkRaNa#saMwqpwi_parIkRaNa#noun#2#RM
scan_period	kramavIkRaNa_avaXi#kramavIkRaNa_avaXi#noun#2#RM
scanning_machine	kramavIkRaNa_yaMwra#kramavIkRaNa_yaMwra#noun#2#RM
scatter_format	prakIrNa_saMrUpa#prakIrNa_saMrUpa#noun#2#RM
scatter_gap	prakIrNa_rikwi#prakIrNa_rikwi#noun#2#RM
scheduled_algorithm	niyojana_kalana_viXi#niyojana_kalana_viXi#noun#2#RM
scheduled_maintainance	niyojiwa_anurakRaNa#niyojiwa_anurakRaNa#noun#2#RM
scientific_notation	vEjFAnika_aMkaNa_paxXawi#vEjFAnika_aMkaNa_paxXawi#noun#2#RM
screen_editor	prapatta_saMpAxaka#prapatta_saMpAxaka#noun#2#RM
screen_generator	prapatta_janiwra#prapatta_janiwra#noun#2#RM
search_cycle	Kojacakra#Kojacakra#noun#2#RM
search_key	Koja_kuMjI#Koja_kuMjI#noun#2#RM
search_tree	Koja_warU#Koja_warU#noun#2#RM
second_generation_computer	xviwIya_pIDI_aBikaliwra#xviwIya_pIDI_aBikaliwra#noun#3#RM
second_level_addressing	xviwIyaswarI_pawABigamana#xviwIyaswarI_pawABigamana#noun#3#RM
secondary_access	xviwIyaka_aBigama#xviwIyaka_aBigama#noun#2#RM
secondary_console	xviwIyaka_kaMsola#xviwIyaka_kaMsola#noun#2#RM
secondary_key	xviwIyaka_kuMjI#xviwIyaka_kuMjI#noun#2#RM
secondary_memory	xviwIyaka_smqwi#xviwIyaka_smqwi#noun#2#RM
secondary_storage	xviwIyaka_BaMdAraNa#xviwIyaka_BaMdAraNa#noun#2#RM
seek_area	aBiXAraNa_kRewra#aBiXAraNa_kRewra#noun#2#RM
seek_key	aBiXAraNa_kuMjI#aBiXAraNa_kuMjI#noun#2#RM
seek_time	aBiXAraNa_kAla#aBiXAraNa_kAla#noun#2#RM
segment_number	KaMda_saMKyA#KaMda_saMKyA#noun#2#RM
selection_check	varaNa_jAMca#varaNa_jAMca#noun#2#RM
selection_sort	varaNAwmaka_SAtana#varaNAwmaka_SAtana#noun#2#RM
selective_erase	varaNAwmaka_vyAmArjana#varaNAwmaka_vyAmArjana#noun#2#RM
selective_index	varaNAwmaka_sUcakAMka#varaNAwmaka_sUcakAMka#noun#2#RM
selector_mode	variwra_viXA#variwra_viXA#noun#2#RM
self_checking_number	svajAMca_saMKyA#svajAMca_saMKyA#noun#3#RM
self_dual	svaxvEwa#svaxvEwa#noun#2#RM
self_learning	sva_aXigama#sva_aXigama#noun#2#RM
self_monitoring_system	sva_mAnitarana_waMwra#sva_mAnitarana_waMwra#noun#3#RM
self_restoring_loop	sva_puna:_sWApana_pASa#sva_puna:_sWApana_pASa#noun#3#RM
semi_conductor_memory	arxXa_cAlaka_smqwi#arxXa_cAlaka_smqwi#noun#3#RM
sender_receiver_terminal	preRaka_aBigrAhI_aMwaka#preRaka_aBigrAhI_aMwaka#noun#3#RM
sense_light	saMvexaka_prakASa#saMvexaka_prakASa#noun#2#RM
sense_switch	saMvexana_svica#saMvexana_svica#noun#2#RM
sensing_element	saMvexI_avayava#saMvexI_avayava#noun#2#RM
sensing_signal	saMvexI_saMkewa#saMvexI_saMkewa#noun#2#RM
sensor_based_computer	saMvexiwra_AXArI_aBikaliwra#saMvexiwra_AXArI_aBikaliwra#noun#3#RM
senstivility_analysis	sugrAhiwA_viSleRaNa#sugrAhiwA_viSleRaNa#noun#2#RM
septenary_number	sapwAXArI_saMKyA#sapwAXArI_saMKyA#noun#2#RM
sequence_control_register	anukrama_niyaMwraNa_paMjI#anukrama_niyaMwraNa_paMjI#noun#3#RM
sequence_counter	anukrama_gaNiwra#anukrama_gaNiwra#noun#2#RM
sequence_moniter	anukrama_mAnitara#anukrama_mAnitara#noun#2#RM
sequence_register	anukrama_paMjI#anukrama_paMjI#noun#2#RM
sequencing_key	anukramaNa_kuMjI#anukramaNa_kuMjI#noun#2#RM
sequential_access	anukramika_aBigama#anukramika_aBigama#noun#2#RM
sequential_access_method	anukramika_aBigama_viXi#anukramika_aBigama_viXi#noun#3#RM
sequential_algorithm	anukramika_kalana_viXi#anukramika_kalana_viXi#noun#2#RM
sequential_circuit	anukramika_paripaWa#anukramika_paripaWa#noun#2#RM
sequential_computer	anukramika_aBikaliwra#anukramika_aBikaliwra#noun#2#RM
sequential_data_set	anukramika_AMkadA_samuccaya#anukramika_AMkadA_samuccaya#noun#3#RM
sequential_file	anukramika_saMcikA#anukramika_saMcikA#noun#2#RM
sequential_logic_element	anukramika_warka_avayava#anukramika_warka_avayava#noun#3#RM
sequential_search_algorithm	anukramika_Koja_kalana_viXi#anukramika_Koja_kalana_viXi#noun#3#RM
serial_access	kramika_aBigama#kramika_aBigama#noun#2#RM
serial_access_memory	kramika_aBigama_smqwi#kramika_aBigama_smqwi#noun#3#RM
serial_access_storage	kramika_aBigama_BaMdAraNa#kramika_aBigama_BaMdAraNa#noun#3#RM
serial_adder	kramika_saMkalaka#kramika_saMkalaka#noun#2#RM
serial_bit_transmission	kramika_xvayaMka_saMcaraNa#kramika_xvayaMka_saMcaraNa#noun#3#RM
serial_computer	kramika_aBikaliwra#kramika_aBikaliwra#noun#2#RM
serial_flow	kramika_pravAha#kramika_pravAha#noun#2#RM
serial_input_output	kramika_niveSa_nirgama#kramika_niveSa_nirgama#noun#3#RM
serial_interface	kramika_aMwarApqRTa#kramika_aMwarApqRTa#noun#2#RM
serial_parallel	kramika_yugapawa#kramika_yugapawa#noun#2#RM
serial_port	kramika_saMxvAra#kramika_saMxvAra#noun#2#RM
serial_printer	kramika_muxriwra#kramika_muxriwra#noun#2#RM
serial_transfer	kramika_sWAnAMwaraNa#kramika_sWAnAMwaraNa#noun#2#RM
serial_transmission	kramika_saMcaraNa#kramika_saMcaraNa#noun#2#RM
service_bureau	sevA_byUro#sevA_byUro#noun#2#RM
service_engineering	sevA_iMjiniyarI#sevA_iMjiniyarI#noun#2#RM
session_layer	sawra_swara#sawra_swara#noun#2#RM
set_algebra	samuccaya_bIjAvalI#samuccaya_bIjAvalI#noun#2#RM
set_symbol	nirxeSa_prawIka#nirxeSa_prawIka#noun#2#RM
set_up	vyavasWA#vyavasWA#noun#2#RM
seven_layer_reference_model	sAwa_pAriwa_saMxarBa_nixarSa#sAwa_pAriwa_saMxarBa_nixarSa#noun#4#RM
shannons_diagram	SEnana_AreKa#SEnana_AreKa#noun#2#RM
shannons_model	SEnana_nixarSa#SEnana_nixarSa#noun#2#RM
shannons_theorem	SEnana_prameya#SEnana_prameya#noun#2#RM
shared_disk	sahaBAjI_cakrikA#sahaBAjI_cakrikA#noun#2#RM
shared_file	sahaBAjI_saMcikA#sahaBAjI_saMcikA#noun#2#RM
shared_memory	sahaBAjI_smqwi#sahaBAjI_smqwi#noun#2#RM
shared_resource	sahaBAjI_sAXana#sahaBAjI_sAXana#noun#2#RM
shared_system	sahaBAjI_waMwra#sahaBAjI_waMwra#noun#2#RM
sheet_feeder	parNa_Baraka#parNa_Baraka#noun#2#RM
shell_sort	Sela_SAtana#Sela_SAtana#noun#2#RM
shift_character	visWApana_saMprawIka#visWApana_saMprawIka#noun#2#RM
shift_counter	visWApana_gaNiwra#visWApana_gaNiwra#noun#2#RM
shift_keying	visWApana_kuMjIyana#visWApana_kuMjIyana#noun#2#RM
shift_pulse	visWApana_spaMxa#visWApana_spaMxa#noun#2#RM
shift_register	visWApana_paMjI#visWApana_paMjI#noun#2#RM
short_term_storage	alpakAlika_BaMdAraNa#alpakAlika_BaMdAraNa#noun#3#RM
shortest_path_algoritm	laGuwwama_paWa_kalana_viXi#laGuwwama_paWa_kalana_viXi#noun#3#RM
side_band	pArSva_bENda#pArSva_bENda#noun#2#RM
side_circuit	pArSva_paripaWa#pArSva_paripaWa#noun#2#RM
side_effect	pArSva_praBAva#pArSva_praBAva#noun#2#RM
sigma_tree	sigmA_warU#sigmA_warU#noun#2#RM
sign_bit	cihqna_xvayaMka#cihqna_xvayaMka#noun#2#RM
sign_magnitude	cihna_parimANa#cihna_parimANa#noun#2#RM
sign_position	cihna_sWiwi#cihna_sWiwi#noun#2#RM
signal_converter	saMkewa_rUpAMwariwra#saMkewa_rUpAMwariwra#noun#2#RM
signal_distributer	saMkewa_viwaraka#saMkewa_viwaraka#noun#2#RM
signal_element	saMkewa_avayava#saMkewa_avayava#noun#2#RM
signal_enabling	saMkewa_sakRamakaraNa#saMkewa_sakRamakaraNa#noun#2#RM
signal_level	saMkewa_swara#saMkewa_swara#noun#2#RM
signal_processing	saMkewa_saMsAXana#saMkewa_saMsAXana#noun#2#RM
signal_ratio	saMkewa_anupAwa#saMkewa_anupAwa#noun#2#RM
signal_transfer_point	saMkewa_sWAnAMwaraNa_viMxu#saMkewa_sWAnAMwaraNa_viMxu#noun#3#RM
signalling_rate	saMkewana_xara#saMkewana_xara#noun#2#RM
signed_binary	cihniwa_xviAXArI#cihniwa_xviAXArI#noun#2#RM
simple_buffering	sarala_cayana#sarala_cayana#noun#2#RM
simple_parity_check	sarala_samawA_jAMca#sarala_samawA_jAMca#noun#3#RM
simplex_channel	ekasaMkewana_praNAla#ekasaMkewana_praNAla#noun#2#RM
simplex_circuit	ekasaMkewana_paripaWa#ekasaMkewana_paripaWa#noun#2#RM
simplex_communication	ekasaMkewana_saMcAra#ekasaMkewana_saMcAra#noun#2#RM
simplex_method	eka_saMkewana_viXi#eka_saMkewana_viXi#noun#2#RM
simultaneous_operation	yugapawa_saMkriyA#yugapawa_saMkriyA#noun#2#RM
simultaneous_transmission	yugapawa_saMcaraNa#yugapawa_saMcaraNa#noun#2#RM
single_address_code	ekala_pawA_kUta#ekala_pawA_kUta#noun#3#RM
single_address_instruction	ekala_pawA_anuxeSa#ekala_pawA_anuxeSa#noun#3#RM
single_address_message	ekala_pawA_saMxeSa#ekala_pawA_saMxeSa#noun#3#RM
single_error	ekala_wruti#ekala_wruti#noun#2#RM
single_instruction_multiple_data	ekala_anuxeSa_bahu_AMkade#ekala_anuxeSa_bahu_AMkade#noun#4#RM
single_sheet_feeding	ekala_parNa_BaraNa#ekala_parNa_BaraNa#noun#3#RM
single_step_operation	ekala_caraNa_saMkriyA#ekala_caraNa_saMkriyA#noun#3#RM
singly_linked_list	ekaXA_SrqMKaliwa_sUci#ekaXA_SrqMKaliwa_sUci#noun#3#RM
sinking_technique	avarohaNa_wakanIka#avarohaNa_wakanIka#noun#2#RM
sip_code	pluwi_kUta#pluwi_kUta#noun#2#RM
six_bit_byte	Rata_xvayaMka_bAita#Rata_xvayaMka_bAita#noun#3#RM
skewed_tree	asaMwuliwa_warU#asaMwuliwa_warU#noun#2#RM
skip_instruction	pluwi_anuxeSa#pluwi_anuxeSa#noun#2#RM
skip_key	pluwi_kuMjI#pluwi_kuMjI#noun#2#RM
slack_byte	SiWila_bAita#SiWila_bAita#noun#2#RM
slave_computer	aXIna_aBikaliwra#aXIna_aBikaliwra#noun#2#RM
slave_mode	aXahana_viXA#aXahana_viXA#noun#2#RM
slow_storage	maMxa_BaMdAraNa#maMxa_BaMdAraNa#noun#2#RM
small_scale_integration	laGu_ekIkaraNa#laGu_ekIkaraNa#noun#3#RM
smart_terminal	cuswa_aMwaka#cuswa_aMwaka#noun#2#RM
smoke_test	XUmra_parIkRaNa#XUmra_parIkRaNa#noun#2#RM
snap_shot	ASuciwra#ASuciwra#noun#2#RM
snap_shot_program	ASuciwra_kramAxeSa#ASuciwra_kramAxeSa#noun#3#RM
soft_copy	mqxu_prawi#mqxu_prawi#noun#2#RM
soft_error=trasient_error_)	kRaNika_wruti#kRaNika_wruti#noun#3#RM
soft_sector_formating	mqxu_wrijyaKaMda_saMrUpaNa#mqxu_wrijyaKaMda_saMrUpaNa#noun#3#RM
soft_sectored_disk	mqxu_wrijyaKaMdI_cakrikA#mqxu_wrijyaKaMdI_cakrikA#noun#3#RM
software_compatible	prakriyA_sAmagrI_susaMgawa#prakriyA_sAmagrI_susaMgawa#noun#2#RM
software_device	prakriyA_sAmagrI_yukwi#prakriyA_sAmagrI_yukwi#noun#2#RM
software_documentation	prakriyA_sAmagrI_praleKana#prakriyA_sAmagrI_praleKana#noun#2#RM
software_driver	prakriyA_sAmagrI_cAlaka#prakriyA_sAmagrI_cAlaka#noun#2#RM
software_engineering	prakriyA_sAmagrI_iMjIniyarI#prakriyA_sAmagrI_iMjIniyarI#noun#2#RM
software_life_cycle	prakriyA_sAmagrI_jIvanacakra#prakriyA_sAmagrI_jIvanacakra#noun#3#RM
software_maintainance	prakriyA_sAmagrI_anurakRaNa#prakriyA_sAmagrI_anurakRaNa#noun#2#RM
software_package	prakriyA_sAmagrI_pEkeja#prakriyA_sAmagrI_pEkeja#noun#2#RM
software_reliability	prakriyA_sAmagrI_viSvasanIyawA#prakriyA_sAmagrI_viSvasanIyawA#noun#2#RM
software_tool	prakriyA_sAmagrI_sAXana#prakriyA_sAmagrI_sAXana#noun#2#RM
solid_error	sWAyI_wruti#sWAyI_wruti#noun#2#RM
solid_state	Tosa_avasWA#Tosa_avasWA#noun#2#RM
solid_state_computer	Tosa_avasWA_aBikaliwra#Tosa_avasWA_aBikaliwra#noun#3#RM
solid_state_memory	Tosa_avasWA_smqwi#Tosa_avasWA_smqwi#noun#3#RM
sort_key	SAtana_kuMjI#SAtana_kuMjI#noun#2#RM
sort_merge	SAtana_vilaya#SAtana_vilaya#noun#2#RM
sort_merge_program	SAtana_vilaya_kramAxeSa#SAtana_vilaya_kramAxeSa#noun#3#RM
sort_selection	SAtana_varaNa#SAtana_varaNa#noun#2#RM
source_code	srowa_kUta#srowa_kUta#noun#2#RM
source_computer	srowa_aBikaliwra#srowa_aBikaliwra#noun#2#RM
source_data	srowa_AMkade#srowa_AMkade#noun#2#RM
source_data_card	srowa_AMkadA_pawraka#srowa_AMkadA_pawraka#noun#3#RM
source_document	srowa_praleKa#srowa_praleKa#noun#2#RM
source_file	srowa_saMcikA#srowa_saMcikA#noun#2#RM
source_language	srowa_BARA#srowa_BARA#noun#2#RM
source_listing	srowa_kramAxeSa_sUciyana#srowa_kramAxeSa_sUciyana#noun#2#RM
source_machine	srowa_yaMwra#srowa_yaMwra#noun#2#RM
source_program	srowa_kramAxeSa#srowa_kramAxeSa#noun#2#RM
source_table	srowa_sAraNI#srowa_sAraNI#noun#2#RM
space_character	rikwi_saMprawIka#rikwi_saMprawIka#noun#2#RM
space_complexity	samiRta_jatilawA#samiRta_jatilawA#noun#2#RM
space_suppression	rikwi_niroXa#rikwi_niroXa#noun#2#RM
spanning_sub_graph	viswariwa_upAleKa#viswariwa_upAleKa#noun#3#RM
spanning_tree	viswariwa_warU#viswariwa_warU#noun#2#RM
sparse_matrix	virala_avayavI_mEtriksa#virala_avayavI_mEtriksa#noun#2#RM
special_purpose_computer	viSeRa_uxxeSya_aBikaliwra#viSeRa_uxxeSya_aBikaliwra#noun#3#RM
special_purpose_language	viSeRa_uxxeSya_BARA#viSeRa_uxxeSya_BARA#noun#3#RM
special_register	viSeRa_paMjI#viSeRa_paMjI#noun#2#RM
specific_address	viSiRta_pawA#viSiRta_pawA#noun#2#RM
specific_code	viSiRta_kUta#viSiRta_kUta#noun#2#RM
specific_program	viSiRta_kramAxeSa#viSiRta_kramAxeSa#noun#2#RM
speech_calling	vAka_AhavAna#vAka_AhavAna#noun#2#RM
speech_input	vAka_niveSa#vAka_niveSa#noun#2#RM
speech_scramble	vAka_rUpAMwariwra#vAka_rUpAMwariwra#noun#2#RM
speech_synthesizer	vAka_saMSleRiwra#vAka_saMSleRiwra#noun#2#RM
split_,__,_screen	viBakwa_prapatta#viBakwa_prapatta#noun#5#RM
spool_management	spUla_prabaMXa#spUla_prabaMXa#noun#2#RM
spread_spectrum	viswqwa_spektrama#viswqwa_spektrama#noun#2#RM
square_matrix	varga_mEtriksa#varga_mEtriksa#noun#2#RM
stable_state	sWAyI_avasWA#sWAyI_avasWA#noun#2#RM
stack_algorithm	ciwi_kalana_viXi#ciwi_kalana_viXi#noun#2#RM
stack_architecture	ciwi_sWApawya_kalA#ciwi_sWApawya_kalA#noun#2#RM
stack_indicator	ciwi_sUcaka#ciwi_sUcaka#noun#2#RM
stack_manipulation	ciwi_sUcaka#ciwi_sUcaka#noun#2#RM
stack_pointer	ciwi_saMsAXana#ciwi_saMsAXana#noun#2#RM
stacked_job	ciwIyiwa_kArya#ciwIyiwa_kArya#noun#2#RM
stand_alone_modem	svASrayI_modema#svASrayI_modema#noun#3#RM
standard_data_format	mAnaka_AMkadA_saMrUpa#mAnaka_AMkadA_saMrUpa#noun#3#RM
standard_file	mAnaka_saMcikA#mAnaka_saMcikA#noun#2#RM
standard_product_term	mAnaka_guNana_paxa#mAnaka_guNana_paxa#noun#3#RM
standard_subroutine	mAnaka_upanemakA#mAnaka_upanemakA#noun#2#RM
standby_block	ApAwopayogI_KaMdaka#ApAwopayogI_KaMdaka#noun#2#RM
standby_computer	ApAwopayogI_aBikaliwra#ApAwopayogI_aBikaliwra#noun#2#RM
standby_register	ApAwopayogI_paMjI#ApAwopayogI_paMjI#noun#2#RM
star_network	wAraka_jAlakrama#wAraka_jAlakrama#noun#2#RM
start_signal	prAraMBaka_saMkewa#prAraMBaka_saMkewa#noun#2#RM
start_stop_system	prAraMBa_virAma_waMwra#prAraMBa_virAma_waMwra#noun#3#RM
start_stop_transmission	prAraMBa_virAma_saMcaraNa#prAraMBa_virAma_saMcaraNa#noun#3#RM
starting_dialling_signal	prAraMBana_dAyalana_saMkewa#prAraMBana_dAyalana_saMkewa#noun#3#RM
state_code	avasWA_kUta#avasWA_kUta#noun#2#RM
state_table	avasWA_sAraNI#avasWA_sAraNI#noun#2#RM
statement_body	kaWana_kAya#kaWana_kAya#noun#2#RM
static_allocation	sWEwika_niyawana#sWEwika_niyawana#noun#2#RM
static_buffering	sWEwika_cayakana#sWEwika_cayakana#noun#2#RM
static_display_image	sWEwika_praxarSa_prawibimba#sWEwika_praxarSa_prawibimba#noun#3#RM
static_error	sWEwika_wruti#sWEwika_wruti#noun#2#RM
static_ram	sWEwika_rEma#sWEwika_rEma#noun#2#RM
static_storage_allocation	sWEwika_BaMdAraNa_niyawana#sWEwika_BaMdAraNa_niyawana#noun#3#RM
static_variable	sWEwika_cara#sWEwika_cara#noun#2#RM
station_control_block	sWAnaka_niyaMwraka_KaMdaka#sWAnaka_niyaMwraka_KaMdaka#noun#3#RM
station_to_station_service	aMwarAsWAnaka_sevA#aMwarAsWAnaka_sevA#noun#4#RM
stationary_information_source	sWira_sUcanA_srowa#sWira_sUcanA_srowa#noun#3#RM
statistical_multiplexing	sAMKyikIya_bahusaMkewana#sAMKyikIya_bahusaMkewana#noun#2#RM
status_line	avasWiwi_lAina#avasWiwi_lAina#noun#2#RM
status_register	avasWiwi_paMjI#avasWiwi_paMjI#noun#2#RM
status_scan	avasiWiwi_kramavIkRaNa#avasiWiwi_kramavIkRaNa#noun#2#RM
step_size	sopAna_AmApa#sopAna_AmApa#noun#2#RM
stepper_switch	caraNaSa:_svica#caraNaSa:_svica#noun#2#RM
still_video	acala_ciwra#acala_ciwra#noun#2#RM
stochastic_matrix	prasaMBAvya_mEtriksa#prasaMBAvya_mEtriksa#noun#2#RM
stochastic_process	prasaMBAvya_prakrama#prasaMBAvya_prakrama#noun#2#RM
stop_bit	virAma_xvayaMka#virAma_xvayaMka#noun#2#RM
stop_character	virAma_saMprawIka#virAma_saMprawIka#noun#2#RM
stop_instruction	virAma_anuxeSa#virAma_anuxeSa#noun#2#RM
stop_key	virAma_kuMjI#virAma_kuMjI#noun#2#RM
stop_signal	virAma_saMkewa#virAma_saMkewa#noun#2#RM
storage_allocation	BaMdAraNa_niyawana#BaMdAraNa_niyawana#noun#2#RM
storage_area	BaMdAraNa_kRewra#BaMdAraNa_kRewra#noun#2#RM
storage_block	BaMdAraNa_KaMdaka#BaMdAraNa_KaMdaka#noun#2#RM
storage_density	BaMdAraNa_saGanawA#BaMdAraNa_saGanawA#noun#2#RM
storage_device	BaMdAraNa_yukwi#BaMdAraNa_yukwi#noun#2#RM
storage_drum	BaMdAraNa_drama#BaMdAraNa_drama#noun#2#RM
storage_fill	BaMdAraNa_BaraNa#BaMdAraNa_BaraNa#noun#2#RM
storage_fragmentation	BaMdAraNa_KaMdana#BaMdAraNa_KaMdana#noun#2#RM
storage_hierarchy	BaMdAraNa_paxAnukrama#BaMdAraNa_paxAnukrama#noun#2#RM
storage_location	BaMdAraNa_sWAna#BaMdAraNa_sWAna#noun#2#RM
storage_matrix	BaMdAraNa_mEtriksa#BaMdAraNa_mEtriksa#noun#2#RM
storage_oscilloscope	BaMdAraNa_xolanaxarSI#BaMdAraNa_xolanaxarSI#noun#2#RM
storage_parity_check	BaMdAraNa_kRamawA_jAMca#BaMdAraNa_kRamawA_jAMca#noun#3#RM
storage_protection	BaMdAraNa_rakRaNa#BaMdAraNa_rakRaNa#noun#2#RM
storage_register	BaMdAraNa_paMjI#BaMdAraNa_paMjI#noun#2#RM
storage_stack	BaMdAraNa_ciwi#BaMdAraNa_ciwi#noun#2#RM
storage_structure	BaMdAraNa_saMracanA#BaMdAraNa_saMracanA#noun#2#RM
store_and_forward	BaMdAraNa_agreRaNa#BaMdAraNa_agreRaNa#noun#3#RM
store_protection	BaMdAra_rakRaNa#BaMdAra_rakRaNa#noun#2#RM
stored_format_instruction	BaMdAriwa_sanrUpa_anuxeSa#BaMdAriwa_sanrUpa_anuxeSa#noun#3#RM
stored_program	BaMdAriwa_kramAxeSa#BaMdAriwa_kramAxeSa#noun#2#RM
stored_program_computer	BaMdAriwa_kramAxeSa_aBikaliwra#BaMdAriwa_kramAxeSa_aBikaliwra#noun#3#RM
straight_insertion_sort	sIXI_niviRti_SArtana#sIXI_niviRti_SArtana#noun#3#RM
straight_selection_sort	sIXAvaraNa_SArtana#sIXAvaraNa_SArtana#noun#3#RM
streaming_tape_transport	pravAhI_tepa_aBigama#pravAhI_tepa_aBigama#noun#3#RM
string_character	rajju_prawIka#rajju_prawIka#noun#2#RM
string_constant	rajju_sWirAMka#rajju_sWirAMka#noun#2#RM
string_length	rajju_xErGya#rajju_xErGya#noun#2#RM
string_manipulation	rajju_prakalana#rajju_prakalana#noun#2#RM
string_matching	rajju_sumelana#rajju_sumelana#noun#2#RM
string_segment	rajju_KaMda#rajju_KaMda#noun#2#RM
string_sorting	rajju_SArtana#rajju_SArtana#noun#2#RM
string_variable	rajju_cara#rajju_cara#noun#2#RM
strobe_pulse	aBicAyI_spaMxa#aBicAyI_spaMxa#noun#2#RM
strongly_connected	xqDa_saMbaxXa#xqDa_saMbaxXa#noun#2#RM
structure_of_arrays	saraNI_saMracanA#saraNI_saMracanA#noun#3#RM
structured_analysis	saMraciwa_viSleRaNa#saMraciwa_viSleRaNa#noun#2#RM
structured_language	saMraciwa_BARA#saMraciwa_BARA#noun#2#RM
structured_programming	saMraciwa_kramAxeSana#saMraciwa_kramAxeSana#noun#2#RM
stuffing_character	praBaraNa_saMprawIka#praBaraNa_saMprawIka#noun#2#RM
stylus_printer	SUka_muxriwra#SUka_muxriwra#noun#2#RM
sub_block	upaKaMdaka#upaKaMdaka#noun#2#RM
sub_field	upakRewra#upakRewra#noun#2#RM
sub_matrix	upamEtriksa#upamEtriksa#noun#2#RM
sub_program	upakramAxeSa#upakramAxeSa#noun#2#RM
sub_routine	upanemakA#upanemakA#noun#2#RM
sub_routine_library	upanemakA_kramAxeSa_saMgraha#upanemakA_kramAxeSa_saMgraha#noun#3#RM
sub_routine_statement	upanemakA_kaWana#upanemakA_kaWana#noun#3#RM
subscript_character	pAxa_saMprawIka#pAxa_saMprawIka#noun#2#RM
subscript_variable	pAxa_cara#pAxa_cara#noun#2#RM
substitute_character	prawisWApaka_saMprawIka#prawisWApaka_saMprawIka#noun#2#RM
suffix_notation	anulagna_saMkewana#anulagna_saMkewana#noun#2#RM
sum_of_products_expression	guNanaPala_yoga_vyaMjaka#guNanaPala_yoga_vyaMjaka#noun#4#RM
super_computer	mahA_aBikaliwra#mahA_aBikaliwra#noun#2#RM
super_conducting_technology	awicAlaka_prOxyogikI#awicAlaka_prOxyogikI#noun#3#RM
super_personal_computer	prODa_vEyakwika_aBikaliwra#prODa_vEyakwika_aBikaliwra#noun#3#RM
super_script_character	mUrxXAMka_saMprawIka#mUrxXAMka_saMprawIka#noun#3#RM
supervisor_program	paryavekRaka_kramAxeSa#paryavekRaka_kramAxeSa#noun#2#RM
support_program	sahAyaka_kramAxeSa#sahAyaka_kramAxeSa#noun#2#RM
surveillance_program	cOkasI_kramAxeSa#cOkasI_kramAxeSa#noun#2#RM
suspended_lock	nilaMbiwa_wAlaka#nilaMbiwa_wAlaka#noun#2#RM
swap_allocation_unit	gamAgama_niyawana_ekaka#gamAgama_niyawana_ekaka#noun#3#RM
swap_in	aMwargamAgama#aMwargamAgama#noun#2#RM
swap_out	bahirgamAgama#bahirgamAgama#noun#2#RM
switch_control_computer	svica_niyaMwraNa_aBikaliwra#svica_niyaMwraNa_aBikaliwra#noun#3#RM
switch_over	kriyAMwaraNa#kriyAMwaraNa#noun#2#RM
switch_register	svica_paMjI#svica_paMjI#noun#2#RM
switched_line	svica_lAina#svica_lAina#noun#2#RM
switching_centre	svicana_kenxra#svicana_kenxra#noun#2#RM
switching_circuit	svicana_paripaWa#svicana_paripaWa#noun#2#RM
switching_element	svicana_avayava#svicana_avayava#noun#2#RM
switching_function	svicana_Palana#svicana_Palana#noun#2#RM
switching_network	svicana_jAlakrama#svicana_jAlakrama#noun#2#RM
switching_speed	svicana_cAla#svicana_cAla#noun#2#RM
switching_theory	svicana_sixXAMwa#svicana_sixXAMwa#noun#2#RM
switching_variable	svicana_cara#svicana_cara#noun#2#RM
syllable_hyphen_character	aMwarakRarIya_hAiPana_prawIka#aMwarakRarIya_hAiPana_prawIka#noun#3#RM
symbol_manipulation	prawIka_prakalana#prawIka_prakalana#noun#2#RM
symbol_string	prawIka_rajju#prawIka_rajju#noun#2#RM
symbol_table	prawIka_sAraNI#prawIka_sAraNI#noun#2#RM
symbolic_address	prawIkAwmaka_pawA#prawIkAwmaka_pawA#noun#2#RM
symbolic_coding	prawIkAwmaka_kUtaleKana#prawIkAwmaka_kUtaleKana#noun#2#RM
symbolic_editor	prawIkAwmaka_saMpAxaka#prawIkAwmaka_saMpAxaka#noun#2#RM
symbolic_instruction	prawIkAwmaka_anuxeSa#prawIkAwmaka_anuxeSa#noun#2#RM
symbolic_language	prawIkAwmaka_BARA#prawIkAwmaka_BARA#noun#2#RM
symbolic_logic	prawIkAwmaka_warka#prawIkAwmaka_warka#noun#2#RM
symbolic_notation	prawIkAwmaka_saMkewana#prawIkAwmaka_saMkewana#noun#2#RM
symbolic_programming	prawIkAwmaka_kramAxeSana#prawIkAwmaka_kramAxeSana#noun#2#RM
symmetric_difference	samamiwa_aMwara#samamiwa_aMwara#noun#2#RM
symmetric_function	samamiwa_Palana#samamiwa_Palana#noun#2#RM
symmetric_matrix	samamiwa_mEtriksa#samamiwa_mEtriksa#noun#2#RM
symmetric_processor	samamiwa_saMsAXiwra#samamiwa_saMsAXiwra#noun#2#RM
symmetric_relation	samamiwa_saMbaMXa#samamiwa_saMbaMXa#noun#2#RM
sync_bit	wulyakAlika_xvayaMka#wulyakAlika_xvayaMka#noun#2#RM
synchronizing_signal	wulyakAlana_saMkewa#wulyakAlana_saMkewa#noun#2#RM
synchronous_communication	wulyakAlika_saMcAra#wulyakAlika_saMcAra#noun#2#RM
synchronous_data_link	wulyakAlika_AMkadA_SrqMKalA#wulyakAlika_AMkadA_SrqMKalA#noun#3#RM
synchronous_data_link_control	wulyakAlika_AMkadA_SrqMKalA_niyaMwraNa#wulyakAlika_AMkadA_SrqMKalA_niyaMwraNa#noun#4#RM
synchronous_data_transfer	wulyakAlika_AMkadA_sWAnAMwaraNa#wulyakAlika_AMkadA_sWAnAMwaraNa#noun#3#RM
synchronous_line_control	wulyakAlika_lAina_niyaMwraNa#wulyakAlika_lAina_niyaMwraNa#noun#3#RM
synchronous_operation	wulyakAlika_pracAlana#wulyakAlika_pracAlana#noun#2#RM
synchronous_satalite	wulyakAlika_upagraha#wulyakAlika_upagraha#noun#2#RM
synchronous_transmission	wulyakAlika_saMcaraNa#wulyakAlika_saMcaraNa#noun#2#RM
syntactic_error	vAkya_racanA_wruti#vAkya_racanA_wruti#noun#2#RM
syntax_analysis	vAkya_racanA_viSleRaNa#vAkya_racanA_viSleRaNa#noun#2#RM
syntax_diagram	vAkya_racanA_AreKa#vAkya_racanA_AreKa#noun#2#RM
syntax_error	vAkya_racanA_wruti#vAkya_racanA_wruti#noun#2#RM
syntax_language	vAkya_racanA_BARA#vAkya_racanA_BARA#noun#2#RM
syntax_tree	vAkya_racanA_warU#vAkya_racanA_warU#noun#2#RM
system_analysis	waMwra_viSleRaNa#waMwra_viSleRaNa#noun#2#RM
system_approach	waMwra_upagamana#waMwra_upagamana#noun#2#RM
system_chart	waMwra_saMciwra#waMwra_saMciwra#noun#2#RM
system_control_language	waMwra_niyaMwraNa_BARA#waMwra_niyaMwraNa_BARA#noun#3#RM
system_crash	waMwra_BaMjana#waMwra_BaMjana#noun#2#RM
system_design	waMwra_aBikalpanA#waMwra_aBikalpanA#noun#2#RM
system_engineering	waMwra_iMjIniyarI#waMwra_iMjIniyarI#noun#2#RM
system_error	waMwra_wruti#waMwra_wruti#noun#2#RM
system_flow_chart	waMwra_pravAha_saMciwra#waMwra_pravAha_saMciwra#noun#3#RM
system_generation	waMwra_janana#waMwra_janana#noun#2#RM
system_input_device	waMwra_niveSa_yukwi#waMwra_niveSa_yukwi#noun#3#RM
system_interface	waMwra_aMwarApqRTa#waMwra_aMwarApqRTa#noun#2#RM
system_interrupt	waMwra_aMwarAyaka#waMwra_aMwarAyaka#noun#2#RM
system_language	waMwra_BARA#waMwra_BARA#noun#2#RM
system_life_cycle	waMwra_jIvana_cakra#waMwra_jIvana_cakra#noun#3#RM
system_management	waMwra_prabaMXa#waMwra_prabaMXa#noun#2#RM
system_network_architecture	waMwra_jAlakrama_vAswavikawA#waMwra_jAlakrama_vAswavikawA#noun#3#RM
system_output_device	waMwra_nirgama_yukwi#waMwra_nirgama_yukwi#noun#3#RM
system_program	waMwra_kramAxeSa#waMwra_kramAxeSa#noun#2#RM
system_programmer	waMwra_kramAxeSaka#waMwra_kramAxeSaka#noun#2#RM
system_programming_language	waMwra_kramAxeSana_BARA#waMwra_kramAxeSana_BARA#noun#3#RM
system_reliability	waMwra_viSvasanIyawA#waMwra_viSvasanIyawA#noun#2#RM
system_resident	smqwivAsI#smqwivAsI#noun#2#RM
system_resident_software	smqwivAsI_prakriyA_sAmagrI#smqwivAsI_prakriyA_sAmagrI#noun#3#RM
system_resource	waMwra_sAXana#waMwra_sAXana#noun#2#RM
system_resource_manager	waMwra_sAXana_prabaMXaka#waMwra_sAXana_prabaMXaka#noun#3#RM
system_response	waMwra_anukriyA#waMwra_anukriyA#noun#2#RM
system_security	waMwra_surakRA#waMwra_surakRA#noun#2#RM
system_shutdown	waMwra_samApana#waMwra_samApana#noun#2#RM
system_simulation	waMwra_anukAra#waMwra_anukAra#noun#2#RM
system_software	waMwra_prakriyA_sAmagrI#waMwra_prakriyA_sAmagrI#noun#2#RM
system_structure	waMwra_saMracanA#waMwra_saMracanA#noun#2#RM
system_subroutine	waMwra_upanemakA#waMwra_upanemakA#noun#2#RM
system_task	waMwra_kArya#waMwra_kArya#noun#2#RM
system_testing	waMwra_parIkRaNa#waMwra_parIkRaNa#noun#2#RM
system_utility	waMwra_upayogiwA#waMwra_upayogiwA#noun#2#RM
system_utility_program	waMwra_upayogiwA_kramAxeSa#waMwra_upayogiwA_kramAxeSa#noun#3#RM
t_flipflop_t	xvimAniwra#xvimAniwra#noun#3#RM
t_gateternary_selected_gate_)	wrayI_varaNiwra_xvAra#wrayI_varaNiwra_xvAra#noun#4#RM
t_type_flip_flop_t	prakAra_xvimAniwra#prakAra_xvimAniwra#noun#5#RM
tab_command	tEba_samAxeSa#tEba_samAxeSa#noun#2#RM
table_look_up	sAraNI_avalokaNa#sAraNI_avalokaNa#noun#3#RM
table_simulator	sAraNI_anukAraka#sAraNI_anukAraka#noun#2#RM
tabular_language	sAraNIbaxXa_BARA#sAraNIbaxXa_BARA#noun#2#RM
tandem_computer	agrAnukrama_aBikaliwra#agrAnukrama_aBikaliwra#noun#2#RM
tandem_office	agrAnukrama_kenxra#agrAnukrama_kenxra#noun#2#RM
tape_drive	tepa_cAlana#tepa_cAlana#noun#2#RM
tape_format	tepa_saMrUpa#tepa_saMrUpa#noun#2#RM
tape_label	tepa_levala#tepa_levala#noun#2#RM
tape_marker	tepa_cihanaka#tepa_cihanaka#noun#2#RM
target_computer	lakRya_aBikaliwra#lakRya_aBikaliwra#noun#2#RM
task_control_block	kArya_niyaMwraka_KaMdaka#kArya_niyaMwraka_KaMdaka#noun#3#RM
task_management	kArya_prabaMXa#kArya_prabaMXa#noun#2#RM
task_scheduler	kArya_niyojaka#kArya_niyojaka#noun#2#RM
tele_confrencing	xUra_sammelana#xUra_sammelana#noun#2#RM
teleprocessing_network	xUra_saMsAXana_jAlakrama#xUra_saMsAXana_jAlakrama#noun#2#RM
teletype_writer	xUra_taMkiwra#xUra_taMkiwra#noun#2#RM
tens_complement	xasapUraka#xasapUraka#noun#2#RM
terminal_controller	aMwaka_niyaMwraka#aMwaka_niyaMwraka#noun#2#RM
terminal_cursor	aMwaka_prasaMkewaka#aMwaka_prasaMkewaka#noun#2#RM
terminal_equipment	aMwaka_upakaraNa#aMwaka_upakaraNa#noun#2#RM
terminal_mode	aMwaka_viXA#aMwaka_viXA#noun#2#RM
terminal_node	aMwaka_AsaMXi#aMwaka_AsaMXi#noun#2#RM
terminal_room	aMwaka_kakRa#aMwaka_kakRa#noun#2#RM
terminal_symbol	aMwaka_prawIka#aMwaka_prawIka#noun#2#RM
terminal_user	aMwaka_upayokwA#aMwaka_upayokwA#noun#2#RM
terminology_bank	SabxAvalI_bEMka#SabxAvalI_bEMka#noun#2#RM
ternary_logic	wrayI_warka#wrayI_warka#noun#2#RM
test_bed	parIkRaNa_kramAxeSAvalI#parIkRaNa_kramAxeSAvalI#noun#2#RM
test_data_generator	parIkRaNa_AMkadA_janiwra#parIkRaNa_AMkadA_janiwra#noun#3#RM
test_program	parIkRaNa_kramAxeSa#parIkRaNa_kramAxeSa#noun#2#RM
test_run	parIkRaNa_XAva#parIkRaNa_XAva#noun#2#RM
text_editor	pATqyAMSa_saMpAxaka#pATqyAMSa_saMpAxaka#noun#2#RM
text_processing	pATqyAMSa_saMsAXana#pATqyAMSa_saMsAXana#noun#2#RM
text_string_search	pATqyAMSa_rajju_Koja#pATqyAMSa_rajju_Koja#noun#3#RM
theorum_proving	prameya_sixXi#prameya_sixXi#noun#2#RM
thermal_printer	wApIya_muxriwra#wApIya_muxriwra#noun#2#RM
thick_film_memory	sWUla_Pilma_smqwi#sWUla_Pilma_smqwi#noun#3#RM
thin_film_memory	wanu_Pilma_smqwi#wanu_Pilma_smqwi#noun#3#RM
third_generator_computer	wqwIya_pIDI_aBikaliwra#wqwIya_pIDI_aBikaliwra#noun#3#RM
threaded_tree	sUwriwa_warU#sUwriwa_warU#noun#2#RM
three_dimensional_array	wrivima_saraNI#wrivima_saraNI#noun#3#RM
three_state_buffer	wri_avasWA_cayaka#wri_avasWA_cayaka#noun#3#RM
threshold_gate	xehalI_xvAra#xehalI_xvAra#noun#2#RM
tightly_coupled	xqDawA_yugmiwa#xqDawA_yugmiwa#noun#2#RM
time_complexity	kAla_jatilawA#kAla_jatilawA#noun#2#RM
time_delay_circuit	samaya_vilaMba_paripaWa#samaya_vilaMba_paripaWa#noun#3#RM
time_division	kAla_viBAjana#kAla_viBAjana#noun#2#RM
time_frame	kAla_samApana#kAla_samApana#noun#2#RM
time_out	kAla_BAjana#kAla_BAjana#noun#2#RM
time_slicing	kAla_kawalIyana#kAla_kawalIyana#noun#2#RM
time_stamping	samayAMkaNa#samayAMkaNa#noun#2#RM
top_down_development	SIrRa_pAxa_vikAsa#SIrRa_pAxa_vikAsa#noun#3#RM
top_down_parsing	SIrRa_pAxa_paxa_vinyAsa#SIrRa_pAxa_paxa_vinyAsa#noun#3#RM
totally_ordered_structure	pUrNawa:_kramiwa_saMracanA#pUrNawa:_kramiwa_saMracanA#noun#3#RM
trace_program	anureKa_kramAxeSa#anureKa_kramAxeSa#noun#2#RM
traffic_control	yAwAyAwa_niyaMwraNa#yAwAyAwa_niyaMwraNa#noun#2#RM
trail_run	jAMca_xOra#jAMca_xOra#noun#2#RM
train_printer	prapaMkwi_muxriwra#prapaMkwi_muxriwra#noun#2#RM
trans_literation	lipyaMwaraNa#lipyaMwaraNa#noun#2#RM
transaction_processing	kriyAkalApa_saMsAXana#kriyAkalApa_saMsAXana#noun#2#RM
transfer_circuit	sWAnAMwaraNa_paripaWa#sWAnAMwaraNa_paripaWa#noun#2#RM
transfer_time	sWAnAMwaraNa_kAla#sWAnAMwaraNa_kAla#noun#2#RM
transform_domain	rUpAMwara_prAMwa#rUpAMwara_prAMwa#noun#2#RM
transient_error	kRaNika_wruti#kRaNika_wruti#noun#2#RM
transister-transister_logic	trAMjistara-trAMjistara_warka#trAMjistara-trAMjistara_warka#noun#2#RM
transitive_closure	saMkrAmI_saMvaraka#saMkrAmI_saMvaraka#noun#2#RM
translator_program	anuvAxaka_kramAxeSa#anuvAxaka_kramAxeSa#noun#2#RM
transmission_channel	saMcaraNa_praNAla#saMcaraNa_praNAla#noun#2#RM
transmission_facility	saMcaraNa_suviXA#saMcaraNa_suviXA#noun#2#RM
transmission_interface	saMcaraNa_aMwarApqRTa#saMcaraNa_aMwarApqRTa#noun#2#RM
transmission_line	saMcaraNa_lAina#saMcaraNa_lAina#noun#2#RM
transmission_link	saMcaraNa_kadI#saMcaraNa_kadI#noun#2#RM
transmission_loss	saMcaraNa_hAni#saMcaraNa_hAni#noun#2#RM
transmission_mmedium	saMcaraNa_mAXyama#saMcaraNa_mAXyama#noun#2#RM
transmission_rate	saMcaraNa_xara#saMcaraNa_xara#noun#2#RM
transmission_service	saMcaraNa_sevA#saMcaraNa_sevA#noun#2#RM
transmit_flow_control	saMcaraNa_pravAha_niyaMwraNa#saMcaraNa_pravAha_niyaMwraNa#noun#3#RM
transmitted_information	saMcariwa_sUcanA#saMcariwa_sUcanA#noun#2#RM
transperancy_mode	pAraxarSiwA_viXA#pAraxarSiwA_viXA#noun#2#RM
transperant_information	pAraxarSI_sUcanA#pAraxarSI_sUcanA#noun#2#RM
transport_unit	parivahana_ekaka#parivahana_ekaka#noun#2#RM
transverse_parity_check	anuprasWa_samawA_jAMca#anuprasWa_samawA_jAMca#noun#3#RM
transverse_redundancy_check	anuprasWa_awirikwawA_jAMca#anuprasWa_awirikwawA_jAMca#noun#3#RM
trapezium_rule	samalamba_niyama#samalamba_niyama#noun#2#RM
trapping_mode	prapASana_viXA#prapASana_viXA#noun#2#RM
tree_grammer	warU_vyAkaraNa#warU_vyAkaraNa#noun#2#RM
tree_network	warU_jAlakrama#warU_jAlakrama#noun#2#RM
tree_search	warU_Koja#warU_Koja#noun#2#RM
tree_structure	warU_saMracanA#warU_saMracanA#noun#2#RM
triangular_matrix	wrikoNAkAra_mEtriksa#wrikoNAkAra_mEtriksa#noun#2#RM
triangular_waveform	wrikoNIya_waraMga_rUpa#wrikoNIya_waraMga_rUpa#noun#2#RM
tributery_station	sahAyaka_kenxra#sahAyaka_kenxra#noun#2#RM
tripple_register	wriguNa_paMjI#wriguNa_paMjI#noun#2#RM
trivial_graph	wucCAleKa/avAleKa#wucCAleKa/avAleKa#noun#2#RM
trouble_shoot	viGna_nivAraNa#viGna_nivAraNa#noun#2#RM
trouble_shooting	viXna_nivAraNa#viXna_nivAraNa#noun#2#RM
truncation_error	Cinna_wruti#Cinna_wruti#noun#2#RM
trunk_exchange	traMka_kenxra#traMka_kenxra#noun#2#RM
trunk_order	traMka_AxeSa#traMka_AxeSa#noun#2#RM
turing_computable	tayUriMga_aBikalanIya#tayUriMga_aBikalanIya#noun#2#RM
turing_machine	tayUriMga_maSIna#tayUriMga_maSIna#noun#2#RM
turn_around_time	prawivarwana_kAla#prawivarwana_kAla#noun#3#RM
turn_key_system	varwana_kuMjI_waMwra#varwana_kuMjI_waMwra#noun#3#RM
twelve_edge=_twelve_punch_)	xvAxaSa_CixraNa#xvAxaSa_CixraNa#noun#4#RM
twisted_pair	vyavarwiwa_yugma#vyavarwiwa_yugma#noun#2#RM
two_bit_byte	xo_xvayaMka_bAita#xo_xvayaMka_bAita#noun#3#RM
two_dimensional_array	xvivima_saraNI#xvivima_saraNI#noun#3#RM
two_level_grammer	xvi_swara_vyAkaraNa#xvi_swara_vyAkaraNa#noun#3#RM
two_pass_assembler	xvi_xOra_kodAMwaraka#xvi_xOra_kodAMwaraka#noun#3#RM
two_way_linked_list	xviXA_SrqMKaliwa_sUci#xviXA_SrqMKaliwa_sUci#noun#4#RM
twos_compliment	xo_kA_pUraka#xo_kA_pUraka#noun#2#RM
twoway_simultaneous_communication	xviXA_yugapawa_saMcAra#xviXA_yugapawa_saMcAra#noun#3#RM
type_declaration	prakAra_GoRaNA#prakAra_GoRaNA#noun#2#RM
type_face	tAipa_Pesa#tAipa_Pesa#noun#2#RM
type_font	tAipa_PoNta#tAipa_PoNta#noun#2#RM
type_head	taMkaNa_SIrRa#taMkaNa_SIrRa#noun#2#RM
typewriter_terminal	taMkiwra_tarminala#taMkiwra_tarminala#noun#2#RM
v_management	smqwi_prabaMXa#smqwi_prabaMXa#noun#2#RM
variable_address	parivarwI_pawA#parivarwI_pawA#noun#2#RM
variable_field	parivarwI_kRewra#parivarwI_kRewra#noun#2#RM
variable_field_length	parivarwI_kRewra_laMbAI#parivarwI_kRewra_laMbAI#noun#3#RM
variable_format_input	parivarwI_saMrUpa_niveSa#parivarwI_saMrUpa_niveSa#noun#3#RM
variable_information_processing	parivarwI_sUcanA_saMsAXana#parivarwI_sUcanA_saMsAXana#noun#3#RM
variable_length_record	parivarwI_laMbAI_aBileKa#parivarwI_laMbAI_aBileKa#noun#3#RM
variable_length_vector	parivarwI_laMbAI_saxiSa#parivarwI_laMbAI_saxiSa#noun#3#RM
variable_length_word	parivarwI_laMbAI_Sabxa#parivarwI_laMbAI_Sabxa#noun#3#RM
variable_point	parivarwI_viMxu#parivarwI_viMxu#noun#2#RM
variable_symbol	parivarwI_prawIka#parivarwI_prawIka#noun#2#RM
variable_word	parivarwI_Sabxa#parivarwI_Sabxa#noun#2#RM
variable_word_length	parivarwI_Sabxa_laMbAI#parivarwI_Sabxa_laMbAI#noun#3#RM
variant_field	parivarwI_kRewra#parivarwI_kRewra#noun#2#RM
vector_generator	saxiSa_janiwra#saxiSa_janiwra#noun#2#RM
vector_graphics	saxiSa_AleKikI#saxiSa_AleKikI#noun#2#RM
veftvoice_frequency_facility_terminal_)	vAk_Avqwwi_suviXA_aMwaka#vAk_Avqwwi_suviXA_aMwaka#noun#4#RM
verification_condition	sawyApana_prawibaMXa#sawyApana_prawibaMXa#noun#2#RM
version_number	ArUpa_saMKyA#ArUpa_saMKyA#noun#2#RM
vertical_feed	urXvAXara_BaraNa#urXvAXara_BaraNa#noun#2#RM
vertical_format	urXvAXara_saMrUpa#urXvAXara_saMrUpa#noun#2#RM
vertical_redundancy_check	urXvAXara_awirikwawA_jAMca#urXvAXara_awirikwawA_jAMca#noun#3#RM
vertical_table	urXvAXara_sAraNI#urXvAXara_sAraNI#noun#2#RM
very_large_scale_integration	awi_bqhawa_ekIkaraNa#awi_bqhawa_ekIkaraNa#noun#4#RM
vftsvoice_frequency_telegraph_system_)	vAk_Avqwwi_wAra_waMwra#vAk_Avqwwi_wAra_waMwra#noun#4#RM
video_bandwidth	vidiyo_bEMda_cOdAI#vidiyo_bEMda_cOdAI#noun#2#RM
video_camera	vidiyo_kEmarA#vidiyo_kEmarA#noun#2#RM
video_cassette	vidiyo_kEseta#vidiyo_kEseta#noun#2#RM
video_conferencing	vidiyo_xUra_sammelana#vidiyo_xUra_sammelana#noun#2#RM
video_game	vidiyo_Kela#vidiyo_Kela#noun#2#RM
video_graph	vidiyo_AleKa#vidiyo_AleKa#noun#2#RM
video_signal	vidiyo_saMkewa#vidiyo_saMkewa#noun#2#RM
video_terminal	vidiyo_aMwaka#vidiyo_aMwaka#noun#2#RM
virtual_address	ABAsI_pawA#ABAsI_pawA#noun#2#RM
virtual_circuit	ABAsI_paripaWa#ABAsI_paripaWa#noun#2#RM
virtual_connection	ABAsI_saMbaMXana#ABAsI_saMbaMXana#noun#2#RM
virtual_machine	ABAsI_yaMwra#ABAsI_yaMwra#noun#2#RM
virtual_memory	ABAsI_smqwi#ABAsI_smqwi#noun#2#RM
virtual_route	ABAsI_mArga#ABAsI_mArga#noun#2#RM
virtual_storage_access_method	ABAsI_BaMdAraNa_aBigama_viXi#ABAsI_BaMdAraNa_aBigama_viXi#noun#4#RM
virtual_terminal	ABAsI_aMwaka#ABAsI_aMwaka#noun#2#RM
visual_enquiry_station	cAkRuka_pUCawACa_kenxra#cAkRuka_pUCawACa_kenxra#noun#3#RM
visual_scanner	cAkRuka_kramavIkRaNa#cAkRuka_kramavIkRaNa#noun#2#RM
vlsivery_large_scale_integration_)	awivqhaw_ekIkaraNa#awivqhaw_ekIkaraNa#noun#4#RM
voice_band	vAk_bENda#vAk_bENda#noun#2#RM
voice_grade_channel	vAk_koti_praNAla#vAk_koti_praNAla#noun#3#RM
volatile_file	urjA_hrAsa_saMcikA#urjA_hrAsa_saMcikA#noun#2#RM
volatile_memory	urjA_hrAsa_smqwi#urjA_hrAsa_smqwi#noun#2#RM
volume_serial_number	prabalawA_krama_saMKyA#prabalawA_krama_saMKyA#noun#3#RM
vtocvolume_table_of_contents_)	KaMda_sUcI#KaMda_sUcI#noun#4#RM
wait_operation	prawIkRA_saMkriyA#prawIkRA_saMkriyA#noun#2#RM
waiting_time	prawIkRA_kAla#prawIkRA_kAla#noun#2#RM
walsh_function	vAlSa_Palana#vAlSa_Palana#noun#2#RM
walsh_transform	vAlSa_rUpAMwara#vAlSa_rUpAMwara#noun#2#RM
warm_start=restart_)	puna:_prAraMBana#puna:_prAraMBana#noun#2#RM
warm_up_time	wEyArI_kAla#wEyArI_kAla#noun#3#RM
wave_guide	waraMga_paWaka#waraMga_paWaka#noun#2#RM
weakly_connected_graph	xurbalawa:_saMbaMXiwa_AleKa#xurbalawa:_saMbaMXiwa_AleKa#noun#3#RM
weighted_graph	BAriwa_AleKa#BAriwa_AleKa#noun#2#RM
wide_area_network	vqhawa_kRewra_jAlakrama#vqhawa_kRewra_jAlakrama#noun#3#RM
winchester_technology	vinvestara_prOxyogikI#vinvestara_prOxyogikI#noun#2#RM
wired_program_computer	wArayukwa_kramAxeSa_aBikaliwra#wArayukwa_kramAxeSa_aBikaliwra#noun#3#RM
word_index	Sabxa_sUci#Sabxa_sUci#noun#2#RM
word_pattern	Sabxa_prawirUpa#Sabxa_prawirUpa#noun#2#RM
word_processing_equipment	Sabxa_saMsAXana_upakaraNa#Sabxa_saMsAXana_upakaraNa#noun#3#RM
word_processor	Sabxa_saMsAXiwra#Sabxa_saMsAXiwra#noun#2#RM
word_proessing	Sabxa_saMsAXana#Sabxa_saMsAXana#noun#2#RM
word_size=word_length_)	Sabxa_laMbAI#Sabxa_laMbAI#noun#3#RM
word_wrapping	Sabxa_veRtana#Sabxa_veRtana#noun#2#RM
work_session	kArya_sawra#kArya_sawra#noun#2#RM
work_space	kAryakRewra#kAryakRewra#noun#2#RM
work_station	kArya_kenxra#kArya_kenxra#noun#2#RM
working_memory	kAryakArI_smqwi#kAryakArI_smqwi#noun#2#RM
working_space	kAryakRewra#kAryakRewra#noun#2#RM
write_cycle_time	leKana_cakra_kAla#leKana_cakra_kAla#noun#3#RM
write_enable	leKana_samarWakArI#leKana_samarWakArI#noun#2#RM
write_error	leKana_wruti#leKana_wruti#noun#2#RM
write_memory_lock	leKana_smqwi_wAlaka#leKana_smqwi_wAlaka#noun#3#RM
write_protection	leKana_rakRaNa#leKana_rakRaNa#noun#2#RM
write_rate	leKana_xara#leKana_xara#noun#2#RM
write_time	leKana_kAla#leKana_kAla#noun#2#RM
xerographic_printer	jIrogrAPI_muxriwra#jIrogrAPI_muxriwra#noun#2#RM
zero_address	SUnya_pawA#SUnya_pawA#noun#2#RM
zero_bit	SUnya_xvayaMka#SUnya_xvayaMka#noun#2#RM
zero_compliment	SUnya_pUraka#SUnya_pUraka#noun#2#RM
zero_elimination	SUnya_nirAkaraNa#SUnya_nirAkaraNa#noun#2#RM
zero_flag	SUnya_pawAkA#SUnya_pawAkA#noun#2#RM
zero_level_address	SUnya_swara_pawA#SUnya_swara_pawA#noun#3#RM
zero_page_addressing	SUnya_pqRTa_pawABigamana#SUnya_pqRTa_pawABigamana#noun#3#RM
zero_state	SUnyAvasWA#SUnyAvasWA#noun#2#RM
zone_punch	kRewra_Cixra#kRewra_Cixra#noun#2#RM
zoom_in	AkAra_varxXana#AkAra_varxXana#noun#2#RM
zoom_out	AkAra_hAsana#AkAra_hAsana#noun#2#RM
