#geotechnology multi word dictionary extracted by Monika Sharma. Formatted by Roja (26-01-2016)
#Changes:: 1) Separated single word and multi words into separate dictionaries
#          2) English words are converted to lower case
#          3) Added category as 'noun' by default
#          4) If last word is not punctuation then treated last word as head
#             or else treated last but one word as head
#################################################################################
ablation_of_snow	hima_apakRaraNa#hima_apakRaraNa#noun#3#RM
above_ground_reservoir	BUmi_se_Upara_kA_jalASaya#BUmi_se_Upara_kA_jalASaya#noun#3#RM
abrasive_charge	apaGarRI_praBAra#apaGarRI_praBAra#noun#2#RM
absolute_specific_gravity	pUrNa_viSiRta_gurUwva_(AnupAwika_Ganawva)#pUrNa_viSiRta_gurUwva_(AnupAwika_Ganawva)#noun#3#RM
absolute_voluma	SuxXa_Ayawana#SuxXa_Ayawana#noun#2#RM
absorption_loss	avaSoRaNa_kRawi#avaSoRaNa_kRawi#noun#2#RM
accelerated_test	wvariwa_parIkRaNa#wvariwa_parIkRaNa#noun#2#RM
accumulated_rainfall	saMciwa_varRA#saMciwa_varRA#noun#2#RM
acid_rain	amlIya_varRA#amlIya_varRA#noun#2#RM
acid_soil	amlIya_mqxA#amlIya_mqxA#noun#2#RM
acidity_of_water	jala_amlawA#jala_amlawA#noun#3#RM
aerial_map	AkASIya_mAnaciwra#AkASIya_mAnaciwra#noun#2#RM
aggregate_abrasion_value	rodZI_GarRaNamAna#rodZI_GarRaNamAna#noun#3#RM
aggregate_crushing_value	rodZI_xalanamAna#rodZI_xalanamAna#noun#3#RM
aggregate_impact_apparatus	rodZI_saMGatta_upakaraNa#rodZI_saMGatta_upakaraNa#noun#3#RM
air_condition_plant	vAwAnukUlana_saMyaMwra#vAwAnukUlana_saMyaMwra#noun#3#RM
air_content	vAyu_mAwrA#vAyu_mAwrA#noun#2#RM
air_entraining_agent	vAyu_ArohI_karmaka#vAyu_ArohI_karmaka#noun#3#RM
air_water_jet	vAyu_jala_jEta#vAyu_jala_jEta#noun#3#RM
alkali_aggregate_reaction	kRAra_rodZI_prawikriyA#kRAra_rodZI_prawikriyA#noun#3#RM
alkali_silica_gel	kRAra_silikA_jela#kRAra_silikA_jela#noun#3#RM
alkaline_land	kRArIya_BUmi#kRArIya_BUmi#noun#2#RM
alkalinity_of_water	jala_kRArawA#jala_kRArawA#noun#3#RM
allied_&_extension_services	saMbaxXa_waWA_viswAra_sevAeM#saMbaxXa_waWA_viswAra_sevAeM#noun#4#RM
aluminous_cement	EluminI_sImeMta#EluminI_sImeMta#noun#2#RM
analytical_balance	vESleRika_wulA/saMwulana#vESleRika_wulA/saMwulana#noun#2#RM
angularity_factor	koNAkAraka_wawva/Gataka#koNAkAraka_wawva/Gataka#noun#2#RM
angularity_number	koNika_saMKyA#koNika_saMKyA#noun#2#RM
annual_flood	vArRika_bADZa#vArRika_bADZa#noun#2#RM
antecedent_precipitation	pUrvavarwI_avakRepaNa/varRaNa#pUrvavarwI_avakRepaNa/varRaNa#noun#2#RM
apparent_specific_gravity	ABAsI_viSiRta_Ganawva#ABAsI_viSiRta_Ganawva#noun#3#RM
applied_hydrology	anuprayukwa/vyAvahArika_jalavijFAna#anuprayukwa/vyAvahArika_jalavijFAna#noun#2#RM
appropriate_technology	upayukwa_prOxyogikI#upayukwa_prOxyogikI#noun#2#RM
arable_land	kqRi_yogya_BUmi#kqRi_yogya_BUmi#noun#2#RM
area_of_influence	praBAva_kRewra#praBAva_kRewra#noun#3#RM
area_prone_to_floods	bADZa_pravqwwa_kRewra#bADZa_pravqwwa_kRewra#noun#4#RM
areal_precipitation	kRewrIya_avakRepaNa#kRewrIya_avakRepaNa#noun#2#RM
artesian_aquifer	uwsruwa_jalaxAyI_swara#uwsruwa_jalaxAyI_swara#noun#2#RM
artesian_well	uwsruwa_kUpa/bumba_kUpa#uwsruwa_kUpa/bumba_kUpa#noun#2#RM
artificial_precipitation	kqwrima_avakRepaNa/varRaNa#kqwrima_avakRepaNa/varRaNa#noun#2#RM
artificial_recharge	kqwrima_puna:_pUraNa/punarBaraNa#kqwrima_puna:_pUraNa/punarBaraNa#noun#2#RM
atomic_weight	paramANuBAra#paramANuBAra#noun#2#RM
auger_borings	oYgara_veXana#oYgara_veXana#noun#2#RM
augmentation_of_water_supply	jala_ApUrwi_kA_viswAra/saMvarXana#jala_ApUrwi_kA_viswAra/saMvarXana#noun#4#RM
auto_clave_apparatus	BApa_saha_upakaraNa/Atokaleva_upakaraNa#BApa_saha_upakaraNa/Atokaleva_upakaraNa#noun#3#RM
auto_level_consolidation_apparatus	svacAliwa_samawalIkaraNa_saMpiMdana_upakaraNa#svacAliwa_samawalIkaraNa_saMpiMdana_upakaraNa#noun#4#RM
autogeneous_healing	svajAwa_yA_svawa:_upaSamana/BarAI#svajAwa_yA_svawa:_upaSamana/BarAI#noun#2#RM
automatic_pore_pressure-assembly	svacAliwa_raMXra_xAba_samuccaya#svacAliwa_raMXra_xAba_samuccaya#noun#3#RM
automatic_rain_gauge	svawa:_varRA_pramApI#svawa:_varRA_pramApI#noun#3#RM
automatic_sieve_shaker	svacAliwa_CalanI_(cAlanI)prakampaka#svacAliwa_CalanI_(cAlanI)prakampaka#noun#3#RM
auxiliary_equipment	sahAyaka_upaskara#sahAyaka_upaskara#noun#2#RM
auxiliary_gauge	sahAyaka_pramApI#sahAyaka_pramApI#noun#2#RM
available_head	prApya_xAboccawA/upalabXa_SIrRa#prApya_xAboccawA/upalabXa_SIrRa#noun#2#RM
available_moisture	prApya_namI/ArxrawA#prApya_namI/ArxrawA#noun#2#RM
average_annual_flood	Osawa_vArRika_bADZa#Osawa_vArRika_bADZa#noun#3#RM
average_annual_rainfall	Osawa_vArRika_varRA#Osawa_vArRika_varRA#noun#3#RM
b.o.d._incubator	bI.o.dI.URmAciwra_iMkyUbetara#bI.o.dI.URmAciwra_iMkyUbetara#noun#2#RM
back_fill	pqRTaBaraNa#pqRTaBaraNa#noun#2#RM
back_water	apravAhI_jala/paScajala#apravAhI_jala/paScajala#noun#2#RM
balancing_unit	saMwulana_ekaka#saMwulana_ekaka#noun#2#RM
ball_mill	bAla_mila/gaMxacakkI#bAla_mila/gaMxacakkI#noun#2#RM
bank_storage	wata_saMcayana#wata_saMcayana#noun#2#RM
bar_chart	bAra_wAlikA#bAra_wAlikA#noun#2#RM
base_flow	AXAraBUwa_pravAha#AXAraBUwa_pravAha#noun#2#RM
base_level_of_deposition	nikRepaNa_kA_AXAra_wala#nikRepaNa_kA_AXAra_wala#noun#4#RM
base_map	AXAra_mAnaciwra#AXAra_mAnaciwra#noun#2#RM
basement_layer	AXAra_parawa#AXAra_parawa#noun#2#RM
basic_cultivation	mUla_kqRi#mUla_kqRi#noun#2#RM
battery_charger	bEtarI_cArjara/AveSaka#bEtarI_cArjara/AveSaka#noun#2#RM
bed_load	walaBAra/walAvasAxa/walaCata#walaBAra/walAvasAxa/walaCata#noun#2#RM
bed_material	wala_sAmagrI#wala_sAmagrI#noun#2#RM
bed_rock	wala_SEla#wala_SEla#noun#2#RM
bench_grinder	bEMca_peRaka#bEMca_peRaka#noun#2#RM
bench_mark	nirxeSa_walacinha/beMcamArka#nirxeSa_walacinha/beMcamArka#noun#2#RM
big_load_cells	aXika_BAravAhI_sela#aXika_BAravAhI_sela#noun#3#RM
black_alkali_soil	kAlI_kRAra-mqxA#kAlI_kRAra-mqxA#noun#3#RM
black_cotton_soil	kAlI_kapAsa_mqxA#kAlI_kapAsa_mqxA#noun#3#RM
blains_apparatus	blensa_upakaraNa#blensa_upakaraNa#noun#2#RM
blast_furnace_slag	visPotaka_BatTI_slega#visPotaka_BatTI_slega#noun#3#RM
blended_earth_fill	saMmiSraNa_mittI_BaraNa#saMmiSraNa_mittI_BaraNa#noun#3#RM
bond_strength	yojaka_Sakwi/baMXana_Sakwi#yojaka_Sakwi/baMXana_Sakwi#noun#2#RM
bonding_materials	baMXana/yojaka_sAmagrI#baMXana/yojaka_sAmagrI#noun#2#RM
bore_hole	bora_hola/beXana_Cixra#bora_hola/beXana_Cixra#noun#2#RM
borrow_area	Kaniwa_kRewra#Kaniwa_kRewra#noun#2#RM
borrow_materials	Kaniwa_sAmagriyAM#Kaniwa_sAmagriyAM#noun#2#RM
bottle_sampler	bowala_prawixarSI#bowala_prawixarSI#noun#2#RM
bucket_auger	baketa_Agara/baramI#baketa_Agara/baramI#noun#2#RM
buckner_funnel	bakanara_Panala/kIpa#bakanara_Panala/kIpa#noun#2#RM
bulk_density	sWUla_Ganawva#sWUla_Ganawva#noun#2#RM
bulking_factor	sWUlana_guNaka#sWUlana_guNaka#noun#2#RM
bulking_of_sand	rewa_kA_PUlanA/rewa_viswAraNa#rewa_kA_PUlanA/rewa_viswAraNa#noun#3#RM
buoyancy_meter	uwplAvakawA_mApaka/ApekRika_laGuwA_mApaka#uwplAvakawA_mApaka/ApekRika_laGuwA_mApaka#noun#2#RM
by_pass_gate	upamArga_PAtaka#upamArga_PAtaka#noun#3#RM
by_product	gONa_uwpAxana/upowpAxa#gONa_uwpAxana/upowpAxa#noun#2#RM
calcium_air_elutriator	kElSiyama_vAyu_XulAI_yaMwra#kElSiyama_vAyu_XulAI_yaMwra#noun#3#RM
calorimeter_for_hydration_test	jalayojana_kI_URNawA_parIkRaNa_ke_lie_kElorImItara#jalayojana_kI_URNawA_parIkRaNa_ke_lie_kElorImItara#noun#4#RM
canteen_hall	jalapAna_kakRa#jalapAna_kakRa#noun#2#RM
capillary_pore	keSikA_Cixra#keSikA_Cixra#noun#2#RM
capillary_rise	keSikIya/keSikA_uwWAna#keSikIya/keSikA_uwWAna#noun#2#RM
capillary_stresses	keSikIya_prawibala#keSikIya_prawibala#noun#2#RM
capillary_water	keSikA_jala#keSikA_jala#noun#2#RM
cash_crops	nakaxI_PasaleM#nakaxI_PasaleM#noun#2#RM
catchment_area	jalagrahaNa_kRewra#jalagrahaNa_kRewra#noun#2#RM
catestrophical_intesity_scale	pralaya_wIvrawA_skela#pralaya_wIvrawA_skela#noun#3#RM
cation_exchange_capacity	XanAyana_vinimaya_kRamawA#XanAyana_vinimaya_kRamawA#noun#3#RM
cementitious_compounds	sImeMta_vAle/saMyojI_miSra#sImeMta_vAle/saMyojI_miSra#noun#2#RM
central_hole	kenxrIya_Cexa#kenxrIya_Cexa#noun#2#RM
centrifugal_method	apakenxrI_viXi#apakenxrI_viXi#noun#2#RM
cereal_crops	XAnya_Sasya/anAja_kI_Pasala#XAnya_Sasya/anAja_kI_Pasala#noun#2#RM
channel_detention	vAhikA_avaroXa#vAhikA_avaroXa#noun#2#RM
channel_flow	vAhikA_pravAha#vAhikA_pravAha#noun#2#RM
channel_precipitation	vAhikA_avakRepaNa/varRaNa#vAhikA_avakRepaNa/varRaNa#noun#2#RM
channel_routing	vAhikA_mArgABigamana/aBigamana#vAhikA_mArgABigamana/aBigamana#noun#2#RM
check_dam	roXaka_bAMXa#roXaka_bAMXa#noun#2#RM
chemical_balance	rAsAyanika_wulA#rAsAyanika_wulA#noun#2#RM
chemical_method	rAsAyanika_viXi#rAsAyanika_viXi#noun#2#RM
cherty_clay	cartI_mqwwikA#cartI_mqwwikA#noun#2#RM
china_dish	cAyanA_diSa#cAyanA_diSa#noun#2#RM
chute-type_spill_ways	pravaNikA/SUta_aXiplava_mArga#pravaNikA/SUta_aXiplava_mArga#noun#3#RM
cleavage_strength	vixalana_sArmaWya#vixalana_sArmaWya#noun#2#RM
co-efficient_of_thermal_expansion	wApa_viswAra_prasAra_kA_guNAMka#wApa_viswAra_prasAra_kA_guNAMka#noun#4#RM
co-efficient_of_variation	viBinnawA_kA_guNaMAka#viBinnawA_kA_guNaMAka#noun#3#RM
coarse_aggregate	motI_rodZI#motI_rodZI#noun#2#RM
coarse_sediment	motA_walaCata#motA_walaCata#noun#2#RM
collection_of_data	dAtA/AMkadZA_saMgraha#dAtA/AMkadZA_saMgraha#noun#3#RM
command_area	kamAna_kRewra#kamAna_kRewra#noun#2#RM
compacted_back_fill	susaMhawa/saGana_punarBaraNa#susaMhawa/saGana_punarBaraNa#noun#3#RM
compacting_factor	saMhananaSIlawA/saGanawA_kAraka#saMhananaSIlawA/saGanawA_kAraka#noun#2#RM
compaction_apparatus	saMhanana_upakaraNa#saMhanana_upakaraNa#noun#2#RM
compaction_test	saMhanana_parIkRaNa#saMhanana_parIkRaNa#noun#2#RM
compressed_air	saMpIdiwa_vAyu#saMpIdiwa_vAyu#noun#2#RM
compressing_testing_machine	xabAva_parIkRaNa_maSIna#xabAva_parIkRaNa_maSIna#noun#3#RM
compression_testing_machine	saMpIdana_parIkRaNa_maSIna#saMpIdana_parIkRaNa_maSIna#noun#3#RM
compresso_meter	xAba_pramApaka#xAba_pramApaka#noun#2#RM
computer_centre_&_equipment	saMgaNaka_kenxra_evaM_upakaraNa#saMgaNaka_kenxra_evaM_upakaraNa#noun#4#RM
conchoidal_fraction	SaMKABa/vqwwa_KaNda_saMbaMXI_KaNda/Binna#SaMKABa/vqwwa_KaNda_saMbaMXI_KaNda/Binna#noun#2#RM
concrete_library-books	kaMkrIta_saMbaMXI_lAibrerI_kI_puswakeM#kaMkrIta_saMbaMXI_lAibrerI_kI_puswakeM#noun#2#RM
concrete_mixer	kaMkrIta_miSraka#kaMkrIta_miSraka#noun#2#RM
concrete_permeability_apparatus	kaMkrIta_pAragamyawA_upakaraNa#kaMkrIta_pAragamyawA_upakaraNa#noun#3#RM
condensed_phase	saMGaniwa_prAvasWA#saMGaniwa_prAvasWA#noun#2#RM
condensed_state	saMGaniwa_avasWA#saMGaniwa_avasWA#noun#2#RM
conductivity_bridge	cAlakawA_brija#cAlakawA_brija#noun#2#RM
conduits_type_spillways	kaMdyUta_tAipa_spilve#kaMdyUta_tAipa_spilve#noun#3#RM
cone_of_depression	avanamana_SaMku#avanamana_SaMku#noun#3#RM
confined_acquifer	parirUxXa/saMsImiwa_jalaxAyI#parirUxXa/saMsImiwa_jalaxAyI#noun#2#RM
conical_flask	SaMkvAkAra_sAMcA_petI/konikala_PalAska#SaMkvAkAra_sAMcA_petI/konikala_PalAska#noun#2#RM
conistency_limits	saGanawA_sImAeM#saGanawA_sImAeM#noun#2#RM
consistency_test	saGanawA_parIkRaNa#saGanawA_parIkRaNa#noun#2#RM
consolidometer/consolidation_apparatus	saMpiMdana_upakaraNa#saMpiMdana_upakaraNa#noun#2#RM
constant_temperature_bath	sWira_wApI_kuNda#sWira_wApI_kuNda#noun#3#RM
construction_planning_and_scheduling	nirmANa_AyojanA_waWA_kAryakrama_nirXAraNa#nirmANa_AyojanA_waWA_kAryakrama_nirXAraNa#noun#4#RM
construction_supervision_and_quality_control	nirmANa_paryavekRaNa_waWA_guNavawwA_niyaMwraNa#nirmANa_paryavekRaNa_waWA_guNavawwA_niyaMwraNa#noun#5#RM
consumable_stores	upaBogIya_BaNdAra#upaBogIya_BaNdAra#noun#2#RM
contour_map	samocca_reKI_mAnaciwra#samocca_reKI_mAnaciwra#noun#2#RM
conversion_factor	rUpAnwaraNa_guNaka/parivarwana_guNaka#rUpAnwaraNa_guNaka/parivarwana_guNaka#noun#2#RM
cooling_system	praSIwalana_praNAlI#praSIwalana_praNAlI#noun#2#RM
core_of_gyratory_crusher	cakkaraxAra_xaliwra/xalana_yaMwra_kA_AMwarika_BAga/kroda#cakkaraxAra_xaliwra/xalana_yaMwra_kA_AMwarika_BAga/kroda#noun#4#RM
correlation_co-efficient	sahasaMbaMXa_guNAMka#sahasaMbaMXa_guNAMka#noun#2#RM
cosolidation_unit	saMpiMdana_ekaka#saMpiMdana_ekaka#noun#2#RM
cost_benefit_assessment	lAgawa-lABa_mUlyAMkana#lAgawa-lABa_mUlyAMkana#noun#3#RM
cost_estimation	lAgawa_Akalana#lAgawa_Akalana#noun#2#RM
cross_section	anuprasWa_kAta#anuprasWa_kAta#noun#2#RM
crushing_strength	saMxalana_sArmaWya#saMxalana_sArmaWya#noun#2#RM
crushing_value	saMxalana_mAna#saMxalana_mAna#noun#2#RM
crystal_form	ravexAra/kristala_ke_AkAra_kI#ravexAra/kristala_ke_AkAra_kI#noun#2#RM
cube_moulds/modules	GanAkqwi_sAMce/mApaMAka#GanAkqwi_sAMce/mApaMAka#noun#2#RM
current_meter	XArA_vega_mApI#XArA_vega_mApI#noun#2#RM
cyclone_air_elutriator	cakravAwIya_vAyu_prakRAlana/Xone_kA_yaMwra#cakravAwIya_vAyu_prakRAlana/Xone_kA_yaMwra#noun#3#RM
dam_&_reservoir_engineering	bAMXa_evaM_jalASaya_iMjIniyarI/aBiyAMwrikI#bAMXa_evaM_jalASaya_iMjIniyarI/aBiyAMwrikI#noun#4#RM
dam_instrumentation	bAMXa_mApayaMwraNa#bAMXa_mApayaMwraNa#noun#2#RM
dam_safety	bAMXa_surakRA#bAMXa_surakRA#noun#2#RM
dam_site	bAMXa_sWala#bAMXa_sWala#noun#2#RM
dam_stability	bAMXa_sWirawA#bAMXa_sWirawA#noun#2#RM
dam_surveillance_&_construction_management	bAMXa_nigarAnI_waWA_nirmANa_prabaMXana#bAMXa_nigarAnI_waWA_nirmANa_prabaMXana#noun#5#RM
data_acquisition_system	dAtA/AMkadZA/jAnakArI/aBigrahaNa_praNAlI#dAtA/AMkadZA/jAnakArI/aBigrahaNa_praNAlI#noun#3#RM
data_base	AMkadZA_AXAra#AMkadZA_AXAra#noun#2#RM
data_collection	dAtA/jAnakArI/AMkadZe_saMgrahaNa#dAtA/jAnakArI/AMkadZe_saMgrahaNa#noun#2#RM
data_processing	AMkadZA_prakriyaNa/saMsAXana#AMkadZA_prakriyaNa/saMsAXana#noun#2#RM
dead_spot	mUka_sWala/avarUxXa_sWala#mUka_sWala/avarUxXa_sWala#noun#2#RM
dead_storage_capacity	acala_BaNdAra_kRamawA#acala_BaNdAra_kRamawA#noun#3#RM
dead_valley	SuRka_GAtI#SuRka_GAtI#noun#2#RM
dead_water	sWiraka_jala#sWiraka_jala#noun#2#RM
decalcium_silicate	dikElsiyama_siliketa#dikElsiyama_siliketa#noun#2#RM
decampier_balance	dekAmpiyara_wulA#dekAmpiyara_wulA#noun#2#RM
deep_percolation	gaharA_anwa:_sravaNa#gaharA_anwa:_sravaNa#noun#2#RM
deformation_modulus	virUpaNa/vikqwi_mApAMka#virUpaNa/vikqwi_mApAMka#noun#2#RM
deleterious_materials	kRawikara/hAnikara_sAmagriyAM#kRawikara/hAnikara_sAmagriyAM#noun#2#RM
density_currents	Ganawva_XArA#Ganawva_XArA#noun#2#RM
dependable_flow	viSvasanIya_pravAha#viSvasanIya_pravAha#noun#2#RM
depletion_curve	avakRaya_vakra#avakRaya_vakra#noun#2#RM
deposit_work	nikRepa_kArya#nikRepa_kArya#noun#2#RM
depth_area_relationship	gaharAI-kRewraPala_saMbaMXa#gaharAI-kRewraPala_saMbaMXa#noun#3#RM
depth_integrating_hand_sampler	gaharAI_samAkalana_haswacAliwa_prawixarSI_yaMwra#gaharAI_samAkalana_haswacAliwa_prawixarSI_yaMwra#noun#4#RM
depth_of_runoff	apavAha_gaharAI#apavAha_gaharAI#noun#3#RM
derric_with_pulley	GiranI_sahiwa_derika#GiranI_sahiwa_derika#noun#3#RM
design_capacity	aBikalpa_sArmaWya/dijAina_XAriwA#aBikalpa_sArmaWya/dijAina_XAriwA#noun#2#RM
design_flood	aBikalpa_bADZa#aBikalpa_bADZa#noun#2#RM
design_storm	aBikalpa_vqRti/varRA#aBikalpa_vqRti/varRA#noun#2#RM
dial_gauge	dAyala_geja#dAyala_geja#noun#2#RM
differential_thermal-analysis	viBexaka_wApa_viSleRaNa#viBexaka_wApa_viSleRaNa#noun#2#RM
diffusion_well	visaraNa_kUpa#visaraNa_kUpa#noun#2#RM
digital_conductivity_meter	aMkIya_cAlakawA_mItara#aMkIya_cAlakawA_mItara#noun#3#RM
digital_ph_meter	aMkIya_pIeca_mItara#aMkIya_pIeca_mItara#noun#3#RM
dilution_gauging	wanukaraNa_pramApana#wanukaraNa_pramApana#noun#2#RM
direct_run-off	prawyakRa_apavAha#prawyakRa_apavAha#noun#2#RM
direct_run-off_hydrograph	prawyakRa_apavAha_jalAleKa#prawyakRa_apavAha_jalAleKa#noun#3#RM
direct_shear_apparatus	prawyakRa_aparUpaNa_upakaraNa#prawyakRa_aparUpaNa_upakaraNa#noun#3#RM
direct_shear_test	prawyakRa_aparUpaNa_parIkRaNa#prawyakRa_aparUpaNa_parIkRaNa#noun#3#RM
disaster_management	vipaxA_prabaMXa#vipaxA_prabaMXa#noun#2#RM
disc_augar	vimba/maMdalaka/diska_oYgara#vimba/maMdalaka/diska_oYgara#noun#2#RM
discharge-frequency_curve	nissaraNa-Avqwwi_vakra#nissaraNa-Avqwwi_vakra#noun#2#RM
discharge_intensity	nissaraNa_wIvrawA#nissaraNa_wIvrawA#noun#2#RM
distillation_apparatus	ASvana_upakaraNa#ASvana_upakaraNa#noun#2#RM
distillation_plant	ASvana_saMyaMwra#ASvana_saMyaMwra#noun#2#RM
distilled_water	Asuwa_jala#Asuwa_jala#noun#2#RM
distribution_network	viwaraNa_waMwra#viwaraNa_waMwra#noun#2#RM
disturbed_sampling	vikRubXa_prawixarSa#vikRubXa_prawixarSa#noun#2#RM
diurnal_variation	xEnika_parivarwana#xEnika_parivarwana#noun#2#RM
diversion_structures	xikparivarwI_saMracanA#xikparivarwI_saMracanA#noun#2#RM
divisional_office	praBAgIya_kAryAlaya#praBAgIya_kAryAlaya#noun#2#RM
domestic_effluents	GarelU_nisrAva/bahisrAva#GarelU_nisrAva/bahisrAva#noun#2#RM
double_distillation_plant	xvikriyAwmaka_Asavana_saMyaMwra#xvikriyAwmaka_Asavana_saMyaMwra#noun#3#RM
double_jacket_cylinder	xvi_AvaraNa_siliMdara#xvi_AvaraNa_siliMdara#noun#3#RM
downstream_tank	anupravAha_kuMda#anupravAha_kuMda#noun#2#RM
drainage_&_flood_control	jala_nikAsI_evaM_bADZa_niyaMwraNa#jala_nikAsI_evaM_bADZa_niyaMwraNa#noun#4#RM
drainage_basin	AvAha_kRewra/apavAha_kRewra#AvAha_kRewra/apavAha_kRewra#noun#2#RM
drainage_density	jala_nikAsa/nikAsI_Ganawva#jala_nikAsa/nikAsI_Ganawva#noun#2#RM
drained_water	nikasiwa_jala#nikasiwa_jala#noun#2#RM
drawdown_curve	jalAvawalana_vakra#jalAvawalana_vakra#noun#2#RM
drilling_machine	driliMga_maSIna#driliMga_maSIna#noun#2#RM
drive_tube_boring	paricAlana_tyUba_Cexana#paricAlana_tyUba_Cexana#noun#3#RM
drought_index	sUKA_sUcakAMka#sUKA_sUcakAMka#noun#2#RM
dry-weather_flow	SuRka-mOsama_pravAha#SuRka-mOsama_pravAha#noun#2#RM
dry_density	SuRka_Ganawva#SuRka_Ganawva#noun#2#RM
dry_farming	SuRka_kqRi#SuRka_kqRi#noun#2#RM
dry_rock	SuRka_SilA#SuRka_SilA#noun#2#RM
dry_soil	SuRka_mqxA#SuRka_mqxA#noun#2#RM
dry_year	sUKA_varRa/SuRka_varRa#sUKA_varRa/SuRka_varRa#noun#2#RM
drying_samples	SuRkana_prawixarSa#SuRkana_prawixarSa#noun#2#RM
dumped_fill	PEMkA_huA_BaraNa#PEMkA_huA_BaraNa#noun#2#RM
duplicating_machine	duplIketiMga_maSIna#duplIketiMga_maSIna#noun#2#RM
durability_test	cirasWAyiwva_parIkRaNa#cirasWAyiwva_parIkRaNa#noun#2#RM
dynamic_material_tester	gawika_sAmagrI_parIkRaka#gawika_sAmagrI_parIkRaka#noun#3#RM
earth-cum-rockfill_dam	mittI_va_SilA_nirmiwa_bAMXa#mittI_va_SilA_nirmiwa_bAMXa#noun#2#RM
earth-cum-rockfill_storage_dam	mittI_va_SilA_nirmiwa_saMcAyaka_bAMXa#mittI_va_SilA_nirmiwa_saMcAyaka_bAMXa#noun#3#RM
earth_dam	mittI_kA_bAMXa/mqxA_bAMXa#mittI_kA_bAMXa/mqxA_bAMXa#noun#2#RM
echo-depth_recorder	prawiXvani-gaharAI_aBileKI#prawiXvani-gaharAI_aBileKI#noun#2#RM
echo_sounder_and_its_accessories	prawiXvaniwra_Ora_usakI_sahAyaka_sAmagrI#prawiXvaniwra_Ora_usakI_sahAyaka_sAmagrI#noun#5#RM
effective_or_net_water_cement_ratio	pAnI_Ora_sImeMta_kA_praBAvI_aWavA_vAswavika_anupAwa#pAnI_Ora_sImeMta_kA_praBAvI_aWavA_vAswavika_anupAwa#noun#6#RM
effective_rainfall	praBAvI_varRA#praBAvI_varRA#noun#2#RM
effluent_stream	bahisrAvI_sariwA/XArA#bahisrAvI_sariwA/XArA#noun#2#RM
elastic_modulus	prawyAsWa_mApAMka#prawyAsWa_mApAMka#noun#2#RM
elastic_mortar_mixer	ilAstika_mortAra_miksara#ilAstika_mortAra_miksara#noun#3#RM
electric_oven	vixyuwa_BatTI#vixyuwa_BatTI#noun#2#RM
electric_precision_balance	vixyuwa_cAliwa_pariSuxXawA_mApaka#vixyuwa_cAliwa_pariSuxXawA_mApaka#noun#3#RM
electrical_balance	vixyuwa_wulA#vixyuwa_wulA#noun#2#RM
electro_magnetic_motive_force	vixyuwa_cumbakIya_vAhaka_bala#vixyuwa_cumbakIya_vAhaka_bala#noun#4#RM
electro_mechanical_property	vixyuwa-yAMwrikI_guNaXarma#vixyuwa-yAMwrikI_guNaXarma#noun#3#RM
electron_beam	ilEkatroYna_bIma#ilEkatroYna_bIma#noun#2#RM
electron_microscope	ilEktroYna_sUkRmaxarSI#ilEktroYna_sUkRmaxarSI#noun#2#RM
elementary_unit	prAraMBika_ekaka#prAraMBika_ekaka#noun#2#RM
elements_of_crystal	kristala_wawva#kristala_wawva#noun#3#RM
elico_ph_meter	eliko_pIeca_mItara#eliko_pIeca_mItara#noun#3#RM
elongation_index	lambAI_sUcaka#lambAI_sUcaka#noun#2#RM
empirical_flood_formula	prayogASriwa_bADZa_sUwra/AnuBavika_bADZa_sUwra#prayogASriwa_bADZa_sUwra/AnuBavika_bADZa_sUwra#noun#3#RM
empirical_technique	prayogASriwa_wakanIka#prayogASriwa_wakanIka#noun#2#RM
energy_dispersion	UrjA_vikRepaNa#UrjA_vikRepaNa#noun#2#RM
energy_dissipation	UrjA_kRaya#UrjA_kRaya#noun#2#RM
energy_efficiency	UrjA_xakRawA#UrjA_xakRawA#noun#2#RM
engineering_properties	iMjIniyarI_viSeRawAeM/aBiyAMwrikI_guNaXarma#iMjIniyarI_viSeRawAeM/aBiyAMwrikI_guNaXarma#noun#2#RM
ephemeral_stream	alpakAlika_sariwA/XArA#alpakAlika_sariwA/XArA#noun#2#RM
equivalent_weight	samawulya_BAra#samawulya_BAra#noun#2#RM
establishment_section-i	sWApanA-I_anuBAga#sWApanA-I_anuBAga#noun#2#RM
evaporation_opportunity	vARpana_saMyoga#vARpana_saMyoga#noun#2#RM
experimental_farms_and_pilot_projects	prAyogika_PArma_waWA_AjamAiSI/prAyogika_pariyojanAeM#prAyogika_PArma_waWA_AjamAiSI/prAyogika_pariyojanAeM#noun#5#RM
exploratory_holes	anveRaka_Cixra#anveRaka_Cixra#noun#2#RM
extra_rapid_hardening_cement	wejI_se_saKwa_hone_vAlI/majabUwa_hone_vAlI_sImeMta#wejI_se_saKwa_hone_vAlI/majabUwa_hone_vAlI_sImeMta#noun#4#RM
extraction_of_water	jala_nissAraNa/jala_niRkarsana#jala_nissAraNa/jala_niRkarsana#noun#3#RM
extreme_rainfall	carama_varRA#carama_varRA#noun#2#RM
failure_of_embankment	watabaMXa_viPalawA#watabaMXa_viPalawA#noun#3#RM
false_set	kqwrima/nakalI_jamAva#kqwrima/nakalI_jamAva#noun#2#RM
fatigue_strength	WakAnakArI/SrAMwikArI/Sakwi/bala#WakAnakArI/SrAMwikArI/Sakwi/bala#noun#2#RM
feasibility_,_planning_&_project_formulation	vyavahAryawA/AyojanA_evaM_pariyojanA_nirUpaNa#vyavahAryawA/AyojanA_evaM_pariyojanA_nirUpaNa#noun#6#RM
feasibility_study	vyavahAryawA_aXyayana/sAXyawA_aXyayana#vyavahAryawA_aXyayana/sAXyawA_aXyayana#noun#2#RM
ferro_printing_machine	PEro_muxraNa_maSIna#PEro_muxraNa_maSIna#noun#3#RM
field_capacity	kRewra_jalaXAraNa_kRamawA/mqxA_jala_XAriwA#kRewra_jalaXAraNa_kRamawA/mqxA_jala_XAriwA#noun#2#RM
field_classification	kRewra_vargIkaraNa#kRewra_vargIkaraNa#noun#2#RM
field_efficiency	kRewra/kRewrIya_xakRawA#kRewra/kRewrIya_xakRawA#noun#2#RM
field_equipments	kRewra_upaskara#kRewra_upaskara#noun#2#RM
field_investigation	kRewragawa_anveRaNa#kRewragawa_anveRaNa#noun#2#RM
field_laboratory	kArya_sWala_prayogaSAlA/PIlda_prayeAgaSAlA#kArya_sWala_prayogaSAlA/PIlda_prayeAgaSAlA#noun#2#RM
field_measurements	kRewra_mApa#kRewra_mApa#noun#2#RM
field_method	kRewra_paxXawi#kRewra_paxXawi#noun#2#RM
field_penetration_test	kRewra_veXana_parIkRaNa#kRewra_veXana_parIkRaNa#noun#3#RM
field_reconnaissance	kRewrIya_AvIkRaNa#kRewrIya_AvIkRaNa#noun#2#RM
field_testing	PIlda_parIkRaNa#PIlda_parIkRaNa#noun#2#RM
field_vane_test	PIlda_vena_parIkRaNa#PIlda_vena_parIkRaNa#noun#3#RM
files_and_records	PAileM_Ora_aBileKa#PAileM_Ora_aBileKa#noun#3#RM
filtering_apparatus	CanAI_upakaraNa/upaskara#CanAI_upakaraNa/upaskara#noun#2#RM
final_set	anwima_jamAva#anwima_jamAva#noun#2#RM
finalisation_of_report	riporta_ko_anwima_rUpa_xiyA_jAnA#riporta_ko_anwima_rUpa_xiyA_jAnA#noun#3#RM
fine_aggregate	mahIna_rodZI#mahIna_rodZI#noun#2#RM
fine_dust	mahIna_XUla#mahIna_XUla#noun#2#RM
fine_mesh	mahIna_jAlI#mahIna_jAlI#noun#2#RM
fine_sediment	mahIna_walaCata#mahIna_walaCata#noun#2#RM
fine_silt	mahIna_gAxa#mahIna_gAxa#noun#2#RM
fineness_modulus	sUkRmawA_mApAMka#sUkRmawA_mApAMka#noun#2#RM
flakiness_index	capatApana_sUcakAMka#capatApana_sUcakAMka#noun#2#RM
flaky_grains	capate_xAne#capate_xAne#noun#2#RM
flame_photometer	jvAlA_prakASamApI#jvAlA_prakASamApI#noun#2#RM
flash_flood	Akasmika_bADZa#Akasmika_bADZa#noun#2#RM
flash_set	wuranwa_jamAva#wuranwa_jamAva#noun#2#RM
flat_jack_test	PlEta_jEka_parIkRaNa/capatA_jEka_parIkRaNa#PlEta_jEka_parIkRaNa/capatA_jEka_parIkRaNa#noun#3#RM
flexural_bond_stress	AnamanI_baMXana_xabAva#AnamanI_baMXana_xabAva#noun#3#RM
flexural_strength	AnamanI_sArmaWya#AnamanI_sArmaWya#noun#2#RM
flood_abatement	bADZa_apacayana#bADZa_apacayana#noun#2#RM
flood_absorption	bADZa_avaSoRaNa/bADZa_anuSIlana#bADZa_avaSoRaNa/bADZa_anuSIlana#noun#2#RM
flood_discharge	bADZa_nissaraNa#bADZa_nissaraNa#noun#2#RM
flood_forecasting	bADZa_pUrvAnumAna#bADZa_pUrvAnumAna#noun#2#RM
flood_routing	bADZa_anuSIlana/bADZa_mArga#bADZa_anuSIlana/bADZa_mArga#noun#2#RM
flow_meter_with_accessories	anuRaMgI_sAmagrI_sahiwa_pravAha_pramApaka#anuRaMgI_sAmagrI_sahiwa_pravAha_pramApaka#noun#4#RM
flow_rest	pravAha_prawiroXa#pravAha_prawiroXa#noun#2#RM
flow_table	pravAha_pITikA#pravAha_pITikA#noun#2#RM
fluvial_soils	naxIya_mqxA#naxIya_mqxA#noun#2#RM
foundation_treatment	nIMva_upacAra#nIMva_upacAra#noun#2#RM
foundations_for_structures	saMracanAoM_ke_lie_nIMva#saMracanAoM_ke_lie_nIMva#noun#3#RM
free_stream_velocity	mukwa_XArA_vega#mukwa_XArA_vega#noun#3#RM
free_suface_energy	mukwa_pqRTa_UrjA#mukwa_pqRTa_UrjA#noun#3#RM
frequency_distribution	Avqwwi/bAraMbArawA_viwaraNa#Avqwwi/bAraMbArawA_viwaraNa#noun#2#RM
fresh_water	svacCa_jala/alavaNa_jala#svacCa_jala/alavaNa_jala#noun#2#RM
full_reservoir_level	pUrNa_jalASaya_swara#pUrNa_jalASaya_swara#noun#3#RM
galena_(_pbo_)	sAXAraNa_kaccA_sIsA/rAMgA_(pIbIo)#sAXAraNa_kaccA_sIsA/rAMgA_(pIbIo)#noun#3#RM
gap-graded_aggregate	gEpa_grededa_rodZI#gEpa_grededa_rodZI#noun#2#RM
gas_burner	gEsa_barnara#gEsa_barnara#noun#2#RM
gas_cylinder_with_burner	barnara_sahiwa_gEsa_siliMdara#barnara_sahiwa_gEsa_siliMdara#noun#4#RM
gauge_pin	geja_pina/pramApI_pina#geja_pina/pramApI_pina#noun#2#RM
gauge_tester	geja_parIkRaka#geja_parIkRaka#noun#2#RM
gauging_site	mApana_sWala#mApana_sWala#noun#2#RM
gaussian_or_normal_distribution	gAusIya_yA_sAmAnya_viwaraNa#gAusIya_yA_sAmAnya_viwaraNa#noun#4#RM
gel_pores	jela_raMXra#jela_raMXra#noun#2#RM
gelatinous_precipitate	jiletinI/SleRI_avakRepa#jiletinI/SleRI_avakRepa#noun#2#RM
generating_capacity	uwpAxana_kRamawA#uwpAxana_kRamawA#noun#2#RM
generation_and_transmission	uwpAxana_waWA_prasAraNa#uwpAxana_waWA_prasAraNa#noun#3#RM
geo-technical_assessment/surveys	BU-wakanIkI_nirXAraNa/sarvekRaNa#BU-wakanIkI_nirXAraNa/sarvekRaNa#noun#2#RM
geologic_map	BU-_vEjFAnika_mAnaciwra#BU-_vEjFAnika_mAnaciwra#noun#2#RM
geological_appraisal	BU-vEjFAnika_mUlyAMkana#BU-vEjFAnika_mUlyAMkana#noun#2#RM
geological_classification_of_rock	SEla_kA_BU-vEjFAnika_vargIkaraNa#SEla_kA_BU-vEjFAnika_vargIkaraNa#noun#4#RM
geological_investigation_of_land_slide	BU-sKalana_kA_BU-vEjFAnika_anveRaNa#BU-sKalana_kA_BU-vEjFAnika_anveRaNa#noun#5#RM
geophysical_investigation	BU-BOwikIya_anveRaNa#BU-BOwikIya_anveRaNa#noun#2#RM
glacial_deposit	himanaxIya_nikRepa#himanaxIya_nikRepa#noun#2#RM
glass_rod	kAMca_kI_CadZa#kAMca_kI_CadZa#noun#2#RM
global_portioning_system	BOgolika_anuBAjana_vyavasWA#BOgolika_anuBAjana_vyavasWA#noun#3#RM
good_man_jack	gudamEna_jEka#gudamEna_jEka#noun#3#RM
grading_modulus	SreNI_mApAMka#SreNI_mApAMka#noun#2#RM
grain_size_distribution	kaNAkAra_viwaraNa#kaNAkAra_viwaraNa#noun#3#RM
gravity_dam	BArASriwa/gurUwva_bAMXa#BArASriwa/gurUwva_bAMXa#noun#2#RM
gross_apparent_specific_gravity	sakala_xqSya_viSiRta_gurUwva#sakala_xqSya_viSiRta_gurUwva#noun#4#RM
ground_and_surface_water	BU-jala_waWA_sawahI_jala#BU-jala_waWA_sawahI_jala#noun#4#RM
ground_water_exploration	BU-jala_Koja#BU-jala_Koja#noun#3#RM
ground_water_flow	BU-jala_pravAha#BU-jala_pravAha#noun#3#RM
ground_water_outflow	BU-jala_bahirpravAha#BU-jala_bahirpravAha#noun#3#RM
ground_water_recession	BU-jala/BOma_jala_apagamana#BU-jala/BOma_jala_apagamana#noun#3#RM
ground_water_recharge_scheme	BU-jala_puna:_pUrwi/punarBaraNa_yojanA#BU-jala_puna:_pUrwi/punarBaraNa_yojanA#noun#4#RM
hair_cracks	sUkRma_xarAra#sUkRma_xarAra#noun#2#RM
hammer_mill_or_impact_breaker	hEmara_mila_yA_AGAwa_BaMjaka#hEmara_mila_yA_AGAwa_BaMjaka#noun#5#RM
hand_auger	haswa_Agara#haswa_Agara#noun#2#RM
hand_compressor	haswacAliwa_saMpIdaka#haswacAliwa_saMpIdaka#noun#2#RM
hand_operated_extractor	haswacAliwa_nicodZaka#haswacAliwa_nicodZaka#noun#3#RM
hardness_number	kaTorawA_saMKyA#kaTorawA_saMKyA#noun#2#RM
hardness_of_water	jala_kI_kaTorawA#jala_kI_kaTorawA#noun#3#RM
head_water	jala_SIrRa/uxgama_jala#jala_SIrRa/uxgama_jala#noun#2#RM
headrace_tunnel	aBiXAra/hEdaresa_suraMga#aBiXAra/hEdaresa_suraMga#noun#2#RM
healing_of_concrete	kaMkrIta_saMsAXana#kaMkrIta_saMsAXana#noun#3#RM
heavy_duty_oven	aXika_URmA_BattI#aXika_URmA_BattI#noun#3#RM
helical_augers	sarpila_Agara#sarpila_Agara#noun#2#RM
hemi_hydrate	arXa_hAidreta/hemihAidreta#arXa_hAidreta/hemihAidreta#noun#2#RM
high_alumina_cement	ucca_elyuminA_sImeMta#ucca_elyuminA_sImeMta#noun#3#RM
high_speed_racord	ucca/aXika_gawi_rekArda#ucca/aXika_gawi_rekArda#noun#3#RM
high_speed_vibrating_machine	xruwa_kampanakArI_maSIna#xruwa_kampanakArI_maSIna#noun#4#RM
high_temperature_oven	ucca_wApa_vAlI_BattI#ucca_wApa_vAlI_BattI#noun#3#RM
hollow_gravity_dam	KoKalA_BArASriwa/gurUwva_bAMXa#KoKalA_BArASriwa/gurUwva_bAMXa#noun#3#RM
honey_combed	KoKalA#KoKalA#noun#2#RM
hookean_element	huka_ke_sixXAMwa_ko_mAnane_vAle_wawva/huka_kA_wawva#huka_ke_sixXAMwa_ko_mAnane_vAle_wawva/huka_kA_wawva#noun#2#RM
hydrated_colloidal_alumina	jala_miSriwa_kolAyadala_elyuminA#jala_miSriwa_kolAyadala_elyuminA#noun#3#RM
hydraulic_cement	jalIya_sImeMta#jalIya_sImeMta#noun#2#RM
hydraulic_compressor	xravIya_saMpIdaka#xravIya_saMpIdaka#noun#2#RM
hydraulic_conductivity	jalIya/xravIya_cAlakawA#jalIya/xravIya_cAlakawA#noun#2#RM
hydraulic_data	jalIya_AMkadZe#jalIya_AMkadZe#noun#2#RM
hydraulic_fill	xravacAliwa_BarAI#xravacAliwa_BarAI#noun#2#RM
hydraulic_gradient	jalIya_pravaNawA#jalIya_pravaNawA#noun#2#RM
hydraulic_jack	hAidrolika_jEka/xravIya_uwWApaka#hAidrolika_jEka/xravIya_uwWApaka#noun#2#RM
hydraulic_pressure	xravIya_xAba#xravIya_xAba#noun#2#RM
hydraulic_properties	xravIya_guNaXarma/jalIya_guNaXarma#xravIya_guNaXarma/jalIya_guNaXarma#noun#2#RM
hydraulic_pump	xravacAliwa_paMpa#xravacAliwa_paMpa#noun#2#RM
hydrographic_failure	jala_vijFAnIya/jalIya_viPalawA#jala_vijFAnIya/jalIya_viPalawA#noun#2#RM
hydrographic_mapping	jalamApa_mAnaciwraNa#jalamApa_mAnaciwraNa#noun#2#RM
hydrographic_surveys_of_rivers_,_lakes_and_coastlines	naxiyoM/JIloM_va_wata_reKAoM_ke_jalamApa_ciwraNa_saMbaMXI_sarvekRaNa#naxiyoM/JIloM_va_wata_reKAoM_ke_jalamApa_ciwraNa_saMbaMXI_sarvekRaNa#noun#8#RM
hydrological_observation	jala_vijFAnIya_prekRaNa#jala_vijFAnIya_prekRaNa#noun#2#RM
igneous_rock	Agneya_SEla#Agneya_SEla#noun#2#RM
impact_assessment	praBAva_Akalana#praBAva_Akalana#noun#2#RM
impact_evaluation	praBAva_mUlyAMkana#praBAva_mUlyAMkana#noun#2#RM
impact_test	saMGatta_parIkRaNa#saMGatta_parIkRaNa#noun#2#RM
impervious_core	apraveSya_kroda_kA_BIwarI_BAga_jisakA_Bexana_nahIM_kiyA_jA_sake#apraveSya_kroda_kA_BIwarI_BAga_jisakA_Bexana_nahIM_kiyA_jA_sake#noun#2#RM
importance_of_control	niyaMwraNa_kA_mahawva#niyaMwraNa_kA_mahawva#noun#3#RM
in_flow	aMwarvAha#aMwarvAha#noun#2#RM
in_situ	avasWiwi/yaWAsWAna/svasWAne#avasWiwi/yaWAsWAna/svasWAne#noun#2#RM
inclino_meter_with_accessories	anuRaMgiyoM_sahiwa_cumbaka_kA_JukAva_mApaka_yaMwra#anuRaMgiyoM_sahiwa_cumbaka_kA_JukAva_mApaka_yaMwra#noun#4#RM
index_properties	sUcakAMka_guNaXarma#sUcakAMka_guNaXarma#noun#2#RM
individual_files	vyakwigawa_PAileM#vyakwigawa_PAileM#noun#2#RM
induced_recharge	preriwa_puna:_pUraNa/puna:_pUrwi#preriwa_puna:_pUraNa/puna:_pUrwi#noun#2#RM
industrial_effluents	Oxyogika_nisrAva/bahisrAva#Oxyogika_nisrAva/bahisrAva#noun#2#RM
industrial_waste_treatment	Oxyogika_apaSiRta_upacAra#Oxyogika_apaSiRta_upacAra#noun#3#RM
infiltration_capacity	aMwa:_spaxaMna_kRamawA#aMwa:_spaxaMna_kRamawA#noun#2#RM
infra_red_measurement	mApa/nApa_rakwimawA_avarakwa#mApa/nApa_rakwimawA_avarakwa#noun#3#RM
infrastructural_facilities	avasWApanAwmaka/buniyAxI_suviXAeM#avasWApanAwmaka/buniyAxI_suviXAeM#noun#2#RM
inland_water-ways_and_navigation	anwarxeSIya_jalamArga_waWA_nOcAlana#anwarxeSIya_jalamArga_waWA_nOcAlana#noun#4#RM
insoluble_residue	avileya_avaSeRa#avileya_avaSeRa#noun#2#RM
inspection_and_quality_surveillance	nirIkRaNa_waWA_guNavawwA_nigarAnI#nirIkRaNa_waWA_guNavawwA_nigarAnI#noun#4#RM
installed_capacity	saMsWApiwa_kRamawA#saMsWApiwa_kRamawA#noun#2#RM
instantaneous_sampler_(_uppal_)	wAwkAlika_prawixarSI_yaMwra_(uppala)#wAwkAlika_prawixarSI_yaMwra_(uppala)#noun#4#RM
instrument_installations	yaMwra_saMsWApana#yaMwra_saMsWApana#noun#2#RM
inter_particle_friction	AMwarika_kaNa_GarRaNa#AMwarika_kaNa_GarRaNa#noun#3#RM
internal_diameter	AMwarika_vyAsa#AMwarika_vyAsa#noun#2#RM
interstitial_voids	anwarAlIya_rikwi#anwarAlIya_rikwi#noun#2#RM
intrinsic_property	nija-guNa-Xarma#nija-guNa-Xarma#noun#2#RM
investigated_area	anveRiwa_kRewra#anveRiwa_kRewra#noun#2#RM
irregular_blocks_of_soil	asaMyamiwa/aniyamiwa_mqxA_blAka#asaMyamiwa/aniyamiwa_mqxA_blAka#noun#4#RM
irrigation_,_conveyance_and_distribution_system	siMcAI/vAhana_waWA_viwaraNa_praNAlI#siMcAI/vAhana_waWA_viwaraNa_praNAlI#noun#6#RM
irrigation_command_area	siMcAI_yogya_kamAna_kRewra#siMcAI_yogya_kamAna_kRewra#noun#3#RM
irrigation_efficiency	siMcAI_xakRawA#siMcAI_xakRawA#noun#2#RM
irrigation_potential	siMcAI_saMBAvyawA#siMcAI_saMBAvyawA#noun#2#RM
irrigation_requirement	siMcAI_mAMga#siMcAI_mAMga#noun#2#RM
jaw_crusher	joY_kraSara#joY_kraSara#noun#2#RM
job_analysis	kqwyaka_viSleRaNa#kqwyaka_viSleRaNa#noun#2#RM
job_card	kqwyaka-pawraka#kqwyaka-pawraka#noun#2#RM
job_classification	kqwyaka_vargIkaraNa#kqwyaka_vargIkaraNa#noun#2#RM
job_comparability	kqwyaka_wulanIyawA#kqwyaka_wulanIyawA#noun#2#RM
job_design	kqwyaka_aBikalpa#kqwyaka_aBikalpa#noun#2#RM
job_specification	kqwyaka_vinirxeSa#kqwyaka_vinirxeSa#noun#2#RM
joint_spacing	jodZa-anwara#jodZa-anwara#noun#2#RM
jolting_apparatus	hicakolA_upaskara#hicakolA_upaskara#noun#2#RM
karstic_river	kArsta_naxI#kArsta_naxI#noun#2#RM
key_diagram	muKya_AreKa#muKya_AreKa#noun#2#RM
key_job	muKya_kqwyaka#muKya_kqwyaka#noun#2#RM
key_trench	risana_roka_KAI/muKya_KAI#risana_roka_KAI/muKya_KAI#noun#2#RM
kinetic_energy	gawika_UrjA#gawika_UrjA#noun#2#RM
kitchen_&_sales_counter	rasoI_Ora_vikraya_kAuMtara#rasoI_Ora_vikraya_kAuMtara#noun#4#RM
laboratory_classification	prayogaSAlA_vargIekaraNa#prayogaSAlA_vargIekaraNa#noun#2#RM
laboratory_stores	prayogaSAlA_BaNdAra#prayogaSAlA_BaNdAra#noun#2#RM
laboratory_testing	prayogaSAlA_parIkRaNa#prayogaSAlA_parIkRaNa#noun#2#RM
laboratory_vane	prayogaSAlA_Palaka#prayogaSAlA_Palaka#noun#2#RM
lake_evaporation	JIla_vARpana#JIla_vARpana#noun#2#RM
land_capability_classification	BUmi_kRamawA_vargIkaraNa#BUmi_kRamawA_vargIkaraNa#noun#3#RM
land_preparation_,_levelling_etc	BUmi_wEyAra_karanA/samawala_karanA_Axi#BUmi_wEyAra_karanA/samawala_karanA_Axi#noun#5#RM
land_reclamation	BUmi_uxXAra#BUmi_uxXAra#noun#2#RM
land_slides_and_erosion	BU-sKalana_va_katAva#BU-sKalana_va_katAva#noun#4#RM
land_use_pattern	BUmi_upayoga_praNAlI#BUmi_upayoga_praNAlI#noun#3#RM
lateral_inflow	pArSvAki_aMwarvAha#pArSvAki_aMwarvAha#noun#2#RM
lateral_pressure_assembly	pArSvika_xabAva_esembalI#pArSvika_xabAva_esembalI#noun#3#RM
lathe_machine_(_big_)	KarAxa_maSIna_(badZI)#KarAxa_maSIna_(badZI)#noun#4#RM
lattice_water	jAlaka-jala#jAlaka-jala#noun#2#RM
leaching_requirement	nikRAlana_mAMga#nikRAlana_mAMga#noun#2#RM
leak_detection_and_reduction	risAva_saMsUcana_va_nyUnIkaraNa#risAva_saMsUcana_va_nyUnIkaraNa#noun#4#RM
leak_detection_study	risAva_saMsUcana_aXyayana#risAva_saMsUcana_aXyayana#noun#3#RM
lean_clay	kamajora_cikanI_mittI/lIna_kle#kamajora_cikanI_mittI/lIna_kle#noun#2#RM
lime_pozzolane_grinder	cUnA/jvAlAmuKI_rAKa_pisAI_maSIna#cUnA/jvAlAmuKI_rAKa_pisAI_maSIna#noun#3#RM
lime_stone	cUnA_pawWara#cUnA_pawWara#noun#2#RM
line_structures	reKA_saMracanAeM#reKA_saMracanAeM#noun#2#RM
liquid_limit	xrava_sImA#xrava_sImA#noun#2#RM
liquid_limit_apparatus	xrava_sImA_upakaraNa#xrava_sImA_upakaraNa#noun#3#RM
liquid_phase	warala_prAvasWA#warala_prAvasWA#noun#2#RM
live_storage_capacity	upayogI/sakriya_BaMdAraNa_kRamawA#upayogI/sakriya_BaMdAraNa_kRamawA#noun#3#RM
load_frame	BAra_Prema#BAra_Prema#noun#2#RM
logarithmical_average	laGu_gaNakIya_Osawa#laGu_gaNakIya_Osawa#noun#2#RM
loose_bulk_density	asaMyukwa_sWUla_Ganawva#asaMyukwa_sWUla_Ganawva#noun#3#RM
magnesium_oxide	mEgnesiyama_AksAIda#mEgnesiyama_AksAIda#noun#2#RM
main_dam	pramuKa_bAMXa#pramuKa_bAMXa#noun#2#RM
manganese_oxide	mEganIja_oYksAida#mEganIja_oYksAida#noun#2#RM
maturity_of_concrete	kaMkrIta_kI_paripakvawA/avaXi_pUrI_honA#kaMkrIta_kI_paripakvawA/avaXi_pUrI_honA#noun#3#RM
maximum_intensity_of_flood	aXikawama_bADZa_wIvrawA#aXikawama_bADZa_wIvrawA#noun#4#RM
mean_annual_evaporation	Osawa_vArRika_vARpana#Osawa_vArRika_vARpana#noun#3#RM
mean_annual_flood	Osawa_vArRika_bADZa#Osawa_vArRika_bADZa#noun#3#RM
mean_annual_precipitation	Osawa_vArRika_avakRepaNa/varRaNa#Osawa_vArRika_avakRepaNa/varRaNa#noun#3#RM
mean_intensity_of_the_suspended_sediment	nilaMbiwa_walaCata_kI_mAXya_wIvrawA#nilaMbiwa_walaCata_kI_mAXya_wIvrawA#noun#6#RM
mean_monthly_runoff	Osawa_mAsika_apavAha#Osawa_mAsika_apavAha#noun#3#RM
measuring_cylinder	mApana_siliNdara#mApana_siliNdara#noun#2#RM
measuring_section	mApana_KaNda#mApana_KaNda#noun#2#RM
mechanical_analysis_apparatus	yAMwrika_viSleRaNa_upakaraNa#yAMwrika_viSleRaNa_upakaraNa#noun#3#RM
mechanical_analysis_test	yAMwrika_viSleRaNa_parIkRaNa#yAMwrika_viSleRaNa_parIkRaNa#noun#3#RM
medium_sediment	mAXyama_walaCata#mAXyama_walaCata#noun#2#RM
metamorphic_rock	kAyAMwariwa_SEla/SilA#kAyAMwariwa_SEla/SilA#noun#2#RM
mettler_balance	mEtalara_wulA#mEtalara_wulA#noun#2#RM
micro_wave	sUkRma_waraMga#sUkRma_waraMga#noun#2#RM
miscellaneous_methods	viviXa_paxyawiyAM#viviXa_paxyawiyAM#noun#2#RM
mixed_filling	miSriwa_BarAI#miSriwa_BarAI#noun#2#RM
modifications_in_designs	aBikalpoM_meM_ASoXana#aBikalpoM_meM_ASoXana#noun#3#RM
modified_bottle_sampler	saMSoXiwa_bowala_sEmpalara#saMSoXiwa_bowala_sEmpalara#noun#3#RM
modulus_of_deformation	virUpaNa-_mApAMka#virUpaNa-_mApAMka#noun#3#RM
moisture_adjustment_factor	ArxrawA_samAyojana_kAraka/guNaka#ArxrawA_samAyojana_kAraka/guNaka#noun#3#RM
moisture_content	namI/ArxrawA_aMSa#namI/ArxrawA_aMSa#noun#2#RM
moisture_meter	ArxrawA/namI_mApI#ArxrawA/namI_mApI#noun#2#RM
molecular_weight	aNu_BAra#aNu_BAra#noun#2#RM
mono_molecularly	Ekika_aNuka#Ekika_aNuka#noun#2#RM
mou_(_memorandum_of_understanding_)	samaJOwA_jFApana#samaJOwA_jFApana#noun#5#RM
muffle_furnace	Avqwa/banxa_BatTI#Avqwa/banxa_BatTI#noun#2#RM
multipurpose_project	bahuuxxeSIya_pariyojanA#bahuuxxeSIya_pariyojanA#noun#2#RM
multipurpose_reservoir	bahuuxxeSIya_jalASaya#bahuuxxeSIya_jalASaya#noun#2#RM
multipurpose_river_valley_projects	bahuuxxeSIya_naxI_GAtI_pariyojanAeM#bahuuxxeSIya_naxI_GAtI_pariyojanAeM#noun#4#RM
natural_control	prAkqwika_niyaMwraNa#prAkqwika_niyaMwraNa#noun#2#RM
natural_foundation	prAkqwika_nIMva/prAkqwa_nIMva#prAkqwika_nIMva/prAkqwa_nIMva#noun#2#RM
natural_harbour	prAkqwika_banxaragAha#prAkqwika_banxaragAha#noun#2#RM
natural_phenomenons	prAkqwika_prawiBAsa#prAkqwika_prawiBAsa#noun#2#RM
needle_vibrators	nIdala_vAibretara#nIdala_vAibretara#noun#2#RM
network_design	kAryakRewra_aBikalpa#kAryakRewra_aBikalpa#noun#2#RM
non-uniform_flow	asama_pravAha#asama_pravAha#noun#2#RM
normal_current	sAmAnya_XArA#sAmAnya_XArA#noun#2#RM
normal_probability_curve	sAmAnya_saMBAvyawA_vakra#sAmAnya_saMBAvyawA_vakra#noun#3#RM
normal_rainfall	sAmAnya_varRA#sAmAnya_varRA#noun#2#RM
nuclear_resonance_method	ANavika_anukampana_praNAlI#ANavika_anukampana_praNAlI#noun#3#RM
number_of_cycles	Avarwana/cakra_saMKyA#Avarwana/cakra_saMKyA#noun#3#RM
numerical_analysis	saMKyAwmaka_viSleRaNa#saMKyAwmaka_viSleRaNa#noun#2#RM
numerically_controlled_process	saMKyAwa:_niyaMwriwa_prakrama#saMKyAwa:_niyaMwriwa_prakrama#noun#3#RM
octahedral_stresses	aRtaPalakIya_balAGAwa#aRtaPalakIya_balAGAwa#noun#2#RM
office_files	kAryAlaya_PAileM#kAryAlaya_PAileM#noun#2#RM
one_dimensional	eka_vimIya#eka_vimIya#noun#2#RM
operating_cost	pracAlana_lAgawa#pracAlana_lAgawa#noun#2#RM
operation_and_maintenance	pracAlana_waWA_anurakRaNa/raKaraKAva#pracAlana_waWA_anurakRaNa/raKaraKAva#noun#3#RM
operational_analysis	pracAlanagawa_viSleRaNa#pracAlanagawa_viSleRaNa#noun#2#RM
operational_planning	pracAlanagawa_AyojanA#pracAlanagawa_AyojanA#noun#2#RM
operational_scheduling	pracAlanagawa_anusUcana#pracAlanagawa_anusUcana#noun#2#RM
operational_studies	pracAlanagawa_aXyayana#pracAlanagawa_aXyayana#noun#2#RM
operational_test	saMkriyAwmaka/pracAlanagawa_parIkRaNa#saMkriyAwmaka/pracAlanagawa_parIkRaNa#noun#2#RM
optimal_design	iRtawama_aBikalpa#iRtawama_aBikalpa#noun#2#RM
optimal_planning	iRtawama_AyojanA#iRtawama_AyojanA#noun#2#RM
optimal_strategies	iRtawama_kAryanIwiyAM#iRtawama_kAryanIwiyAM#noun#2#RM
optimal_yield	iRtawama_labXi/uwpAxa#iRtawama_labXi/uwpAxa#noun#2#RM
optimum_utilisation	anukUlawama_upayoga#anukUlawama_upayoga#noun#2#RM
organic_matter	kArbanika_paxArWa#kArbanika_paxArWa#noun#2#RM
ornamental_concrete	alaMkqwa_kaMkrIta#alaMkqwa_kaMkrIta#noun#2#RM
oscillo_scope	oYsilo_skopa/xolana_xarSI#oYsilo_skopa/xolana_xarSI#noun#2#RM
out_flow	bahirvAha/bahirpravAha#bahirvAha/bahirpravAha#noun#2#RM
out_flow_rate	bahirpavAha_xara#bahirpavAha_xara#noun#3#RM
over_bank_flow	upariwata_pravAha#upariwata_pravAha#noun#3#RM
over_flow_dam	uwplAvI_bAMXa#uwplAvI_bAMXa#noun#3#RM
oxide_composition	oYksAida_racanA#oYksAida_racanA#noun#2#RM
oxygen_gas_cyclinder	oYksIjana_gEsa_siliMdara#oYksIjana_gEsa_siliMdara#noun#3#RM
pan_balance	katorIxAra_warAjU#katorIxAra_warAjU#noun#2#RM
pan_mixer	pEna/kaDZAhInumA_miSraka#pEna/kaDZAhInumA_miSraka#noun#2#RM
particle_size_and_shape	kaNawA_mApa_va_AkAra#kaNawA_mApa_va_AkAra#noun#4#RM
parts_per_million	BAga_prawi_xasa_lAKa#BAga_prawi_xasa_lAKa#noun#3#RM
patrographic_examination	SEla_vargika_nirIkRaNa#SEla_vargika_nirIkRaNa#noun#2#RM
pbx_telephone_exchange	pI.bI.eksa_telIPona_eksaceMja/xUraBARa_kenxra#pI.bI.eksa_telIPona_eksaceMja/xUraBARa_kenxra#noun#3#RM
peak_discharge	carama_nissaraNa#carama_nissaraNa#noun#2#RM
penetration_resistance_curve	beXana_prawiroXI_vakra#beXana_prawiroXI_vakra#noun#3#RM
perched_water_table	xu:sWiwa_BOmajala_swara#xu:sWiwa_BOmajala_swara#noun#3#RM
percolation_losses	anwa:_sravaNa_hAni#anwa:_sravaNa_hAni#noun#2#RM
permissible_variation	anumawa_aMwara#anumawa_aMwara#noun#2#RM
persistent_rainfall	niraMwara_varRA#niraMwara_varRA#noun#2#RM
pervious_fill	pAragamya_BaraNa#pAragamya_BaraNa#noun#2#RM
pervious_materials	pAragamya_sAmagrI#pAragamya_sAmagrI#noun#2#RM
pestle_and_mortar	mUsala_Ora_Karala#mUsala_Ora_Karala#noun#3#RM
petrographic_analysis	SEla_vargika_viSleRaNa#SEla_vargika_viSleRaNa#noun#2#RM
phase_equilibrium	prAvasWA_sanwulana#prAvasWA_sanwulana#noun#2#RM
photo_micrographic_examination_porosity	Poto_sUkRmAkRarIya_parIkRaNa_saMraMXrawA#Poto_sUkRmAkRarIya_parIkRaNa_saMraMXrawA#noun#4#RM
photostat_machine	Poto_steta_maSIna#Poto_steta_maSIna#noun#2#RM
physical_properties	BOwika_guNaXarma#BOwika_guNaXarma#noun#2#RM
pilot_project	AraMBika/paWapraxarSaka_pariyojanA#AraMBika/paWapraxarSaka_pariyojanA#noun#2#RM
pipe_lines	pAipa_lAina#pAipa_lAina#noun#2#RM
pivot_method	muKya_paxyawi#muKya_paxyawi#noun#2#RM
plant_mixing_meter	miSraNa_saMyaMwra_pramApaka#miSraNa_saMyaMwra_pramApaka#noun#3#RM
plastic_consistency	plAstika_saMgawi#plAstika_saMgawi#noun#2#RM
plasticity_index	plAstikawA_sUcakAMka#plAstikawA_sUcakAMka#noun#2#RM
platform_balance	pleta_PArma/Palaka/patala_kAMtA/wulA#pleta_PArma/Palaka/patala_kAMtA/wulA#noun#2#RM
point_integrating	binxu_samAkalana#binxu_samAkalana#noun#2#RM
point_integrating_sampler	binxu_samAkalana_prawixarSI#binxu_samAkalana_prawixarSI#noun#3#RM
point_load_test	biMxu_BAra_parIkRaNa#biMxu_BAra_parIkRaNa#noun#3#RM
poorly_graded_gravel	bemela_SreNIbaxXa_bajarI#bemela_SreNIbaxXa_bajarI#noun#3#RM
pore_water_pressure	raMXra_jala_xAba#raMXra_jala_xAba#noun#3#RM
portable_direct_shear_test	vahanIya_prawyakRa_aparUpaNa_parIkRaNa#vahanIya_prawyakRa_aparUpaNa_parIkRaNa#noun#4#RM
potassium_oxide	potEsiyama_oYksAida#potEsiyama_oYksAida#noun#2#RM
power_extractor	pAvaragrAhI/pAvara_ekasatrEktara#pAvaragrAhI/pAvara_ekasatrEktara#noun#2#RM
pozzolanic_cement	jvAlAmuKIya_sImeMta#jvAlAmuKIya_sImeMta#noun#2#RM
pre-feasibility_study	vyavahAryawA-pUrva_aXyayana#vyavahAryawA-pUrva_aXyayana#noun#2#RM
pre_cooling	pUrva_SIwalana#pUrva_SIwalana#noun#2#RM
pre_packed_concrete	pUrva_nicaya_kaMkrIta#pUrva_nicaya_kaMkrIta#noun#3#RM
pre_tensioning	pUrva_wananIkaraNa#pUrva_wananIkaraNa#noun#2#RM
precipitable_water	varRaNIya_jala#varRaNIya_jala#noun#2#RM
preparation_of_samples	prawixarSa_banAnA#prawixarSa_banAnA#noun#3#RM
pressure_cell	xAba_sela#xAba_sela#noun#2#RM
pressure_gradation	xAba_pravaNawA#xAba_pravaNawA#noun#2#RM
primary_crusher	AraMBika_krEYSara/prAimarI_krEYSara#AraMBika_krEYSara/prAimarI_krEYSara#noun#2#RM
primary_shear	AraMBika_aparUpaNa#AraMBika_aparUpaNa#noun#2#RM
properties_of_soil_groups	mqxA_samUhoM_ke_guNa#mqxA_samUhoM_ke_guNa#noun#4#RM
protective_blankets	rakRI_AvaraNa#rakRI_AvaraNa#noun#2#RM
pulse_velocity_test	spaMxana_vega_parIkRaNa#spaMxana_vega_parIkRaNa#noun#3#RM
pulverized_aggregate	pisI_rodZI#pisI_rodZI#noun#2#RM
pumped_concrete	paMpiwa_kaMkrIta#paMpiwa_kaMkrIta#noun#2#RM
qualitative_analysis	guNAwmaka_viSleRaNa#guNAwmaka_viSleRaNa#noun#2#RM
qualitative_application	guNAwmaka_anuprayoga#guNAwmaka_anuprayoga#noun#2#RM
quality_control	guNavawwA_niyaMwraNa#guNavawwA_niyaMwraNa#noun#2#RM
quality_standard	guNavawwA_mAnaka#guNavawwA_mAnaka#noun#2#RM
quantitative_analysis	mAwrAwmaka_viSleRaNa#mAwrAwmaka_viSleRaNa#noun#2#RM
quantitative_application	parimANAwmaka_anuprayeAga#parimANAwmaka_anuprayeAga#noun#2#RM
quantity_control	mAwrA_niyaMwraNa#mAwrA_niyaMwraNa#noun#2#RM
quantity_of_electricity	vixyuwa_parimANa#vixyuwa_parimANa#noun#3#RM
quantity_of_seepage	risana_parimANa#risana_parimANa#noun#3#RM
quarternary_systems	cawurXAwuka_paxyawiyAM#cawurXAwuka_paxyawiyAM#noun#2#RM
quick_return_flow	xruwa_prawivarwI_pravAha#xruwa_prawivarwI_pravAha#noun#3#RM
radius_of_pipe	pAipa_kI_wrijyA#pAipa_kI_wrijyA#noun#3#RM
rain_gauge	varRA_mApI#varRA_mApI#noun#2#RM
rain_shadow_area	varRA_vaMciwa_kRewra#varRA_vaMciwa_kRewra#noun#3#RM
rainfall_distribution_co-efficient	varRA_viwaraNa_guNAMka#varRA_viwaraNa_guNAMka#noun#3#RM
rainfall_excess	varRAXikya#varRAXikya#noun#2#RM
rainfall_intensity	varRA_wIvrawA#varRA_wIvrawA#noun#2#RM
rapid_compaction	xruwa_saMhanana#xruwa_saMhanana#noun#2#RM
rapid_hardening_portland_cement	SIGra_pakkI_hone_vAlI_portalENda_sImeMta#SIGra_pakkI_hone_vAlI_portalENda_sImeMta#noun#4#RM
rate_of_silting_of_reservoirs	jalASayoM_kI_avasAxana_xara#jalASayoM_kI_avasAxana_xara#noun#5#RM
read_out_unit	paTana_ekaka#paTana_ekaka#noun#3#RM
reagemt_bottle	aBikarmaka_bowala#aBikarmaka_bowala#noun#2#RM
recession_curve	apagamana_vakra#apagamana_vakra#noun#2#RM
reconnaissance_survey	AvIkRaNa_sarvekRaNa#AvIkRaNa_sarvekRaNa#noun#2#RM
recurrence_interval	punarAvqwi_kAla/avaXi#punarAvqwi_kAla/avaXi#noun#2#RM
reduction_ratio	katOwI/kamI_kA_anupAwa#katOwI/kamI_kA_anupAwa#noun#2#RM
refraction_co-efficient	apavarwana_guNAMka#apavarwana_guNAMka#noun#2#RM
refraction_of_water_level	jala-wala_kA_apavarwana#jala-wala_kA_apavarwana#noun#4#RM
rehabilitation_of_dam	bAMXa_kA_punarsuXAra/punarUxXAra#bAMXa_kA_punarsuXAra/punarUxXAra#noun#3#RM
relative_density_apparatus	sApekRa_Ganawva_upakaraNa#sApekRa_Ganawva_upakaraNa#noun#3#RM
relative_humidity	ApekRika_ArxrawA#ApekRika_ArxrawA#noun#2#RM
remedial_measures	upacArAwmaka_upAya#upacArAwmaka_upAya#noun#2#RM
requirement_of_indian_standard	BArawIya_mAnaka_kI_apekRAeM#BArawIya_mAnaka_kI_apekRAeM#noun#4#RM
research_and_analysis	anusaMXAna_waWA_viSleRaNa#anusaMXAna_waWA_viSleRaNa#noun#3#RM
reservoir_and_command_area_surveys	jalASaya_waWA_kamAna_kRewra_sarvekRaNa#jalASaya_waWA_kamAna_kRewra_sarvekRaNa#noun#5#RM
residual_soils	avaSiRta_mqxA#avaSiRta_mqxA#noun#2#RM
resistance_strain_gauge	prawiroXaka_vikqwi_mApI#prawiroXaka_vikqwi_mApI#noun#3#RM
resistivity_apparatus	prawiroXakawA_upakaraNa#prawiroXakawA_upakaraNa#noun#2#RM
retention_curve	XAraNa_vakra#XAraNa_vakra#noun#2#RM
river_basin	naxI_xroNI/naxI_besina#naxI_xroNI/naxI_besina#noun#2#RM
river_gauging	naxI_pramApana#naxI_pramApana#noun#2#RM
river_management	naxI_prabaMXana#naxI_prabaMXana#noun#2#RM
rock_crusher	SilA_marxaka/vicUrNaka#SilA_marxaka/vicUrNaka#noun#2#RM
rock_cutting_machine	SilA_katAI_maSIna#SilA_katAI_maSIna#noun#3#RM
rock_fill	roYka_Pila#roYka_Pila#noun#2#RM
rock_fill_testing	roYka_Pila_parIkRaNa/pAtana_pawWara_parIkRaNa#roYka_Pila_parIkRaNa/pAtana_pawWara_parIkRaNa#noun#3#RM
rock_grinding_machine	SilA/roYka/kaMkadZa_pisAI_maSIna#SilA/roYka/kaMkadZa_pisAI_maSIna#noun#3#RM
rock_mass	SilApuMja#SilApuMja#noun#2#RM
rock_mechanics	SilA_yAMwrikI#SilA_yAMwrikI#noun#2#RM
rock_polishing_machine	SilA/roYka_pAliSa_karane_kI_maSIna#SilA/roYka_pAliSa_karane_kI_maSIna#noun#3#RM
rock_sample	SilA_prawixarSa/roYka_sEmpala#SilA_prawixarSa/roYka_sEmpala#noun#2#RM
rod_extenso_meter	CadZa/roda_eksatEnsomItara#CadZa/roda_eksatEnsomItara#noun#3#RM
rolled_eearth_fill	saMhaniwa_mittI_BarAI#saMhaniwa_mittI_BarAI#noun#3#RM
root_mean_square_(_r.m.s_)	varga_mAXya_mUla_mAna_(Ara.ema.esa)#varga_mAXya_mUla_mAna_(Ara.ema.esa)#noun#5#RM
rotary_drilling	GUrNI/rotarI_veXana#GUrNI/rotarI_veXana#noun#2#RM
rotary_kiln	GUrNI/rotarI_BatTA#GUrNI/rotarI_BatTA#noun#2#RM
run_off	apavAha#apavAha#noun#2#RM
run_off_co-efficient	apavAha_guNAMka#apavAha_guNAMka#noun#3#RM
safe_bearing_capacity	surakRiwa_XAriwA_kRamawA#surakRiwa_XAriwA_kRamawA#noun#3#RM
salinity_control	lavaNawA_niyaMwraNa#lavaNawA_niyaMwraNa#noun#2#RM
sample_extractor	namUnA/prawixarSa_lene_vAlA#namUnA/prawixarSa_lene_vAlA#noun#2#RM
sampling_technique	prawicayana_wakanIka#prawicayana_wakanIka#noun#2#RM
sand_bath	bAlU_URmaka#bAlU_URmaka#noun#2#RM
sand_blast_utility_apparatus	bAlU/rewa_visPota_upayogiwA_upakaraNa#bAlU/rewa_visPota_upayogiwA_upakaraNa#noun#4#RM
sand_blasting	bAlU_visPotana#bAlU_visPotana#noun#2#RM
scoop_type	uxgarwa_kI_waraha#uxgarwa_kI_waraha#noun#2#RM
scoop_type_bed_material_sampler	kalaCI_kI_Akqwi_vAlA_wala_sAmagrI_prawixarSI_yaMwra#kalaCI_kI_Akqwi_vAlA_wala_sAmagrI_prawixarSI_yaMwra#noun#5#RM
sealing_material	saMvaraNa_paxArWa#saMvaraNa_paxArWa#noun#2#RM
secondary_compression	gONa/mAXyamika_saMpIdana#gONa/mAXyamika_saMpIdana#noun#2#RM
secondary_crusher	gONa_xaliwra/xalaka#gONa_xaliwra/xalaka#noun#2#RM
secondary_tension	gONa_wanAva#gONa_wanAva#noun#2#RM
sediment_discharge_curve	walaCata_visarjana_vakra#walaCata_visarjana_vakra#noun#3#RM
sediment_observation	avasAxa_avalokana#avasAxa_avalokana#noun#2#RM
sediment_observation_site	avasAxa_avalokana_sWala#avasAxa_avalokana_sWala#noun#3#RM
sediment_yield	avasAxa_parABava#avasAxa_parABava#noun#2#RM
sedimentary_rock	avasAxI_SEla#avasAxI_SEla#noun#2#RM
seepage_analysis	risana_viSleRaNa#risana_viSleRaNa#noun#2#RM
seismic_monitoring	BUkampI_praboXana#BUkampI_praboXana#noun#2#RM
seismic_refraction_unit	BUkampIya_apavarwana_ekaka#BUkampIya_apavarwana_ekaka#noun#3#RM
selected_fill	variwa_BarAI#variwa_BarAI#noun#2#RM
selection_of_samples	prawixarSoM_kA_cayana#prawixarSoM_kA_cayana#noun#3#RM
self_desiccation	svawa:_SuRkana_aWavA_sUKanA#svawa:_SuRkana_aWavA_sUKanA#noun#2#RM
shallow_depth	kama_gaharA/uWalA#kama_gaharA/uWalA#noun#2#RM
shallow_seaports	CiCale_samuxra_pawwana#CiCale_samuxra_pawwana#noun#2#RM
shaper_machine	AkAra_xene_vAlI_maSIna/Separa_maSIna#AkAra_xene_vAlI_maSIna/Separa_maSIna#noun#2#RM
shear_strength	aparUpaNa_bala#aparUpaNa_bala#noun#2#RM
shear_test_apparatus	aparUpaNa_parIkRaNa_upakaraNa#aparUpaNa_parIkRaNa_upakaraNa#noun#3#RM
shifting_control	visWApana_niyaMwraNa#visWApana_niyaMwraNa#noun#2#RM
shrinkage_limit_apparatus	sikudZana/saMkucana_sImA_upakaraNa#sikudZana/saMkucana_sImA_upakaraNa#noun#3#RM
sieves_analysis	CAnakara_kiyA_gayA_viSleRaNa/cAlanI_viSleRaNa#CAnakara_kiyA_gayA_viSleRaNa/cAlanI_viSleRaNa#noun#2#RM
sieves_of_different_diameters	viBinna_vyAsoM_vAlI_CalaniyAM/cAlaniyAM#viBinna_vyAsoM_vAlI_CalaniyAM/cAlaniyAM#noun#4#RM
signal_conditioning	siganala_kaMdISaniMga#siganala_kaMdISaniMga#noun#2#RM
silt_discharge_site	gAxa_nissaraNa_sWala#gAxa_nissaraNa_sWala#noun#3#RM
silt_factor	gAxa_guNAMka#gAxa_guNAMka#noun#2#RM
single_pan_balance	eka_paladZe_vAlA_warAjU#eka_paladZe_vAlA_warAjU#noun#3#RM
site_study	sWala_aXyayana#sWala_aXyayana#noun#2#RM
six_channel_recorder	Caha_cEnaloM_vAlA_aBileKI_yaMwra#Caha_cEnaloM_vAlA_aBileKI_yaMwra#noun#3#RM
slake_durability_apparatus	Samana_sWAyiwva_upakaraNa#Samana_sWAyiwva_upakaraNa#noun#3#RM
slake_durability_test	Samana_sWAyiwva_parIkRaNa#Samana_sWAyiwva_parIkRaNa#noun#3#RM
sliding_resistance	PisalAva_prawiroXa#PisalAva_prawiroXa#noun#2#RM
small_load_cells_with_accessories	anuRaMgiyoM_sahiwa_laGuBAra_mApaka/sela#anuRaMgiyoM_sahiwa_laGuBAra_mApaka/sela#noun#5#RM
sodium_oxide	sodiyama_oYksAida#sodiyama_oYksAida#noun#2#RM
soft_particles	narama_kaNa#narama_kaNa#noun#2#RM
soft_water	mqxu_jala#mqxu_jala#noun#2#RM
soil/rock_strength	mqxA/pARANa_bala/Sakwi#mqxA/pARANa_bala/Sakwi#noun#2#RM
soil_-conservation_forestry	mqxA/BU-saMrakRaNa_va_vAnikI#mqxA/BU-saMrakRaNa_va_vAnikI#noun#3#RM
soil_and_land_classification	mqxA_waWA_BUmi_vargIekaraNa#mqxA_waWA_BUmi_vargIekaraNa#noun#4#RM
soil_components	mqxA_Gataka#mqxA_Gataka#noun#2#RM
soil_conservation	BUmi_saMrakRaNa#BUmi_saMrakRaNa#noun#2#RM
soil_consistency	mqxA_saMgawi#mqxA_saMgawi#noun#2#RM
soil_erosion	BU-kRaraNa/mittI_kA_katAva#BU-kRaraNa/mittI_kA_katAva#noun#2#RM
soil_lathe	mqxA_KarAxa#mqxA_KarAxa#noun#2#RM
soil_mechanics	mqxA_yAnwrikI#mqxA_yAnwrikI#noun#2#RM
soil_moisture	mqxA_namI/ArxrawA#mqxA_namI/ArxrawA#noun#2#RM
soil_moisture_deficit	mqxA_jalAMSa_nyUnawA/mqxA_namI_nyUnawA#mqxA_jalAMSa_nyUnawA/mqxA_namI_nyUnawA#noun#3#RM
soil_profile	mqxA_paricCexikA/mqxA_proPAila#mqxA_paricCexikA/mqxA_proPAila#noun#2#RM
soil_samples_&_t&p_equipment	mqxA_namUne_waWA_OjAra_Ora_saMyaMwra_upakaraNa#mqxA_namUne_waWA_OjAra_Ora_saMyaMwra_upakaraNa#noun#5#RM
soil_structure	mqxA_saMracanA#mqxA_saMracanA#noun#2#RM
solid_phase	Tosa_prAvasWA#Tosa_prAvasWA#noun#2#RM
solid_solution	Tosa_Gola#Tosa_Gola#noun#2#RM
soluble_salts	vilayaSIla/GulanaSIla_lavaNa#vilayaSIla/GulanaSIla_lavaNa#noun#2#RM
soundness_test	Tosapana_parIkRaNa/sAuMdanEsa_parIkRaNa#Tosapana_parIkRaNa/sAuMdanEsa_parIkRaNa#noun#2#RM
spare_triaxial_cell	awirikwa_wriakRIya_sela#awirikwa_wriakRIya_sela#noun#3#RM
specific_capacity	viSiRta_kRamawA#viSiRta_kRamawA#noun#2#RM
specific_density	viSiRta_Ganawva/apekRiwa_Ganawva#viSiRta_Ganawva/apekRiwa_Ganawva#noun#2#RM
specific_energy	viSiRta_UrjA#viSiRta_UrjA#noun#2#RM
specific_gravity	viSiRta_gurUwva#viSiRta_gurUwva#noun#2#RM
specific_properties	viSiRta/viSeRa_guNa#viSiRta/viSeRa_guNa#noun#2#RM
specific_retention	viSiRta_XAraNa#viSiRta_XAraNa#noun#2#RM
specific_surface	viSiRta_sawaha#viSiRta_sawaha#noun#2#RM
specific_yield	viSiRta_labXi#viSiRta_labXi#noun#2#RM
spectro_photometer	spektro_Poto_mItara#spektro_Poto_mItara#noun#2#RM
split-tube_sampler	viBakwa-tyUba_prawixarSaka#viBakwa-tyUba_prawixarSaka#noun#2#RM
standard_deviation	mAnaka_vicalana#mAnaka_vicalana#noun#2#RM
standard_solution	mAnaka_Gola#mAnaka_Gola#noun#2#RM
static_fatigue	sWEwika_SrAMwi#sWEwika_SrAMwi#noun#2#RM
static_strength	sWEwika_bala#sWEwika_bala#noun#2#RM
station_gauge_line	steSana_geja_lAina#steSana_geja_lAina#noun#3#RM
statistical_analysis	sAMKyikIya_viSleRaNa#sAMKyikIya_viSleRaNa#noun#2#RM
stop_watch	virAma_GadZI#virAma_GadZI#noun#2#RM
store_of_water_samples	jala_namUnoM_kA_BaNdAra#jala_namUnoM_kA_BaNdAra#noun#4#RM
strain_gauge	vikqwi_pramApaka#vikqwi_pramApaka#noun#2#RM
strain_meter_with_accessories	anuRaMgiyoM_sahiwa_wanana/viqkawi_pramApaka#anuRaMgiyoM_sahiwa_wanana/viqkawi_pramApaka#noun#4#RM
stress_&_strain_relation	prawibala_waWA_vikqwi_saMbaMXa#prawibala_waWA_vikqwi_saMbaMXa#noun#4#RM
stress_meter	prawibala_pramApaka#prawibala_pramApaka#noun#2#RM
sub-surface_exploration	aXaswala_anveRaNa#aXaswala_anveRaNa#noun#2#RM
sub_grades	upa_SreNiyAM#upa_SreNiyAM#noun#2#RM
sub_soil_investigations	ava_mqxA_anveRaNa#ava_mqxA_anveRaNa#noun#3#RM
submerged_gate_area	nimagna_PAtaka_kRewra#nimagna_PAtaka_kRewra#noun#3#RM
sulphur_fernite	gaMXaka_ParanAita#gaMXaka_ParanAita#noun#2#RM
surface_area_factor	sawahI_kRewrIya_Gataka#sawahI_kRewrIya_Gataka#noun#3#RM
surface_energy	sawahI_UrjA#sawahI_UrjA#noun#2#RM
surface_exploration	sawahI_anveRaNa#sawahI_anveRaNa#noun#2#RM
surface_moisture	sawahI_namI#sawahI_namI#noun#2#RM
surface_outflow	sawahI_jala_bahirpravAha#sawahI_jala_bahirpravAha#noun#2#RM
surface_retention	sawahI_jalaXAraNa#sawahI_jalaXAraNa#noun#2#RM
surface_run_off	sawahI_apavAha#sawahI_apavAha#noun#3#RM
surface_run_off_retention	sawahI_apavAha_jalaXAraNa#sawahI_apavAha_jalaXAraNa#noun#4#RM
surface_texture	wala_gaTana/racanA#wala_gaTana/racanA#noun#2#RM
surface_volume_ratio	wala_Ayawana_anupAwa#wala_Ayawana_anupAwa#noun#3#RM
surveillance_measures	nigarAnI_upAya#nigarAnI_upAya#noun#2#RM
suspended_sediment	nilaMbiwa_avasAxa/walaCata#nilaMbiwa_avasAxa/walaCata#noun#2#RM
sustained_loading	sawawa/xIrXAvaXi_BAra#sawawa/xIrXAvaXi_BAra#noun#2#RM
sustained_runoff	avirawa_apavAha#avirawa_apavAha#noun#2#RM
swamp_muck	xalaxala_karxama#xalaxala_karxama#noun#2#RM
swell_test_apparatus_(_hand_operated_)	sPIwi_parIkRaNa_upakaraNa_(haswacAliwa)#sPIwi_parIkRaNa_upakaraNa_(haswacAliwa)#noun#6#RM
tailrace_tunnel	visarjanI_suraMga#visarjanI_suraMga#noun#2#RM
tamping_rod	kutAI_CadZa/kuttaka_xaMda#kutAI_CadZa/kuttaka_xaMda#noun#2#RM
tape_extensometer	tepa_eksatensomItara/xErXya_vqxXimApI#tepa_eksatensomItara/xErXya_vqxXimApI#noun#2#RM
technical_assistance	wakanIkI_sahAyawA#wakanIkI_sahAyawA#noun#2#RM
technical_collaboration	wakanIkI_sahayoga#wakanIkI_sahayoga#noun#2#RM
technical_guidance	wakanIkI_mArgaxarSana#wakanIkI_mArgaxarSana#noun#2#RM
technical_specification	wakanIkI_vinirxeSa/viSiRti#wakanIkI_vinirxeSa/viSiRti#noun#2#RM
tensile_strength	wanana_bala#wanana_bala#noun#2#RM
test_apparatus	parIkRaNa_upakaraNa#parIkRaNa_upakaraNa#noun#2#RM
test_pit	parIkRaNa_garwa/jAMca_gadDA#parIkRaNa_garwa/jAMca_gadDA#noun#2#RM
test_procedure	parIkRaNa_viXi#parIkRaNa_viXi#noun#2#RM
testing_machine	parIkRaNa_maSIna#parIkRaNa_maSIna#noun#2#RM
tetra_hedron	cawuRPalaka#cawuRPalaka#noun#2#RM
thermal_conductivity	wApa_saMvAhakawA/saMcalanaSIlawA#wApa_saMvAhakawA/saMcalanaSIlawA#noun#2#RM
thermal_diffusivity	wApa/wApIya_visaraNaSIlawA#wApa/wApIya_visaraNaSIlawA#noun#2#RM
thermal_dilatation	wApa_viswAraNa/wApAyawana_prasAra#wApa_viswAraNa/wApAyawana_prasAra#noun#2#RM
thermal_expansion	wApa_viswAra#wApa_viswAra#noun#2#RM
thermal_gravimetry	wApa_gurUwvakI#wApa_gurUwvakI#noun#2#RM
thermostate_control	wApApekRI_niyaMwraNa#wApApekRI_niyaMwraNa#noun#2#RM
thermostate_vacuum_balance	wApApekRI_nirvAwa_wulA#wApApekRI_nirvAwa_wulA#noun#3#RM
thermostatically_controlled_water_bath	wApa_niyaMwraka_jala_pAwra#wApa_niyaMwraka_jala_pAwra#noun#4#RM
three_dimensional	wrivimIya/wri-AyAmI#wrivimIya/wri-AyAmI#noun#2#RM
thunder_strom	wadZiwa_vqRti#wadZiwa_vqRti#noun#2#RM
tidal_and_delta_river	jvArIya_va_deltA_naxI#jvArIya_va_deltA_naxI#noun#4#RM
tidal_currents	jvArIya_pravAha/XArA#jvArIya_pravAha/XArA#noun#2#RM
tidal_power_station	jvArIya_vixyuwa_kenxra#jvArIya_vixyuwa_kenxra#noun#3#RM
titanium_dioxide	titeniyama_dAI-oYksAida#titeniyama_dAI-oYksAida#noun#2#RM
tools_and_plants	OjAra_Ora_saMyaMwra#OjAra_Ora_saMyaMwra#noun#3#RM
top_pan_balance	UparI_paladZe_vAlI_wulA#UparI_paladZe_vAlI_wulA#noun#3#RM
top_soil	UparI_mqxA#UparI_mqxA#noun#2#RM
topographic_map	sWalAkqwi_mAnaciwra#sWalAkqwi_mAnaciwra#noun#2#RM
topographical_survey/investigation	sWalAkqwika_sarvekRaNa/anveRaNa#sWalAkqwika_sarvekRaNa/anveRaNa#noun#2#RM
transmission_of_power	vixyuwa_prasAraNa#vixyuwa_prasAraNa#noun#3#RM
transmission_system	prasAraNa_praNAlI#prasAraNa_praNAlI#noun#2#RM
trapping_efficiency	pASana_xakRawA/pragrahaNa_xakRawA#pASana_xakRawA/pragrahaNa_xakRawA#noun#2#RM
tri-axial_cell	wriakRIya_sEla#wriakRIya_sEla#noun#2#RM
tri_axial_machine	wriakRIya_maSIna#wriakRIya_maSIna#noun#3#RM
tri_axial_shear	wriakRIya_aparUpaNa#wriakRIya_aparUpaNa#noun#3#RM
tri_axial_shear_of_soil	mqxA_kA_wriakRIya_aparUpaNa#mqxA_kA_wriakRIya_aparUpaNa#noun#5#RM
tri_axial_unit	wriakRIya_ekaka#wriakRIya_ekaka#noun#3#RM
tri_calcium_silicate	trAkElsiyama_siliketa#trAkElsiyama_siliketa#noun#3#RM
turbidity_meter	gaMxalApana_mApI/mApaka#gaMxalApana_mApI/mApaka#noun#2#RM
turbine_blades	tarabAina_bleda#tarabAina_bleda#noun#2#RM
typical_sand	prArUpika_rewa#prArUpika_rewa#noun#2#RM
ultimate_bearing_capacity	carama_XAriwA_kRamawA#carama_XAriwA_kRamawA#noun#3#RM
ultimate_strength_of_concrete	kaMkrIta_kI_carama_sArmaWya#kaMkrIta_kI_carama_sArmaWya#noun#4#RM
ultra_fine_cement	awi_bArIka_sImeMta#awi_bArIka_sImeMta#noun#3#RM
ultra_high_early_strength_portland_cement	bahuwa_jalxI_xqDZa_ho_jAne_vAlI_porta_lENda_sImeMta#bahuwa_jalxI_xqDZa_ho_jAne_vAlI_porta_lENda_sImeMta#noun#6#RM
ultra_sonic	parASravya#parASravya#noun#2#RM
ultrasonic_flow_meter	parAXvanika/parASravya_pravAhamApI#parAXvanika/parASravya_pravAhamApI#noun#3#RM
ultrasonic_test	parAXvanika/parASravya_parIkRaNa#parAXvanika/parASravya_parIkRaNa#noun#2#RM
un-regulated_flow	aniyamiwa_pravAha#aniyamiwa_pravAha#noun#2#RM
under_construction	nirmANAXIna#nirmANAXIna#noun#2#RM
underground_exploration	BUmigawa_Koja#BUmigawa_Koja#noun#2#RM
underground_power_station	BUmigawa_vixyuwa_kenxra#BUmigawa_vixyuwa_kenxra#noun#3#RM
underground_reservoir	BUmigawa_jalASaya#BUmigawa_jalASaya#noun#2#RM
undisturbed_sampling	avikRubXa_prawixarSa_cayana#avikRubXa_prawixarSa_cayana#noun#2#RM
undulated_land	Urmila/UMcI-nIcI_BUmi#Urmila/UMcI-nIcI_BUmi#noun#2#RM
uniaxial_tension	eka_akRIya_wanAva#eka_akRIya_wanAva#noun#2#RM
unified_sand	ekIkqwa_rewa#ekIkqwa_rewa#noun#2#RM
unified_soil_classification_chart	ekIkqwa_mqxA_vargIkaraNa_wAlikA#ekIkqwa_mqxA_vargIkaraNa_wAlikA#noun#4#RM
uniform_flow	eka_samAna_pravAha#eka_samAna_pravAha#noun#2#RM
unit_hydrograph	ekaka_jalAleKa#ekaka_jalAleKa#noun#2#RM
unit_rainfall_duration	varRA_avaXi_ekaka#varRA_avaXi_ekaka#noun#3#RM
unit_weight	ekaka_BAra/ikAI_BAra#ekaka_BAra/ikAI_BAra#noun#2#RM
unsaturated_zone	asaMwqpwa_kRewra#asaMwqpwa_kRewra#noun#2#RM
upgrading_of_existing_system	vixyamAna_praNAliyoM_kA_swara_suXAra/unnayana#vixyamAna_praNAliyoM_kA_swara_suXAra/unnayana#noun#4#RM
upstream_drainage_basin	prawipravAha_apavAha_kRewra#prawipravAha_apavAha_kRewra#noun#3#RM
upto-date_report	axyawana_riporta/prawivexana#axyawana_riporta/prawivexana#noun#2#RM
v.s.d.vertical_sediment_distribution_)	UrXva_walaCata_viwaraNa#UrXva_walaCata_viwaraNa#noun#3#RM
vacuum_saturaties	nirvAwa_saMwqpwiyAM#nirvAwa_saMwqpwiyAM#noun#2#RM
vagaries_of_monsoon	mAnasUna_kI_aniSciwawAeM#mAnasUna_kI_aniSciwawAeM#noun#3#RM
valley_fill	GAtI-BarAva#GAtI-BarAva#noun#2#RM
velocity_diagram	vega_AreKa#vega_AreKa#noun#2#RM
vertical_movement	UrXva_gawi/UrXva_calana#UrXva_gawi/UrXva_calana#noun#2#RM
vertical_velocity_distribution	UrXvAXara_gawi/vega_viwaraNa#UrXvAXara_gawi/vega_viwaraNa#noun#3#RM
verticle_component	UrXvAXara_Gataka#UrXvAXara_Gataka#noun#2#RM
virgin_flow	prAkqwa/akRawa_pravAha#prAkqwa/akRawa_pravAha#noun#2#RM
visual_method_of_indentification	aBinirXAraNa_kI_xqSya_paxyawi#aBinirXAraNa_kI_xqSya_paxyawi#noun#4#RM
void_ratio	rikwi_anupAwa#rikwi_anupAwa#noun#2#RM
voltage_stabilizer	voltawA_sWAyIkArI#voltawA_sWAyIkArI#noun#2#RM
volumetric_flask	AyawanI_PalAska#AyawanI_PalAska#noun#2#RM
wading_rod	gaharAI_mApaka_xaNda#gaharAI_mApaka_xaNda#noun#2#RM
warning_stage	cewAvanI_swara/jala_swara#cewAvanI_swara/jala_swara#noun#2#RM
wash_bottle	vASa_boewala/XAvana_bowala#vASa_boewala/XAvana_bowala#noun#2#RM
watch_glass	vAca_glAsa#vAca_glAsa#noun#2#RM
water_absorption	jala_avaSoRaNa#jala_avaSoRaNa#noun#2#RM
water_balance_study	jala_saMwulana_aXyayana#jala_saMwulana_aXyayana#noun#3#RM
water_bath	jala_kuMdikA/jala_URmaka#jala_kuMdikA/jala_URmaka#noun#2#RM
water_body	jala_rASi#jala_rASi#noun#2#RM
water_carriage_system	jala_vahana_praNAlI#jala_vahana_praNAlI#noun#3#RM
water_conservation	jala_saMrakRaNa#jala_saMrakRaNa#noun#2#RM
water_content	jala_mAwrA#jala_mAwrA#noun#2#RM
water_delivery_efficiency	jala_viwaraNa_xakRawA#jala_viwaraNa_xakRawA#noun#3#RM
water_distribution_system	jala_viwaraNa_praNAlI#jala_viwaraNa_praNAlI#noun#3#RM
water_exchange	jala_vinimaya#jala_vinimaya#noun#2#RM
water_harvesting	jala_saMcayana/ekawrIkaraNa#jala_saMcayana/ekawrIkaraNa#noun#2#RM
water_logged_area	jalakrAnwa/jalagraswa_kRewra#jalakrAnwa/jalagraswa_kRewra#noun#3#RM
water_logging	jala_grasana/jala_grasanawA#jala_grasana/jala_grasanawA#noun#2#RM
water_purification_workshop	jala_SuxXikaraNa/SoXana_kAryaSAlA#jala_SuxXikaraNa/SoXana_kAryaSAlA#noun#3#RM
water_recharge	jala_puna:pUraNa#jala_puna:pUraNa#noun#2#RM
water_resources_development	jala_saMsAXana_vikAsa#jala_saMsAXana_vikAsa#noun#3#RM
water_scarcity	jala_aBAvagraswawA/jala_xurlaBawA#jala_aBAvagraswawA/jala_xurlaBawA#noun#2#RM
water_shed_area	jala_viBAjaka_kRewra#jala_viBAjaka_kRewra#noun#3#RM
water_shed_management	jala_viBAjaka_prabaMXana#jala_viBAjaka_prabaMXana#noun#3#RM
water_shed_simulation	jala_viBAjaka/jala_parikRewra_anukaraNa#jala_viBAjaka/jala_parikRewra_anukaraNa#noun#3#RM
water_soaked	jala_sikwa#jala_sikwa#noun#2#RM
water_supply_and_sewage	jala_ApUrwi_va_malajala_vyavasWA#jala_ApUrwi_va_malajala_vyavasWA#noun#4#RM
water_table	BOma_jala_swara#BOma_jala_swara#noun#2#RM
water_treatment	jala_praSoXana/saMSoXana#jala_praSoXana/saMSoXana#noun#2#RM
wear_and_tear	prayoga_se_hone_vAlI_kRawi#prayoga_se_hone_vAlI_kRawi#noun#3#RM
weighted_average	BAriwa_mAXya/Osawa#BAriwa_mAXya/Osawa#noun#2#RM
well_graded_gravel	supravaNiwa_bajarI#supravaNiwa_bajarI#noun#3#RM
wet_land	Arxra_BUmi#Arxra_BUmi#noun#2#RM
x-section_of_river_diversion	naxI_paWAMwaraNa_sWala_kA_anuprasWa_kAta#naxI_paWAMwaraNa_sWala_kA_anuprasWa_kAta#noun#4#RM
yield_point	upaja/prApwi/labXi_binxu#upaja/prApwi/labXi_binxu#noun#2#RM
yielding_soil	parABavI_mqxA#parABavI_mqxA#noun#2#RM
yielding_strength	parABavIya_Sakwi/sArmaWya#parABavIya_Sakwi/sArmaWya#noun#2#RM
youngs_modulous	yaMga_mApAMka/yaMga_moYdyulsa#yaMga_mApAMka/yaMga_moYdyulsa#noun#2#RM
zero_moisture_index	SUnya_ArxrawA_sUcakAMka#SUnya_ArxrawA_sUcakAMka#noun#3#RM
zone_control	kRewra_niyaMwraNa#kRewra_niyaMwraNa#noun#2#RM
zone_levelling	kRewra/KaNda_samawalana#kRewra/KaNda_samawalana#noun#2#RM
zoned_earth_dam	samiRta_mittI_bAMXa#samiRta_mittI_bAMXa#noun#3#RM
