#steel multi word dictionary extracted by Monika Sharma. Formatted by Roja (26-01-2016)
#Changes:: 1) Separated single word and multi words into separate dictionaries
#          2) English words are converted to lower case
#          3) Added category as 'noun' by default
#          4) If last word is not punctuation then treated last word as head
#             or else treated last but one word as head
######################################################################################
acid_open-hearth_process	amla_openahArWa_prakrama#amla_openahArWa_prakrama#noun#3#RM
acid_refractory	amlIya_uccawApasaha_paxArWa#amlIya_uccawApasaha_paxArWa#noun#2#RM
acid_slag	amlIya_XAwumala#amlIya_XAwumala#noun#2#RM
acierage_(_steeling_)	esIare_ispAwa_vilepana#esIare_ispAwa_vilepana#noun#3#RM
air_cooled_slag	vAyu_SIwiwa_XAwumala#vAyu_SIwiwa_XAwumala#noun#3#RM
air_hardening	vAyu_kaToraNa#vAyu_kaToraNa#noun#2#RM
allotropy_(_polymorphism_)	apararUpawA#apararUpawA#noun#3#RM
alloy_steel	miSrAwu_ispAwa#miSrAwu_ispAwa#noun#2#RM
alloy_steel_plant	miSrAwu_ispAwa_saMyaMwra#miSrAwu_ispAwa_saMyaMwra#noun#3#RM
anneal_hardening	anIla_kaToraNa#anIla_kaToraNa#noun#2#RM
arc_blow	Arka_WamA#Arka_WamA#noun#2#RM
arc_brazing	Arka_brejana#Arka_brejana#noun#2#RM
arc_crater	Arka-swaMBa#Arka-swaMBa#noun#2#RM
arc_cutting	Arka_karwana#Arka_karwana#noun#2#RM
arc_furnace	Arka_BattI#Arka_BattI#noun#2#RM
arc_heating	Arka_wApA#Arka_wApA#noun#2#RM
asbestos_rope	EsbestoYsa_rajju#EsbestoYsa_rajju#noun#2#RM
austenitic_cast_iron	oYstenAitI_DalavAM_lohA#oYstenAitI_DalavAM_lohA#noun#3#RM
automatic_conveyer	svawa:_vAhiwra_BattI#svawa:_vAhiwra_BattI#noun#2#RM
automatic_furnace	svacAliwa_BattI#svacAliwa_BattI#noun#2#RM
automatic_welding	svacAliwa_veldiMga#svacAliwa_veldiMga#noun#2#RM
bar_steel	SalAkA_ispAwa#SalAkA_ispAwa#noun#2#RM
basic_arc_furnace	kRArakIya_Arka_BattI#kRArakIya_Arka_BattI#noun#3#RM
basic_electric_arc_furnace	kRArakIya_vixyuwa_Arka_BattI#kRArakIya_vixyuwa_Arka_BattI#noun#4#RM
basic_hearth_process	kRakRArakI_hArWa_prakrama#kRakRArakI_hArWa_prakrama#noun#3#RM
basic_lined_converter	kRArakIya_Aswariwa_parivarwiwra#kRArakIya_Aswariwa_parivarwiwra#noun#3#RM
basic_open_hearth_process	kRArakIya_openahArWa_prakrama#kRArakIya_openahArWa_prakrama#noun#4#RM
basic_refractory	kRArakIya_uccawApasaha#kRArakIya_uccawApasaha#noun#2#RM
basic_slag	kRArakIya_XAwumala#kRArakIya_XAwumala#noun#2#RM
basic_steel	kRArakIya_ispAwa#kRArakIya_ispAwa#noun#2#RM
basicity_of_slag	XAwumala-kRArakawA#XAwumala-kRArakawA#noun#3#RM
bayer_process	bOara_prakrama#bOara_prakrama#noun#2#RM
belt_conveyor	pattA_vAhiwra#pattA_vAhiwra#noun#2#RM
bessemer_converter	bEsemara_parivarwiwra#bEsemara_parivarwiwra#noun#2#RM
bessemer_iron	bEsemara_lohA#bEsemara_lohA#noun#2#RM
bessemer_pig_iron	bEsemara_kaccA_lohA#bEsemara_kaccA_lohA#noun#3#RM
bessemer_process	bEsemara_prakrama#bEsemara_prakrama#noun#2#RM
bessemer_steel	bEsemara_ispAwa#bEsemara_ispAwa#noun#2#RM
billet_ejector	bileta_saMcakiwra#bileta_saMcakiwra#noun#2#RM
billet_furnace	bileta_BattI#bileta_BattI#noun#2#RM
bimetallic_corrosion	xviXAkawvaka_saMkRAraNa#xviXAkawvaka_saMkRAraNa#noun#2#RM
bisra_process_(_british_iron_steel_research_association_)	bisarA_prakrama#bisarA_prakrama#noun#8#RM
bitumen-asbestos_mastic	bitUmena_EsbestoYsa_makastaka#bitUmena_EsbestoYsa_makastaka#noun#2#RM
bitumen_coating	bitUmena_vilepa/bitUmena_vilepana#bitUmena_vilepa/bitUmena_vilepana#noun#2#RM
bitumen_lining	bitUmena_AswaraNa#bitUmena_AswaraNa#noun#2#RM
bituminous_solution	bitUminI_vilayA#bitUminI_vilayA#noun#2#RM
black_annealing	kqRNa_anIlana#kqRNa_anIlana#noun#2#RM
black_ore	kqRNa_ayaska#kqRNa_ayaska#noun#2#RM
black_slag	kqRNa_XAwumala#kqRNa_XAwumala#noun#2#RM
blacksmithfas_furnace	lohArI_BattI#lohArI_BattI#noun#2#RM
blast_furnace	XamA_BattI#XamA_BattI#noun#2#RM
bloom_caster	blUma_saMcakiwra#blUma_saMcakiwra#noun#2#RM
box_annealing	petI_anIlana#petI_anIlana#noun#2#RM
brass_coupling	pIwala_yugmA#pIwala_yugmA#noun#2#RM
brick_lining	ikaRtakA_Aswara/IMta_Aswara#ikaRtakA_Aswara/IMta_Aswara#noun#2#RM
bright_annealing	xIpwa_anIlana#xIpwa_anIlana#noun#2#RM
bucket_hoist	bAltI_uccAlaka#bAltI_uccAlaka#noun#2#RM
calomel_electrode	kElomala_ilOktroda#kElomala_ilOktroda#noun#2#RM
captive_mine	pragrAhI_KaxAna/nijI_KaxAna#pragrAhI_KaxAna/nijI_KaxAna#noun#2#RM
carbon_arc_welding	kArbana_Arka_vOKldaga#kArbana_Arka_vOKldaga#noun#3#RM
cast_iron	DalavAM_lohA/saMcakiwa_lohA#DalavAM_lohA/saMcakiwa_lohA#noun#2#RM
cast_steel	DalavAM_ispAwa/saMcakiwa_ispAwa#DalavAM_ispAwa/saMcakiwa_ispAwa#noun#2#RM
cast_steel_roll	DalavAM_ispAwa_belA/saMcakiwa_ispAwa_belA#DalavAM_ispAwa_belA/saMcakiwa_ispAwa_belA#noun#3#RM
cathode_corrosion	kEWoda_nirmalA#kEWoda_nirmalA#noun#2#RM
ceramic_(_insulating_)_hot_top	siremika_(URmAroXI)_wapwa_SIrRa#siremika_(URmAroXI)_wapwa_SIrRa#noun#6#RM
ceramic_coating	siremika_vilepana#siremika_vilepana#noun#2#RM
charcoal_iron	cArakola_lohA#cArakola_lohA#noun#2#RM
charge_mix	GAna_miSra#GAna_miSra#noun#2#RM
charging_bucket	GAna-bAltI#GAna-bAltI#noun#2#RM
chrome_plating	kroma_lepana#kroma_lepana#noun#2#RM
chrome_refractory	kroma_uccawApasaha#kroma_uccawApasaha#noun#2#RM
chromium-iron_alloy	kromiyama-loha_miSrAwu#kromiyama-loha_miSrAwu#noun#2#RM
chromium-molybdenum_steel	kromiyama-molikabdAma-ispAwa#kromiyama-molikabdAma-ispAwa#noun#2#RM
chromium_nickel_alloy	kromiyama-nikila_miSrAwu#kromiyama-nikila_miSrAwu#noun#3#RM
chromium_steel	kromiyama_ispAwa#kromiyama_ispAwa#noun#2#RM
close_annealing	saMvqwa_anIlana#saMvqwa_anIlana#noun#2#RM
coal_blending	koyalA_saMmiSraNa#koyalA_saMmiSraNa#noun#2#RM
coal_blending_station	koyalA_saMmiSraNa_kexra#koyalA_saMmiSraNa_kexra#noun#3#RM
coal_fired_furnace	koyalA_jvAliwa_BattI#koyalA_jvAliwa_BattI#noun#3#RM
coal_pulverizor	koyalA_cakkI/koyalA_cUrNiwra#koyalA_cakkI/koyalA_cUrNiwra#noun#2#RM
coal_stamp_charging	saMkuliwa_koyalA_GAnana#saMkuliwa_koyalA_GAnana#noun#3#RM
coiled_bar	kuMdaliwa_SalAkA#kuMdaliwa_SalAkA#noun#2#RM
coiled_strip	kuMdaliwa_pattI#kuMdaliwa_pattI#noun#2#RM
coke_oven	koka_ovA#koka_ovA#noun#2#RM
coke_oven_battery	koka_ovA_bOtarI#koka_ovA_bOtarI#noun#3#RM
coke_oven_gas	koka_ovA_gEsa#koka_ovA_gEsa#noun#3#RM
coking_coal	kokA_koyalA#kokA_koyalA#noun#2#RM
cold_briquetting	awapwa_ikaRtakAkaraNa/awapwa_brikitA#awapwa_ikaRtakAkaraNa/awapwa_brikitA#noun#2#RM
cold_charge	awapwa_GAna#awapwa_GAna#noun#2#RM
cold_galvanizing	awapwa_yaSaxA#awapwa_yaSaxA#noun#2#RM
cold_rolling	awapwa_bellA#awapwa_bellA#noun#2#RM
combustion_chamber	xahana_kakRa#xahana_kakRa#noun#2#RM
compressed_air	saMpIdiwa_vAyu#saMpIdiwa_vAyu#noun#2#RM
concrete_steel	kaMkrIta_ispAwa#kaMkrIta_ispAwa#noun#2#RM
continuous_billet_mill	sawaw_bileta_mila#sawaw_bileta_mila#noun#3#RM
continuous_process	sawawa_prakrama#sawawa_prakrama#noun#2#RM
converter_steel	parivarwiwra_ispAwa/kavartara_ispAwa#parivarwiwra_ispAwa/kavartara_ispAwa#noun#2#RM
conveyor_belt	vAhiwra_pattA#vAhiwra_pattA#noun#2#RM
copper_brazing	wAmra_parivarwiwra#wAmra_parivarwiwra#noun#2#RM
coupling_(_coupler_)	yugmA#yugmA#noun#3#RM
coupling_parameter	samavaya_prAcala#samavaya_prAcala#noun#2#RM
coupling_tube_(_coupler_tube_)	yugmakanalikA#yugmakanalikA#noun#5#RM
crucible_process	krusibala_BattI#krusibala_BattI#noun#2#RM
crude_steel	apariRkqwa_ispAwa#apariRkqwa_ispAwa#noun#2#RM
dead_annealing	pUrNa_anIlana#pUrNa_anIlana#noun#2#RM
degassing_of_steel	ispAwa-vigEsana#ispAwa-vigEsana#noun#3#RM
dip_brazing	nimajja_brEjA#nimajja_brEjA#noun#2#RM
dip_soldering	nimajja_soldarana#nimajja_soldarana#noun#2#RM
direct_arc_furnace	saMparka_Arka_BattI#saMparka_Arka_BattI#noun#3#RM
direct_steel_making	prawyakRa_ispAwa_nirmANa#prawyakRa_ispAwa_nirmANa#noun#3#RM
double_slag_process	xvi-XAwumala_prakrama#xvi-XAwumala_prakrama#noun#3#RM
double_slagging	xviXAwumalA#xviXAwumalA#noun#2#RM
drilling_(_min._)	praveXA#praveXA#noun#3#RM
electric_arc_furnace	vixyuwa_Arka_BattI#vixyuwa_Arka_BattI#noun#3#RM
electric_arc_process	vixyuwa_Arka_prakrama#vixyuwa_Arka_prakrama#noun#3#RM
electric_furnace	vixyuwa_BattI#vixyuwa_BattI#noun#2#RM
electric_smelting	vixyuwa_pragalana#vixyuwa_pragalana#noun#2#RM
electric_steel	vixyuwa_ispAwa#vixyuwa_ispAwa#noun#2#RM
electrical_steel	vEispAwa#vEispAwa#noun#2#RM
electro_galvanizing	vEyaSaxalepana#vEyaSaxalepana#noun#2#RM
electrocast_refractory	vEsaMcakiwa_uccawApasaha#vEsaMcakiwa_uccawApasaha#noun#2#RM
electrochemical_corrosion	vErAsAyanika_vilepana#vErAsAyanika_vilepana#noun#2#RM
electrolytic_corrosion	vEaGatanI_saMkRAraNa#vEaGatanI_saMkRAraNa#noun#2#RM
electroslag_refining	vEXAwumala_pariRkaraNa#vEXAwumala_pariRkaraNa#noun#2#RM
end_hardening	anwya_kaToraNa#anwya_kaToraNa#noun#2#RM
extrusion_billet	uwsAraNa_bileta#uwsAraNa_bileta#noun#2#RM
extrusion_ingot	uwsAraNa_piMda#uwsAraNa_piMda#noun#2#RM
extrusion_metal	uwsAraNa_XAwu#uwsAraNa_XAwu#noun#2#RM
ferro-alloy_yard	lOha_miSrAwu_prAMgaNa/lOha_miSrAwu_yArda#lOha_miSrAwu_prAMgaNa/lOha_miSrAwu_yArda#noun#2#RM
ferro_nickel	lOha_nikila#lOha_nikila#noun#2#RM
fireclay_brick	akagasaha_ikaRtakA#akagasaha_ikaRtakA#noun#2#RM
flame_annealing	jvAlA_anIlana#jvAlA_anIlana#noun#2#RM
fog_quenching	kuhAsa_prakRAlana#kuhAsa_prakRAlana#noun#2#RM
forging_steel	Porjana_ispAwa#Porjana_ispAwa#noun#2#RM
fusible_alloy	saMgalanIya_miSrAwu#saMgalanIya_miSrAwu#noun#2#RM
fusion_welding	saMgalA_veldiMga#saMgalA_veldiMga#noun#2#RM
galvanized_sheet	jaswexAra_cAxara/yaSaxa_lepiwa_cAxara#jaswexAra_cAxara/yaSaxa_lepiwa_cAxara#noun#2#RM
gas_brazing	gEsa_beMjA#gEsa_beMjA#noun#2#RM
gas_quenching	gEsa_Samana#gEsa_Samana#noun#2#RM
h.r._coil	eca.Ara._kuMdalI#eca.Ara._kuMdalI#noun#2#RM
hearth_furnace	hArWa_BattI#hArWa_BattI#noun#2#RM
high-alloy_steel	ucca_miSrAwu_ispAwa#ucca_miSrAwu_ispAwa#noun#2#RM
high_carbon_steel	aXikArbana_ispAwa#aXikArbana_ispAwa#noun#3#RM
high_speed_steel	kRipra_ispAwa#kRipra_ispAwa#noun#3#RM
high_tensile_alloy	ucca_wanana_miSrAwu#ucca_wanana_miSrAwu#noun#3#RM
hollow_forging	KoKalA_Porjana#KoKalA_Porjana#noun#2#RM
hot_blast_cupola	wapwa_vAwyA_kyUpolA#wapwa_vAwyA_kyUpolA#noun#3#RM
hot_dip_galvanizing	wapwa_yaSaxalepana#wapwa_yaSaxalepana#noun#3#RM
hot_galvanizing	wapwa_yaSaxalepana#wapwa_yaSaxalepana#noun#2#RM
hot_quenching	wapwa_Samana#wapwa_Samana#noun#2#RM
hot_rolled	wapwa_bekallawa#wapwa_bekallawa#noun#2#RM
hot_rolled_coil	wapwa_bekallawa_kuMdala#wapwa_bekallawa_kuMdala#noun#3#RM
hot_rolling	wapwa_bellA#wapwa_bellA#noun#2#RM
hydrogen_blistering	hAIdrojA_PaPolA#hAIdrojA_PaPolA#noun#2#RM
hydrogen_brazing	hAIdrojA_brejana#hAIdrojA_brejana#noun#2#RM
hydrogen_embrittlement	hAIdrojA_BaMgurawA#hAIdrojA_BaMgurawA#noun#2#RM
indirect_arc_furnace	aprawyakRa_Arka_BattI#aprawyakRa_Arka_BattI#noun#3#RM
induction_brazing	preraNa_brejana#preraNa_brejana#noun#2#RM
induction_hardening	preraNa_kaToraNa#preraNa_kaToraNa#noun#2#RM
induction_soldering	preraNa_soldarA#preraNa_soldarA#noun#2#RM
induction_tempering	preraNa_pAyA/preraNa_tEmparA#preraNa_pAyA/preraNa_tEmparA#noun#2#RM
industrial_furnace	Oxyogika_BattI#Oxyogika_BattI#noun#2#RM
industrial_ore	Oxyogika_ayaska#Oxyogika_ayaska#noun#2#RM
inert-gas_cutting	akriya_gEsa_karwana#akriya_gEsa_karwana#noun#2#RM
ingot_cutting	piMdakarwA/SilikA_karwana#piMdakarwA/SilikA_karwana#noun#2#RM
ingot_iron	piMda_loha/SilikA_loha#piMda_loha/SilikA_loha#noun#2#RM
iron-nickel_alloy	loha-nikila_miSrAwu#loha-nikila_miSrAwu#noun#2#RM
iron_arc_process	loha_Arka_prakrama#loha_Arka_prakrama#noun#3#RM
iron_foundry	loha_DalAISAlA/loha_saMcakakRI#loha_DalAISAlA/loha_saMcakakRI#noun#2#RM
iron_ore	loha_ayaska#loha_ayaska#noun#2#RM
iron_ore_fines	loha_ayaska_sumaka#loha_ayaska_sumaka#noun#3#RM
iron_ore_lump	loha_ayaska_piMdaka#loha_ayaska_piMdaka#noun#3#RM
lignite_briquette	ligAita_briketa/ligAita_ikaRtakA#ligAita_briketa/ligAita_ikaRtakA#noun#2#RM
lignite_coke	ligAita_koka#ligAita_koka#noun#2#RM
lime_stone	cUnA_pawWara#cUnA_pawWara#noun#2#RM
low_alloy_steel	alpa_miSrAwu_ispAwa#alpa_miSrAwu_ispAwa#noun#3#RM
low_carbon_ferrochrome	alpa_kArbana_lohakroma#alpa_kArbana_lohakroma#noun#3#RM
low_carbon_steel	alpa_kArbana_ispAwa#alpa_kArbana_ispAwa#noun#3#RM
manganese_steel	mEMganIja_ispAwa#mEMganIja_ispAwa#noun#2#RM
metal_arc_welding	Arka_XAwu_veKlda_ga#Arka_XAwu_veKlda_ga#noun#3#RM
mild_steel	mqxu_ispAwa#mqxu_ispAwa#noun#2#RM
mould_steel	saMca_ispAwa#saMca_ispAwa#noun#2#RM
natural_ore	prAkqwika_ayaska#prAkqwika_ayaska#noun#2#RM
natural_steel	prAkqwika_ispAwa#prAkqwika_ispAwa#noun#2#RM
needle_steel	sUcIyiAwa_ispAwa#sUcIyiAwa_ispAwa#noun#2#RM
nickel_chromium_steel	nikila_kromiyama_ispAwa#nikila_kromiyama_ispAwa#noun#3#RM
nickel_steel	nikila_ispAwa#nikila_ispAwa#noun#2#RM
nickel_vanadium_steel	nikila_vEnedi_yama_ispAwa#nikila_vEnedi_yama_ispAwa#noun#3#RM
nu-iron_process	nyU-lOha_prakrama#nyU-lOha_prakrama#noun#2#RM
oil_hardened_steel	wOla_kaToriwa_ispAwa#wOla_kaToriwa_ispAwa#noun#3#RM
oil_hardening	wOla_kaToraNa#wOla_kaToraNa#noun#2#RM
open-cast_mining_(_min_)	vivqwwa_Kanana_(vivqwwa_garwa_Kanana)#vivqwwa_Kanana_(vivqwwa_garwa_Kanana)#noun#4#RM
open_annealing	vivqwwa_anIlana#vivqwwa_anIlana#noun#2#RM
open_arc_furnace	vixyuwa_Arka_BattI/vivqwa_A_rka_BrAptra#vixyuwa_Arka_BattI/vivqwa_A_rka_BrAptra#noun#3#RM
open_coil_annealing	vivqwwa_kuMdalI_anIlana#vivqwwa_kuMdalI_anIlana#noun#3#RM
open_die_forging	vivqwwa_rUpaxA_Porjana#vivqwwa_rUpaxA_Porjana#noun#3#RM
open_hearth_furnace	opA_hArWa_BattI/opA_hArWa_BrARtra#opA_hArWa_BattI/opA_hArWa_BrARtra#noun#3#RM
open_hearth_process	opA_hArWa_prakrama#opA_hArWa_prakrama#noun#3#RM
oxygen_corrosion	oYksIjA_saMkRAraNa#oYksIjA_saMkRAraNa#noun#2#RM
oxygen_enrichment	oYksIjA_samqxXikaraNa#oYksIjA_samqxXikaraNa#noun#2#RM
oxygen_steelmaking	oYksIjA_ispAwa_nirmANa#oYksIjA_ispAwa_nirmANa#noun#2#RM
pitting_corrosion	garwa_saMkRAraNa#garwa_saMkRAraNa#noun#2#RM
pitting_erosion	garwa-aparaxA#garwa-aparaxA#noun#2#RM
plain_carbon_steel_(_carbon_steel_)	kArbana_ispAwa#kArbana_ispAwa#noun#6#RM
pot_quenching	pAwra_Samana#pAwra_Samana#noun#2#RM
powdered-iron_core_(_ferrite_core_)	cUrNiwa_loha_kroda_(PErAita_kroda)#cUrNiwa_loha_kroda_(PErAita_kroda)#noun#5#RM
process_annealing	prakrama_anIlana#prakrama_anIlana#noun#2#RM
process_control	prakrama_niyaMwraNa#prakrama_niyaMwraNa#noun#2#RM
quench_annealing	Samana_anIlana#Samana_anIlana#noun#2#RM
rail_and_structural_mill	rela_evaM_saMracanA_upAxAna_mila#rela_evaM_saMracanA_upAxAna_mila#noun#4#RM
rail_steel	rela_ispAwa#rela_ispAwa#noun#2#RM
rapid_steel	kRipra_ispAwa#kRipra_ispAwa#noun#2#RM
rare-earth_alloy	xurlaBa-mqxA_miSrAwu#xurlaBa-mqxA_miSrAwu#noun#2#RM
rare-earth_metal	xurlaBa-mqxA_XAwu#xurlaBa-mqxA_XAwu#noun#2#RM
raw_material	kaccA_mAla/kaccI_sAmagrI#kaccA_mAla/kaccI_sAmagrI#noun#2#RM
red_hardness	rakwa_wapwa_kaTorawA#rakwa_wapwa_kaTorawA#noun#2#RM
red_hot	rakwa_wapwa#rakwa_wapwa#noun#2#RM
reducing_slag	apacAyI_XAwumala#apacAyI_XAwumala#noun#2#RM
refining_slag	pariRkaraNa_XAwumala#pariRkaraNa_XAwumala#noun#2#RM
refractory_brick	uccawApasaha_IMta/uccawApasaha_ikaRtakA#uccawApasaha_IMta/uccawApasaha_ikaRtakA#noun#2#RM
refractory_cement	uccawApasaha_sImeMta#uccawApasaha_sImeMta#noun#2#RM
refractory_clay	uccawApasaha_mqwwikA#uccawApasaha_mqwwikA#noun#2#RM
refractory_lining	uccawApasaha_Aswara#uccawApasaha_Aswara#noun#2#RM
refractory_metal	uccawApasaha_XAwu#uccawApasaha_XAwu#noun#2#RM
refractory_ore	xurgalanIya_ayaska#xurgalanIya_ayaska#noun#2#RM
reheating_furnace	punarwApA_BattI#punarwApA_BattI#noun#2#RM
rerolling_mill	punarbellA_mila#punarbellA_mila#noun#2#RM
resistance_welding	prawiroXa_veldiMga#prawiroXa_veldiMga#noun#2#RM
rimmed_steel	omi_ispAwa#omi_ispAwa#noun#2#RM
rimming_steel	omIyA_ispAwa#omIyA_ispAwa#noun#2#RM
rising_steel	uxgAmI_ispAwa#uxgAmI_ispAwa#noun#2#RM
roasted_steel	Barjiwa_ispAwa#Barjiwa_ispAwa#noun#2#RM
roll_welding	belA_veldiMga#belA_veldiMga#noun#2#RM
rolled-in_steel	aMwarbekallawa_ispAwa#aMwarbekallawa_ispAwa#noun#2#RM
rotary_forge_process	GUrNI_Porjana_prakrama#GUrNI_Porjana_prakrama#noun#3#RM
rotary_furnace	GUrNI_BattI/GUrNI_BrARtra#GUrNI_BattI/GUrNI_BrARtra#noun#2#RM
rotary_rolling_mill	bellA_GUrNI_mila#bellA_GUrNI_mila#noun#3#RM
rotflame_furnace	GUrNI_jvAlA_BattI/GUrNI_jvAlA_BrARtra#GUrNI_jvAlA_BattI/GUrNI_jvAlA_BrARtra#noun#2#RM
rustless_iron	jaMgahIna_loha#jaMgahIna_loha#noun#2#RM
saleable_steel	bikrIyogya_ispAwa#bikrIyogya_ispAwa#noun#2#RM
sand_cast	bAlU_saMcakiwa#bAlU_saMcakiwa#noun#2#RM
sand_casting	bAlU_saMcakA#bAlU_saMcakA#noun#2#RM
sand_casting_alloy	bAlU_saMcakA_miSrAwu#bAlU_saMcakA_miSrAwu#noun#3#RM
sand_stone	baluA_pawWara#baluA_pawWara#noun#2#RM
seamless_steel_tube	sIvAhIA_ispAwanalI#sIvAhIA_ispAwanalI#noun#3#RM
secondary_hardness	xviwIyaka_kaTorawA#xviwIyaka_kaTorawA#noun#2#RM
secondary_metal	xviwIyaka_XAwu#xviwIyaka_XAwu#noun#2#RM
self_annealing	sva_anIlana#sva_anIlana#noun#2#RM
self_corrosion	svasaMkRAraNa#svasaMkRAraNa#noun#2#RM
self_fluxing_iron_ore	svagAlakI_loha_ayaska#svagAlakI_loha_ayaska#noun#4#RM
selfjfhardening_steel	svakaToraNa_ispAwa#svakaToraNa_ispAwa#noun#2#RM
semi_killed_steel	arXahawa_ispAwa#arXahawa_ispAwa#noun#3#RM
semifinished_steel	aMSaparisakajjawa_ispAwa#aMSaparisakajjawa_ispAwa#noun#2#RM
semirimmed_steel	arXa_omIyiAwa_ispAwa#arXa_omIyiAwa_ispAwa#noun#2#RM
shaft_furnace	SOPta_BattI/SOPta_BrARtra#SOPta_BattI/SOPta_BrARtra#noun#2#RM
shaft_lining	SOPta_Aswara#SOPta_Aswara#noun#2#RM
shear_steel	samAkawAI_ispAwa#samAkawAI_ispAwa#noun#2#RM
sheet_metal	cAxarI_XAwu#cAxarI_XAwu#noun#2#RM
sheet_steel	cAxarI_ispAwa#cAxarI_ispAwa#noun#2#RM
short_bar	yUA_SalAkA#yUA_SalAkA#noun#2#RM
short_ingot	yUA_piMda#yUA_piMda#noun#2#RM
silicon_steel	silikA_ispAwa#silikA_ispAwa#noun#2#RM
sintered_steel	siMtariwa_ispAwa#siMtariwa_ispAwa#noun#2#RM
sintering_furnace	siMtaraNa_BattI#siMtaraNa_BattI#noun#2#RM
slag_pot	XAwumala_bAltI#XAwumala_bAltI#noun#2#RM
slag_runner	XAwumala_vAhaka#XAwumala_vAhaka#noun#2#RM
slurry_process	karxama-prakrama#karxama-prakrama#noun#2#RM
soft_coke	mqxu_koka#mqxu_koka#noun#2#RM
solder_brazing	soldara_brejana#soldara_brejana#noun#2#RM
solder_embrittlement	soldara_BaMguralA#soldara_BaMguralA#noun#2#RM
spring_steel	spriMga_ispAwa#spriMga_ispAwa#noun#2#RM
stainless-clad_steel	stenalesa_ispAwa/aXipattiwa_ispAwa#stenalesa_ispAwa/aXipattiwa_ispAwa#noun#2#RM
stainless_alloy	stenalesa_miSrAwu#stenalesa_miSrAwu#noun#2#RM
stainless_steel	stenalesa_ispAwa#stenalesa_ispAwa#noun#2#RM
steel_bronze	ispAwa_kAMsya#ispAwa_kAMsya#noun#2#RM
steel_converter	ispAwa_parivarwiwra#ispAwa_parivarwiwra#noun#2#RM
steel_defect	ispAwa_xoRa#ispAwa_xoRa#noun#2#RM
steel_degassing	ispAwa_vigEsana#ispAwa_vigEsana#noun#2#RM
steel_emergy	ispAwa_EmarI#ispAwa_EmarI#noun#2#RM
steel_encased_brick	ispAwa_Avariwa_IMta#ispAwa_Avariwa_IMta#noun#3#RM
steel_foil	ispAwa_parNI#ispAwa_parNI#noun#2#RM
steel_jack	ispAwa_jOka#ispAwa_jOka#noun#2#RM
steel_ladle_transfer_car	ispAwa_lOdala_aMwaraNa_gAdZI#ispAwa_lOdala_aMwaraNa_gAdZI#noun#4#RM
steel_making	ispAwa_nirmANa#ispAwa_nirmANa#noun#2#RM
steel_melting_shop	ispAwa_galASAlA#ispAwa_galASAlA#noun#3#RM
steel_scrap	ispAwa_skrEpa/ispAwa_ukacCaRta#ispAwa_skrEpa/ispAwa_ukacCaRta#noun#2#RM
steel_set	ispAwa_sOta#ispAwa_sOta#noun#2#RM
steel_skirt	ispAwa_skarta#ispAwa_skarta#noun#2#RM
steel_tunnel_support	ispAwa_suraMga_AXAra#ispAwa_suraMga_AXAra#noun#3#RM
steel_wool	ispAwa_UrNa/ispAwa_UA#ispAwa_UrNa/ispAwa_UA#noun#2#RM
strain_hardening	vikqwi_kaToraNa#vikqwi_kaToraNa#noun#2#RM
strain_lines	vikqwi_reKAeM#vikqwi_reKAeM#noun#2#RM
stress_corrosion	prawibala_saMkRAraNa#prawibala_saMkRAraNa#noun#2#RM
strobo_torch	strovo_toYrca#strovo_toYrca#noun#2#RM
structural_hardening	saMracanAwmaka_kaTa_raNa#saMracanAwmaka_kaTa_raNa#noun#2#RM
structural_section	saMracanAwmaka_KaMda#saMracanAwmaka_KaMda#noun#2#RM
structural_shape	saMracanAwmaka_AkAra#saMracanAwmaka_AkAra#noun#2#RM
structural_spalling	saMracanAwmaka_samuwKaMdA#saMracanAwmaka_samuwKaMdA#noun#2#RM
structural_steel	saMracanAwmaka_ispAwa#saMracanAwmaka_ispAwa#noun#2#RM
structural_tube	saMracanAwmakanalI#saMracanAwmakanalI#noun#2#RM
superconducting_metal	awicAlaka_XAwu#awicAlaka_XAwu#noun#2#RM
surface_rolling	pqRTa_bellA#pqRTa_bellA#noun#2#RM
sutton_steel_jig	satA_ispAwa_jiMga#satA_ispAwa_jiMga#noun#3#RM
temper_mill	tEmpara_mila#tEmpara_mila#noun#2#RM
temper_rolling	wvaka_bellA#wvaka_bellA#noun#2#RM
temper_stressing	tEmpara_prawibalA/pAyA_prawibalA#tEmpara_prawibalA/pAyA_prawibalA#noun#2#RM
tensile_strength	wanana_sAmarWya#wanana_sAmarWya#noun#2#RM
thermit_mixture	Warmita_miSraNa#Warmita_miSraNa#noun#2#RM
thermit_process	Warmita_prakrama#Warmita_prakrama#noun#2#RM
thermit_welding	Warmita_veldiMga#Warmita_veldiMga#noun#2#RM
thin_foil_(_thin_film_)	wanu_parNikA#wanu_parNikA#noun#5#RM
thread_rolling	cUdZI_bellA#cUdZI_bellA#noun#2#RM
tilting_furnace	Anamana_BrARtra#Anamana_BrARtra#noun#2#RM
tilting_openhearth	Anamana_opA_hArWa#Anamana_opA_hArWa#noun#2#RM
trenching_machine	treca_maSIna#treca_maSIna#noun#2#RM
tube_rolling_mill	nalikA_bellA_mila#nalikA_bellA_mila#noun#3#RM
tube_steel_nalika_ispawa	Tube_steel_nalikA_ispAwa#Tube_steel_nalikA_ispAwa#noun#4#RM
tubular_mould	nalikAkAra_saMca#nalikAkAra_saMca#noun#2#RM
tumbling_strength	saMlotA_sAmarWya#saMlotA_sAmarWya#noun#2#RM
tungsten_steel	taMgastA_ispAwa#taMgastA_ispAwa#noun#2#RM
twin_bath_open_hearth	yamala_opA_hArWa#yamala_opA_hArWa#noun#4#RM
twin_hearth_furnace	yamala_hArWa_BrARtra/yamala_hArWa_BattI#yamala_hArWa_BrARtra/yamala_hArWa_BattI#noun#3#RM
universal_rolling_mill	sArvika_belA_mila#sArvika_belA_mila#noun#3#RM
washed_coal	XAviwa_koyalA#XAviwa_koyalA#noun#2#RM
weathering_steel	apakRayana_ispAwa#apakRayana_ispAwa#noun#2#RM
wedge_furnace	veja_BattI/veja_BrARtra#veja_BattI/veja_BrARtra#noun#2#RM
wedge_roaster	veja_Barjiwra#veja_Barjiwra#noun#2#RM
welding_rod	veldiMga_CadZa#veldiMga_CadZa#noun#2#RM
wet_charging	klexa_XAnana#klexa_XAnana#noun#2#RM
wet_chemical_analysis	klexa_rAsAyanika_viSleRaNa#klexa_rAsAyanika_viSleRaNa#noun#3#RM
wet_corrosion	klexa_saMkRAraNa#klexa_saMkRAraNa#noun#2#RM
white_slag	Svewa_XAwumala#Svewa_XAwumala#noun#2#RM
wire_drawing	wAra_karRaNa#wAra_karRaNa#noun#2#RM
wire_gauge	wAra_pramApI/wAra_jAlI#wAra_pramApI/wAra_jAlI#noun#2#RM
wire_rod	wAra_CadZa#wAra_CadZa#noun#2#RM
wire_rod_mill	wAra_CadZa_mila#wAra_CadZa_mila#noun#3#RM
zone_refining	aMcala_pariRkaraNa#aMcala_pariRkaraNa#noun#2#RM
