critically	awyanwa
needed	AvaSyaka
or	yA_Pira
release	mukwa_ho
unravelling	sulaJAnA
step	caraNa
derive	vyuwpanna
intuitive	sahajAnuBUwa
since	cUfki
electrically	vExyuwa
govern	niyanwriwa
namely	arWAwa
evident	arWapUrNa
form	sUwra
dominate	CA
equal	barAbara
move	gawimAna
central	mahawvapUrNa
fix	sWira_raha
inseparable	avicCexa
transmit	saFcariwa_kara
fur	samUra
Fig.	ciwra
a	kisI
an	kisI_BI/koI_BI
even	waba_BI
denote	nirUpiwa_kara
cross-sectional	anuprasWa_paricCexa
see	XyAna_xe
interdependent	paraspara_sambanXiwa
dimension	vimA
kind	prakAra
same	eka_hI
join	joda_xe
nor	na_wo
second	sekanda
different	viviXa
trace	Koja_kara
convenient	suviXAnusAra
until	wAki
method	niyama
everyday	xEnika
not	na_ki
travel	gawi
later	agale
however	yaxyapi/kiMwu
before	ke_pUrva
macroeconomics	samaRti_arWaSAswra
macroeconomic	samaRti_arWaSAswrIya
microeconomics	vyaRti_arWaSAswra
your	wU
yes	jI
