Gita	gIwA
Bhagavad-Gita	BAgavax-gIwA
Bhishma	BIRma
Sita	sIwA
Hanuman	hanumAna
Draupadi	xrOpaxI
Mahabharata	mahABArawa
Ramayana	rAmAyaNa
Johann	johana
Jakob	jekaba
Balmer	bAmara
Ernst	arnesta
Rutherford	raxaraPorda
Thomson	Woyamasana
Hans	hEMsa
Geiger	gAigara
Marsden	mArsadana
Galileo	gElIliyo
Isaac	aAijaka
Newton	nyUtana
Faraday	PErAde
Henry	henarI
Michael	mAikala
Germer	jarmara
